name,1,2,3,4,5,N
Killer Innovations with Phil McKinney - A Show About Ideas Creativity And Innovation,1,0,2,1,30,34
Science Friday,52,44,56,39,236,427
Escape Pod,7,3,3,1,36,50
This Week in Tech (Audio),173,61,45,29,192,500
Distorted View Daily,2,1,0,1,46,50
Las Vegas Podcast: Five Hundy by Midnight,9,5,2,5,77,98
Big Picture Science,6,6,4,9,144,169
KQED's Forum,5,1,6,3,25,40
The Deadpod,1,0,2,3,198,204
"KCRW's Left, Right & Center",154,74,74,58,140,500
The Roadhouse,0,0,0,0,59,59
The Radio Adventures of Dr. Floyd,1,0,0,5,44,50
The Science Show - Full Program Podcast,3,1,2,0,19,25
Filmspotting: Reviews & Top 5s,16,9,10,12,453,500
Endurance Planet,2,1,5,0,42,50
Comic Geek Speak Podcast - The Best Comic Book Podcast,14,14,15,12,145,200
Background Briefing,8,1,1,2,84,96
Life Matters - Full program podcast,2,0,3,1,11,17
Sci-Fi Talk,0,0,1,1,6,8
This Week in Science – The Kickass Science Podcast,35,16,11,11,140,213
Feast of Fun: Gay Talk Show,8,1,3,2,36,50
Fighting Talk,9,4,7,10,100,130
Design and Architecture,3,2,1,2,8,16
On the Media,14,1,2,2,31,50
Mac Geek Gab (Enhanced AAC),2,6,8,27,457,500
Marketplace Tech,12,8,3,2,25,50
In Our Time,12,12,15,18,120,177
All In The Mind,2,3,1,9,64,79
Late Night Live - Full program podcast,8,0,1,5,77,91
Utah's Morning News,1,0,1,0,4,6
Geek News Central Podcast,0,2,2,12,34,50
From Our Own Correspondent Podcast,2,1,1,2,41,47
Slice of SciFi Radio,4,5,2,6,47,64
Dr Karl Podcast,10,1,3,6,111,131
Zencast,3,1,1,7,94,106
The Autoblog Podcast,8,8,13,5,16,50
Digital Planet,0,1,0,1,9,11
The Brian Lehrer Show,7,3,2,5,49,66
Nightline,18,10,10,6,12,56
Studio 360 with Kurt Andersen,6,1,0,7,66,80
Pulse of the Planet Podcast with Jim Metzner | Science | Nature | Environment | Technology,0,1,0,0,4,5
HomeShow Radio Show | Tom Tynan,1,2,0,0,2,5
AEW Week in Review - AEW News & Opinion Podcast,9,3,3,4,66,85
Life.Church with Craig Groeschel,0,1,2,2,82,87
LensWork - Photography and the Creative Process,0,0,0,0,9,9
The Documentary Podcast,0,0,0,0,8,8
Kermode and Mayo's Film Review,17,6,4,8,60,95
The Tech Guy (Audio),28,22,13,31,267,361
Sports Business Radio Podcast,0,0,0,2,17,19
Into Tomorrow With Dave Graveline,0,0,0,0,5,5
Polyamory Weekly,2,2,1,8,94,107
The Naked Scientists Podcast,4,0,1,11,100,116
World of Warcast: A World of Warcraft Podcast,6,2,6,5,31,50
Manager Tools,8,7,6,5,174,200
Art Talk,0,0,0,0,6,6
All Of It,15,7,1,9,31,63
Film Junk Podcast,14,4,4,12,144,178
"MacCast - For Mac Geeks, by Mac Geeks",6,1,7,22,328,364
NBC Meet the Press,176,57,32,34,109,408
CounterSpin,0,1,1,3,42,47
WSJ Tech News Briefing,20,16,21,16,79,152
Major Nelson Radio,8,6,4,8,24,50
Law Report - Full program podcast,0,0,0,0,1,1
Apple Quarterly Earnings Call,1,2,0,2,15,20
Free Buddhist Audio,0,0,0,1,10,11
Slate Daily Feed,26,21,10,14,106,177
Berkeley Buddhist Monastery,0,0,0,0,5,5
Basic Brewing Radio,1,0,0,5,99,105
Calvary Chapel Chino Hills,2,0,0,1,45,48
Gamertag Radio,7,4,4,1,34,50
NBC Nightly News with Lester Holt,52,24,19,15,55,165
Audio Dharma,0,2,1,0,85,88
Bishop Robert Barron’s Sermons - Catholic Preaching and Homilies,2,1,1,5,230,239
Soundcheck,0,0,1,2,10,13
English as a Second Language (ESL) Podcast - Learn English Online,3,0,0,4,43,50
The Weekly Mix,0,0,0,4,46,50
iCritical Care: All Audio,1,4,2,1,11,19
Bethel Church Sermon of the Week,15,1,1,4,242,263
Chabad.org - Daily Torah Study,1,1,0,1,12,15
MuggleCast: the Harry Potter podcast,15,9,6,18,152,200
The Dave Ramsey Show,308,84,78,30,262,762
The Ramsey Show,154,42,39,15,131,381
Irish and Celtic Music Podcast,1,2,3,2,42,50
PUB SONGS & STORIES,0,0,0,1,17,18
White Roof Radio - The MINI Cooper Podcast,2,0,0,0,48,50
Chobo-Ji's Zen Podcast,0,0,0,0,10,10
CAGcast,10,2,3,0,35,50
ARRL Audio News,0,0,0,0,5,5
PARANORMAL PODCAST,21,8,16,34,420,499
Scott Sigler's Audiobooks,1,0,0,0,49,50
Skydive Radio,0,0,1,0,21,22
WMMR's Preston & Steve Daily Podcast,1,1,2,5,41,50
The RELEVANT Podcast,45,15,17,32,391,500
Duct Tape Marketing,0,0,0,2,47,49
Talking Metal,5,3,2,2,38,50
Face the Nation on the Radio,62,30,18,14,41,165
Hack,23,5,6,6,55,95
Security Now (Audio),19,20,22,19,204,284
Travel with Rick Steves,10,8,10,10,91,129
I Should Be Writing,3,1,3,8,81,96
PotterCast: The Harry Potter Podcast (since 2005),42,17,7,10,124,200
BirdNote,2,1,0,1,36,40
Amateur Traveler Travel Podcast,6,6,6,22,184,224
Video Game Outsiders,14,4,5,5,22,50
A Spoonful of Russian - Learn Russian Online from Russian Tutor,1,0,0,0,30,31
Decoder Ring Theatre,0,0,0,1,49,50
The Martin Bailey Photography Podcast,0,1,0,2,47,50
Blackhawks Insider - Official Chicago Blackhawks Podcast,0,3,1,3,18,25
KQED's The California Report,7,3,0,2,24,36
The Environment Report,1,0,0,2,8,11
All Songs Considered,9,4,8,3,26,50
Raw Material,0,1,1,0,15,17
Betty in the Sky with a Suitcase!,3,2,3,1,41,50
The Project Management Podcast,2,1,1,4,34,42
The Genealogy Guys Podcast & Genealogy Connection,1,0,0,2,47,50
Persiflagers Infectious Disease Puscast,3,1,1,0,45,50
Pardes from Jerusalem,1,0,1,4,23,29
Living Planet | Deutsche Welle,0,0,0,0,2,2
Greg Laurie Podcast,0,2,4,4,132,142
60 Minutes,21,7,7,7,8,50
Entitled Opinions (about Life and Literature),2,1,2,4,49,58
Stuck in the '80s Podcast,0,4,1,6,58,69
The Digital Story Photography Podcast,2,0,0,5,43,50
The Math Factor,1,0,2,4,11,18
The Village Church - Sermons,4,1,5,5,254,269
Learn Japanese Pod,0,1,1,1,47,50
The Final Lap Weekly - NASCAR Talk Show,1,1,2,2,31,37
We the People,7,4,4,14,93,122
Urban Dharma,0,0,0,5,50,55
School of Podcasting,0,0,2,0,48,50
Bridgetown Audio Podcast,3,1,0,6,95,105
The Karel Cast,2,0,1,2,26,31
The Finer Points - Aviation Podcast,0,1,1,6,25,33
Ted Wells living : simple,0,1,0,0,4,5
The Splendid Table,25,26,19,10,120,200
Gateway People Audio Podcast,1,1,4,1,71,78
The Penguin Podcast,0,2,0,0,7,9
Insight for Living Daily Broadcast,4,1,9,6,121,141
Cast On,1,0,0,0,49,50
iFanboy - Comic Books,3,0,1,3,93,100
Talkin' Birds,0,0,0,0,14,14
Truth For Life Programs,0,1,1,1,162,165
"Planetary Radio: Space Exploration, Astronomy and Science",0,5,3,4,195,207
This Week with George Stephanopoulos,151,49,32,32,49,313
All Sides with Ann Fisher Podcast,0,1,0,0,9,10
The Accidental Creative,1,1,0,1,47,50
WhiskyCast,2,0,0,1,47,50
History of Photography Podcast,1,1,0,2,25,29
Storynory - Stories for Kids,6,2,4,3,35,50
Understanding the Times,7,0,1,0,55,63
Conversations,16,8,16,20,228,288
Sound Opinions,5,3,5,6,31,50
Real Time with Bill Maher,138,33,30,30,269,500
Holy Quran Daily Podcast,3,1,0,3,62,69
InDesign Secrets,0,0,0,0,9,9
A Buddhist Podcast,2,0,0,4,109,115
Animal Radio®,1,0,0,1,3,5
LearnItalianPod,2,4,4,9,31,50
The Dice Tower,5,6,7,3,29,50
Unfettered Mind,1,2,0,0,12,15
Point of Inquiry,19,10,8,13,121,171
World Cafe Words and Music from WXPN,6,3,3,2,13,27
Apple Context Machine,9,5,3,4,20,41
Documentary on One Podcast,0,0,0,0,10,10
Learning English Broadcast - VOA Learning English,0,0,0,0,2,2
Renewing Your Mind with R.C. Sproul,6,1,1,4,174,186
1 Year Daily Audio Bible,6,4,2,10,478,500
golf SMARTER,8,7,5,23,223,266
Learn Japanese | JapanesePod101.com (Video),1,1,1,2,16,21
Learn Japanese | JapanesePod101.com (Audio),1,1,5,6,37,50
Notes in Spanish Advanced,0,0,2,8,31,41
CO2 mon Amour,0,0,0,0,1,1
Le masque et la plume,0,1,0,1,4,6
The Instance: The Podcast for Lovers of WoW and Blizzard Games,11,4,1,3,31,50
Hanselminutes with Scott Hanselman,1,1,1,3,80,86
Daily Radio Program with Charles Stanley - In Touch Ministries,7,1,1,10,481,500
"Astronomy 162 - Stars, Galaxies, & the Universe",0,0,0,1,26,27
The Babylon Podcast,0,0,0,1,24,25
The Jodcast - astronomy podcast,1,0,3,4,49,57
The Atheist Experience,28,10,10,19,252,319
Paws & Tales Paws-cast,5,1,1,5,38,50
Learn Chinese - Easy Situational Mandarin Chinese Audio Lessons,5,1,2,4,38,50
Defected Radio,2,3,2,5,35,47
The Book Review,6,5,8,11,170,200
Popcast,24,20,11,20,41,116
Science Magazine Podcast,3,11,13,10,25,62
MicrobeWorld Video,0,0,0,0,5,5
Mac OS Ken,7,5,6,8,321,347
Software Engineering Radio - the podcast for professional software developers,1,1,1,2,22,27
Learn French With Alexa,0,1,5,4,40,50
Money Guy Show,2,2,2,8,186,200
Song of the Day,4,2,7,14,143,170
"A Way with Words: language, linguistics, and callers from all over",2,1,2,1,44,50
NPR News Now,68,18,22,20,168,296
Piano Puzzler,0,0,0,1,31,32
This I Believe,3,2,0,3,23,31
Wait Wait... Don't Tell Me!,14,4,8,16,148,190
On Point,52,28,32,17,71,200
Israel Hour Radio - Israeli Music Podcast,0,0,0,0,25,25
Off The Hook,6,0,0,1,8,15
The Money Pit Home Improvement Podcast,0,4,5,7,6,22
Jeff Curto's Camera Position,1,0,1,3,60,65
Science Talk,20,13,8,15,47,103
American Conservative University,11,2,3,2,32,50
PRN - Fast Talk Podcast,0,0,0,0,7,7
PRN - The Pit Reporters Podcast,0,0,0,1,2,3
Meditation Station by Stin Hansen,2,1,0,2,45,50
PODRUNNER: Workout Music,1,1,1,1,46,50
"Best of the Left - Progressive Politics and Culture, Curated by a Human",16,2,2,1,29,50
Easy French Poetry (French Today),0,0,0,1,29,30
Deejay Chiama Italia,0,0,0,0,1,1
The Candid Frame: Conversations on Photography,1,0,0,1,98,100
Zen Tiki Lounge,2,1,0,0,47,50
The Skeptics' Guide to the Universe,41,32,21,17,389,500
JAMA Editors' Summary,5,5,2,1,9,22
Around Comics - Comic Book Podcast,5,2,1,17,125,150
Superego,2,0,0,0,48,50
606,37,18,13,16,53,137
Catholic Answers Live,11,2,1,6,252,272
Carnegie Council Audio Podcast,1,1,0,2,7,11
Woman's Hour,18,7,10,9,52,96
Intelligent Design the Future,58,1,3,6,66,134
The Don Tony Show / Wednesday Night Don-O-Mite,45,12,13,14,104,188
"World Soccer Talk: Premier League, MLS, Champions League, EFL and more",29,12,15,16,85,157
EconTalk,3,5,4,2,36,50
Global News Podcast,364,203,182,245,1785,2779
Ask About Fly Fishing - Podcast,1,4,0,7,16,28
Philosopher's Zone,2,0,0,5,22,29
Science Weekly,3,1,1,4,13,22
Accounting Best Practices with Steve Bragg,0,0,1,2,23,26
Joel Osteen Podcast,136,4,4,28,332,504
Hora 25,4,1,1,1,4,11
Word In Your Ear,1,0,0,0,13,14
Marketplace Morning Report,8,5,2,7,28,50
Le journal de 8H00,0,0,0,0,1,1
Baseball Tonight with Buster Olney,114,37,34,54,261,500
Talking Beasts: The Narnia Podcast,0,0,1,2,26,29
The Brewing Network Presents | The Jamil Show,0,4,2,4,30,40
Podcasts – ESL Teacher Talk – ESL Podcasts for Teachers,3,2,0,1,0,6
Le journal de 18h00,0,0,0,0,2,2
Poetry Off the Shelf,1,2,2,5,51,61
Arts & Ideas,2,2,5,2,15,26
Upaya Zen Center's Dharma Podcast,0,0,0,0,7,7
Aquarium Drunkard - SIDECAR (TRANSMISSIONS) - Podcast,1,1,0,1,15,18
IMTalk,0,1,0,2,69,72
The Ageless Wisdom Mystery School with Michael Benner,1,0,1,2,25,29
PTI,123,27,37,41,272,500
Mad Money w/ Jim Cramer,64,12,10,8,104,198
Classical Performance,0,1,1,5,36,43
Food for Thought: How to Live Compassionately and Healthfully,3,2,0,1,94,100
CapRadio: Latest News Podcast,0,0,1,0,1,2
The Advanced Selling Podcast,6,2,3,3,77,91
On Being with Krista Tippett,0,0,0,0,5,5
Economist Radio,0,0,4,0,44,48
CraftLit - Serialized Classic Literature for Busy Book Lovers,0,0,0,2,95,97
WSJ What’s News,14,6,2,1,27,50
HBR IdeaCast,0,0,1,0,5,6
WSJ Your Money Briefing,12,7,5,10,16,50
Radiolab,80,28,14,12,56,190
Joyce Meyer Enjoying Everyday Life® TV Audio Podcast,12,3,3,10,249,277
Joyce Meyer Radio Podcast,0,0,1,0,12,13
Freethought Radio,6,10,14,12,73,115
FINRA Unscripted,0,0,0,0,6,6
"Fear the Boot, RPG Podcast",0,2,2,4,42,50
Let's Speak Italian!,6,4,1,6,33,50
Common Sense with Dan Carlin,108,20,17,9,346,500
Radio Free Nintendo,2,4,4,5,35,50
Audio Book Club,12,21,15,12,34,94
Political Gabfest,10,6,8,5,21,50
Rick Steves' Europe Video,1,1,1,3,17,23
Cato Daily Podcast,14,3,5,15,80,117
Zen Talks from Windhorse Zen Community,1,1,0,0,7,9
This Morning With Gordon Deal,48,55,62,41,172,378
The DIS Unplugged - A Weekly Roundtable Discussion About All Things Disney World,80,39,33,39,309,500
Linux Action News,7,3,2,5,48,65
Learn French by Podcast,3,1,3,6,37,50
Futures in Biotech (Audio),1,3,2,3,10,19
Vedanta and Yoga,1,0,0,0,17,18
TED Talks Daily (SD video),6,1,0,2,41,50
TED Talks Daily,245,98,63,154,399,959
Sekulow Radio Show,7,3,5,3,32,50
SBS Italian - SBS in Italiano,0,1,1,1,5,8
SBS Polish - SBS po polsku,0,0,0,1,1,2
Slate's Spoiler Specials,87,32,25,23,49,216
Big Ideas,5,2,4,8,40,59
Merriam-Webster's Word of the Day,21,8,10,14,55,108
PediaCast: Pediatric Podcasts for Parents,0,1,0,2,47,50
Morning Ireland,2,8,2,8,5,25
Lean Blog Interviews,0,0,0,0,12,12
My History Can Beat Up Your Politics,6,2,4,0,38,50
Learn Spanish - Survival Guide,11,6,4,6,23,50
Bigfoot Information Project Podcast,1,0,0,2,30,33
Puck Podcast,5,8,1,9,192,215
College of Judaism,0,0,0,0,2,2
Dan Carlin's Hardcore History,28,12,12,16,1008,1076
Grammar Girl Quick and Dirty Tips for Better Writing,5,4,2,1,38,50
Pure Sex Radio,0,0,0,0,13,13
RNZ: Nine To Noon,1,0,1,0,13,15
RNZ: Saturday Morning,2,0,0,1,21,24
48 Days to the Work You Love Internet Radio Show,6,3,1,5,140,155
MacBreak Weekly (Audio),10,7,11,7,15,50
Mark Driscoll Audio,49,4,2,9,266,330
PseudoPod,1,3,2,0,44,50
Beats in Space,0,1,0,0,34,35
Zorba Paster On Your Health,3,2,2,2,11,20
National Park Service,3,0,0,0,3,6
PHOTOGRAPHY 101,6,3,5,8,36,58
Uncontrolled Airspace: General Aviation Podcast,2,8,4,2,34,50
"""A Tale of Two Cities"" Audiobook (Audio book)",0,0,4,1,51,56
The Deer Park Dharmacast,0,0,0,0,7,7
"In the Groove, Jazz and Beyond",5,1,0,3,41,50
Patriots Unfiltered,17,8,7,9,150,191
11 O'Clock Comics Podcast,3,4,2,1,90,100
Better at English,0,1,0,1,18,20
Effortless English Podcast | Learn English with AJ Hoge,4,4,1,5,36,50
Football Weekly,26,4,12,8,96,146
Dragon Talk - An Official Dungeons & Dragons Podcast,12,3,7,8,20,50
Notes in Spanish Intermediate,0,0,2,3,28,33
60-Second Science,25,13,12,21,86,157
The Philosophy Podcast,1,7,3,16,13,40
Gun Talk,6,3,2,0,39,50
Learn French with daily podcasts,8,1,2,1,38,50
Messianic Shabbat - The Harvest,17,0,0,1,13,31
Astronomy Cast,11,9,12,22,446,500
Astronomy 161 - Introduction to Solar System Astronomy,0,0,1,3,45,49
The Ziglar Show,1,0,5,6,138,150
Farrakhan Speaks,4,2,0,0,18,24
The Official Adventures in Odyssey Podcast,3,0,2,2,43,50
The Real Estate Guys Radio Show - Real Estate Investing Education for Effective Action,12,3,3,5,94,117
John Piper Sermons,3,1,1,3,90,98
Medmal Insider,0,0,0,0,3,3
Learn To Meditate - Meditation Podcast,0,2,2,1,45,50
Windows Weekly (Audio),29,18,13,17,92,169
Live Wire with Luke Burbank,3,3,2,2,31,41
The Meditation Podcast,8,3,2,4,33,50
Savage Lovecast,13,3,2,5,27,50
Coffee Break Spanish,2,3,2,1,42,50
NASACast Audio,0,2,0,1,8,11
This American Life,300,96,108,66,1272,1842
SpyCast,17,8,4,9,12,50
Marketplace,114,66,36,38,482,736
Player One Podcast,16,5,9,14,215,259
Gardens Illustrated Magazine,0,1,0,0,1,2
Skeptoid,42,15,18,16,409,500
NOS Met het Oog op Morgen,0,0,0,0,5,5
Meditation Oasis,2,1,4,1,42,50
Mooney Goes Wild,0,0,0,0,1,1
Deeper Shades of House - weekly Deep House Podcast with Lars Behrenroth,1,0,2,4,42,49
Test Match Special,4,6,8,16,64,98
ESPN On Ice with Wyshynski and Kaplan,23,18,15,19,120,195
Messianic Jewish Teachings: David Levine,30,2,2,1,45,80
My Thought Coach,0,2,3,0,45,50
THE OPINION ZONE : A Sonic The Hedgehog Podcast,6,5,1,1,37,50
Business English Pod :: Learn Business English Online,1,0,0,4,19,24
The Thomas Jefferson Hour,7,3,2,3,35,50
New England Journal of Medicine Interviews,0,0,0,1,3,4
Radio Diaries,2,4,4,9,99,118
Mason & Ireland,11,7,4,9,46,77
The Clark Howard Podcast,7,3,7,9,174,200
Parsha Podcast with Ari Goldwag,0,0,0,0,24,24
Reduced Shakespeare Company Podcast,0,0,1,1,44,46
RNZ: Morning Report,1,2,0,0,3,6
Start Cooking,1,0,1,10,106,118
Made in Germany: Das Wirtschaftsmagazin,0,0,0,0,1,1
The National Archives Podcast Series,0,1,0,1,4,6
The Michael Kay Show,27,8,8,12,123,178
Airspeed,0,1,2,1,27,31
Music to my Ears,0,0,0,0,1,1
Mark Levin Podcast,98,22,10,22,542,694
MarriageToday with Jimmy & Karen Evans,1,0,0,0,53,54
Money Girl's Quick and Dirty Tips for a Richer Life,4,6,8,7,175,200
Fox News Radio Newscast,32,5,4,3,6,50
Books and Ideas with Dr. Ginger Campbell,0,0,0,1,18,19
"Brain Science with Ginger Campbell, MD: Neuroscience for Everyone",1,1,0,7,182,191
One Thing In A French Day,0,0,0,1,49,50
Power Yoga with Dave Farmar,3,9,1,1,36,50
The Mustache Rangers Podcast: Comedy | Sci-Fi | Improv,0,0,0,1,49,50
My Daily Phrase Italian,2,3,0,4,41,50
My Daily Phrase German,5,4,0,5,12,26
Buddhist Geeks,5,3,4,3,50,65
Your Move with Andy Stanley Podcast,9,1,0,6,215,231
FamilyLife Today®,2,0,2,4,66,74
Carrusel Deportivo,0,1,0,0,2,3
Hamish & Andy,2,0,2,2,174,180
Talkin' Cowboys,40,19,11,13,48,131
The Wigglian Way Pagan Podcast,3,0,0,2,33,38
Fresh Life Church,5,0,0,1,60,66
Fresh Air,90,27,39,27,255,438
Bass Edge's THE EDGE,0,2,1,4,61,68
KQED Science News,0,0,0,0,1,1
Math Mutation,0,1,0,0,47,48
The Truth of the Matter,3,1,2,2,12,20
Learn Chinese & Culture @ iMandarinPod.com,1,1,0,1,17,20
This Birding Life,0,0,0,0,7,7
Inside Yellowstone,1,0,0,1,9,11
The Mighty Mommy's Quick and Dirty Tips for Practical Parenting,2,3,4,9,32,50
KSL Greenhouse,0,0,0,1,4,5
The Psych Files,4,2,1,2,41,50
The WDW Radio Show - Your Walt Disney World Information Station,8,8,8,12,464,500
"CNBC's ""Fast Money""",88,22,12,19,59,200
Creating Wealth Real Estate Investing with Jason Hartman,8,3,0,2,87,100
Elevation with Steven Furtick,1,0,1,1,32,35
Radio Drama Revival,1,2,1,4,23,31
Risky Business,9,2,0,0,31,42
The Social Work Podcast,0,0,1,0,85,86
Intelligence Squared U.S. Debates,3,2,4,5,36,50
The Drabblecast Audio Fiction Podcast,1,0,2,2,45,50
Bible Study Podcasts,6,5,2,6,95,114
Doctor Who: Radio Free Skaro,2,4,3,1,52,62
The Brewing Network Presents | The Session,12,3,2,1,32,50
The Disciplined Investor,6,4,5,12,73,100
The Mountain Top For Men (formerly The Chick Whisperer):,1,3,0,2,44,50
The Dirtbag Diaries,8,8,8,6,260,290
Conversations with John & Lisa Bevere,0,0,0,1,13,14
Vanguard Advisor's Alpha Podcast,1,0,2,0,2,5
World News Tonight with David Muir,19,5,12,4,10,50
"Expanded Lovemaking: Sex, Love, and Consciousness",1,3,1,1,17,23
The Brian Kilmeade Show Free Podcast,18,1,1,1,29,50
Sales Gravy: Jeb Blount,0,2,3,3,92,100
Case Closed! (old time radio),1,0,0,2,34,37
Composers Datebook,1,0,0,3,7,11
StoryCorps,20,19,12,22,358,431
The Genealogy Gems Podcast with Lisa Louise Cooke     -      Your Family History Show,2,2,2,4,40,50
Wood Talk | Woodworking,1,1,1,1,46,50
CLUBLIFE,5,1,6,6,32,50
US Citizenship Podcast,0,0,1,2,4,7
Superman on the Radio,4,0,1,1,7,13
Around the Horn,47,11,13,32,182,285
Frankenstein by Mary Shelly - The Audio Book,3,5,4,6,8,26
"Today in iOS  - The Unofficial iPhone, iPad, and Apple Watch Podcast",25,15,13,24,232,309
Keith and The Girl comedy talk show,4,0,0,1,45,50
The Best of Car Talk,2,0,0,2,46,50
Selected Shorts,18,6,11,20,145,200
Knit Picks' Podcast,2,1,5,5,37,50
Rochester Zen Center Teisho (Zen Talks),1,2,0,2,10,15
PC Perspective Podcast,5,3,5,10,56,79
American Journal of Psychiatry Audio,3,1,3,5,7,19
The Golf Psychology Podcast,0,0,1,0,4,5
Football Ramble,8,10,4,2,283,307
San Francisco Zen Center Dharma Talks,0,3,0,0,6,9
Philosophy: The Classics,1,1,0,8,19,29
ICU Rounds,0,0,1,1,48,50
Classic Poetry Aloud,4,1,2,3,18,28
Louis French Lessons,6,1,2,4,26,39
The Relic Radio Show (old time radio),0,0,0,1,28,29
The Horror! (Old Time Radio),1,0,2,8,189,200
History Extra podcast,9,9,18,21,84,141
q: The Podcast from CBC Radio,1,0,0,2,14,17
The New Yorker: Fiction,12,8,6,22,152,200
Philosophy Bites,9,3,4,17,84,117
Druidcast - The Druid Podcast,1,0,0,3,174,178
Learn Spanish: Notes in Spanish Inspired Beginners,4,2,5,2,37,50
Pride and Prejudice,2,4,6,15,23,50
Kabbalah & Physics,1,0,0,0,3,4
The Classic Tales Podcast,0,1,1,1,47,50
Guitar Music Theory,0,1,0,0,49,50
Nature's Voice,0,0,0,0,1,1
The Bowery Boys: New York City History,2,2,0,0,46,50
Perry Mason,8,2,2,1,1,14
Shea Anything,6,3,11,5,41,66
Now Playing - The Movie Review Podcast,34,24,25,30,387,500
Woodworking with The Wood Whisperer (HD),0,0,0,0,21,21
The Cold-Case Christianity Podcast,5,1,2,3,72,83
20 min. Yoga Sessions from YogaDownload.com,1,3,1,8,37,50
Redleg Nation Radio: A Cincinnati Reds Podcast,2,3,2,6,76,89
IQ - Wissenschaft und Forschung,0,0,0,0,1,1
Naval Air,0,0,0,0,6,6
Chess Killer Tips Video Podcast with Alexandra Kosteniuk,2,0,0,5,13,20
BrainStuff,41,44,45,28,83,241
Fantasy Focus Football,117,46,30,23,283,499
Judaism's response to Christian Missionaries with Rabbi Tovia Singer,3,0,2,0,19,24
"Retirement Talk for Boomers, Seniors, and Retirees",0,0,2,1,45,48
John Eldredge and Wild at Heart (Audio),5,1,0,6,172,184
Star Trek: Lost Frontier,0,0,0,0,3,3
iMore show,23,13,13,16,197,262
Focus on Parenting Podcast,19,0,1,1,29,50
Focus on Marriage Podcast,4,1,6,7,32,50
Wormwood: A Serialized Mystery,4,2,2,6,36,50
Sesho's Anime And Manga Reviews,0,1,0,1,9,11
Learn Portuguese - BrazilianPodClass,1,1,0,3,32,37
Football Daily,28,10,15,16,71,140
The Spurs Show,0,3,1,3,13,20
Thinking Allowed,1,0,2,3,15,21
The History of Rome,2,2,2,1,43,50
Fantasy Football Today,4,4,1,9,482,500
Great Lives,3,3,0,1,17,24
Business Daily,7,0,4,4,25,40
6 Minute English,0,0,0,0,3,3
The English We Speak,1,0,1,1,9,12
Science in Action,0,1,1,2,9,13
RadioWest,3,2,0,5,89,99
Overeaters Anonymous Virtual Speakers Bureau,0,2,1,0,24,27
Learn Korean | KoreanClass101.com,4,0,3,2,13,22
Once Upon a Time in Vegas audio drama,0,0,1,2,9,12
North Point Community Church,6,0,1,0,86,93
Spanish Grammar Review,1,0,0,4,14,19
The Stoop Storytelling Series,1,1,3,3,25,33
Art History Podcast,0,0,1,0,2,3
National Gallery of Art | Audio,0,1,0,2,5,8
The Big Boo Cast,1,1,1,2,45,50
Coffee Break French,0,0,0,0,4,4
The WDW News Today Podcast - Standard,31,22,17,12,104,186
Ray Edwards Show,0,2,0,0,48,50
Medical Spanish Podcast,0,0,0,2,35,37
Plus podcast – Maths on the Move,0,1,0,0,2,3
Money Box,6,1,4,8,32,51
RPG Cast,5,0,3,8,27,43
Learn to Speak Spanish with Discover Spanish,3,2,1,2,42,50
Sesame Street Podcast,5,2,3,7,33,50
The Metamor City Podcast,1,1,2,1,45,50
Abnormal Psychology Lectures,4,0,0,2,6,12
Ancient Dragon Zen Gate Dharma Talks,0,1,0,0,2,3
Tara Brach,4,2,6,8,305,325
Friday Night Comedy from BBC Radio 4,294,78,80,64,286,802
The Bugle,6,2,1,2,127,138
The Archers,10,4,3,8,25,50
Neurology® Podcast,2,0,0,1,32,35
Creating a Family: Talk about Adoption & Foster Care,3,2,1,5,39,50
Gadget Lab: Weekly Tech News,2,6,1,4,22,35
Yarnspinners Tales's Podcast,0,1,0,2,19,22
Unbelievable?,2,0,5,9,127,143
The Strength Coach Podcast,1,2,4,2,41,50
Buddhist Temple of Toledo Podcast,0,0,0,0,13,13
Analysis,3,0,0,1,13,17
More or Less: Behind the Stats,8,5,2,3,75,93
Final Fantasy & Kingdom Hearts Union,1,4,1,2,42,50
Orson Welles On The Air,1,0,0,0,10,11
Live In Concert from NPR's All Songs Considered,3,3,9,8,109,132
The People's Pharmacy,2,2,0,2,44,50
Logical Weight Loss,4,3,4,5,34,50
The New Yorker: Politics and More,21,7,14,15,78,135
U.S. Presidents Podcast,6,0,2,4,3,15
Deutsch - warum nicht? Serie 1 | Deutsch lernen | Deutsche Welle,0,0,0,1,1,2
Deutsch - warum nicht? Series 2 | Learning German | Deutsche Welle,0,0,0,1,4,5
Modern Mentor,13,11,9,15,137,185
Classics For Kids,2,0,1,4,41,48
Wieso nicht? | Learning German | Deutsche Welle,0,0,0,0,2,2
Max Lucado,0,0,0,1,29,30
Eye On College Basketball,23,10,8,6,453,500
Recovered Podcast,1,0,1,1,47,50
Student Pilot Journal Aviation Podcast,1,0,0,0,11,12
Ramblings,0,0,0,0,16,16
No Agenda,9,5,3,0,33,50
Endurance Nation Podcast,0,1,0,0,15,16
All TWiT.tv Shows (Audio),3,2,2,2,25,34
The Solid Verbal - College Football Podcast,25,8,11,15,441,500
Poem Talk,3,0,0,1,10,14
Avant-Garde All the Time,1,0,0,1,5,7
The Poetry Magazine Podcast,0,0,2,1,12,15
Audio Poem of the Day,0,1,2,6,18,27
TGC Podcast,3,1,1,2,37,44
Pure Trance Radio Podcast with Solarstone,3,0,5,4,38,50
The Story Home Children's Audio Stories,18,3,2,2,25,50
The New Man,0,0,3,1,46,50
Learn Spanish | SpanishPod101.com,3,2,1,6,24,36
The Bigfoot Show,4,1,2,8,66,81
The Old Time Radio Superman Show,0,3,3,2,27,35
Living on the Edge with Chip Ingram Daily Podcast,2,0,2,1,112,117
One Minute German,0,0,3,3,6,12
MMA Junkie Radio,13,6,21,32,377,449
Talkin Mets with Mike Silva,18,4,5,1,41,69
Rick Steves Italy Audio Tours,0,0,0,2,17,19
Leadership and Loyalty™,0,0,0,0,6,6
www.MANMINDSET.com DATING SHOW FOR MEN,1,0,1,0,6,8
Useless Information Podcast,1,2,6,2,39,50
Celtic Myth Podshow,0,0,2,1,49,52
Fantasy Baseball from Prospect361.com,15,10,9,9,194,237
City Journal's 10 Blocks,5,1,2,0,42,50
Comic Book Club,3,5,3,2,45,58
Fantasy Baseball Today,23,5,10,12,350,400
Learn Italian | ItalianPod101.com,9,4,4,3,30,50
Hermetic Astrology Podcast,1,1,3,2,56,63
KunstlerCast - Suburban Sprawl: A Tragic Comedy,8,4,2,7,77,98
Hadar Institute Online Learning,0,1,0,0,3,4
Major Spoilers Comic Book Podcast,5,3,4,7,81,100
Peristyle Podcast - USC Trojan Football Discussion,5,2,5,6,219,237
Giant Bombcast,44,30,23,20,383,500
Ancient Warfare Podcast,3,4,2,10,31,50
The Truth About Money with Ric Edelman,18,10,5,8,33,74
Fantasy Focus Baseball,142,57,41,38,222,500
Gardenerd Tip of the Week,1,2,2,2,15,22
Tu Ingles! podcast,0,0,1,3,46,50
The Reflex Blue Show : A Graphic Design Podcast,0,1,2,1,6,10
The Moth,57,9,9,18,318,411
Apple Events (video),80,19,27,25,349,500
"Mantra, Kirtan and Stotra: Sanskrit Chants",1,1,0,0,8,10
Learn German | GermanPod101.com,6,4,4,11,16,41
PodCastle,3,2,2,6,37,50
Podcast Beyond - IGN's PlayStation Show,17,9,4,4,16,50
Game Scoop!,2,1,2,3,42,50
Podcast Unlocked,17,5,6,7,15,50
Nintendo Voice Chat,6,6,5,5,28,50
Be Our Guest WDW Podcast,8,12,13,13,454,500
the DharmaRealm,0,0,0,0,5,5
Relic Radio Thrillers (Old Time Radio),0,1,0,0,25,26
Bloomberg Law,28,7,14,4,15,68
Learn French | FrenchPod101.com,3,3,4,1,11,22
The Student Pilot Cast (mp3),0,0,0,0,4,4
Investing Insights,3,2,4,4,9,22
"Essential Tennis Podcast - Instruction, Lessons, Tips",0,1,0,4,191,196
Tokyo Midtown presents The Lifestyle MUSEUM,0,0,0,0,1,1
The World: Latest Edition,6,3,4,2,35,50
Knitmoregirls's Podcast,5,1,7,7,80,100
The Orvis Fly-Fishing Podcast,3,0,1,10,280,294
Radio Astronomy,0,0,0,0,1,1
Pop Culture Happy Hour,65,43,23,35,334,500
Stuff You Should Know,343,84,98,70,1421,2016
Slate Culture,28,23,12,9,128,200
LSE: Public lectures and events,0,0,0,1,1,2
The Dana Show with Dana Loesch,2,0,1,2,45,50
Social Psychology Lectures,2,0,0,0,2,4
The Language of Tarot - A Tarot Podcast,0,0,1,4,22,27
Culips Everyday English Podcast,0,0,0,1,49,50
Learn Arabic | ArabicPod101.com,3,2,2,0,7,14
The Look & Sound of Leadership,0,1,1,2,196,200
Valley Baptist Bakersfield Sermons Podcast,0,0,0,0,2,2
InvestTalk,28,22,23,22,100,195
Daily Kabbalah Lesson with Ari Goldwag,0,0,0,0,6,6
"Arseblog - the Arsecasts, Arsenal podcasts",3,2,5,0,490,500
BackStory,5,9,3,5,28,50
The /Filmcast (AKA The Slashfilmcast),60,29,21,24,366,500
Media Monarchy,1,0,1,0,12,14
Daily Daf Yomi with Ari Goldwag,0,0,0,0,4,4
Hoy por Hoy,4,0,1,1,0,6
TechStuff,46,43,17,32,288,426
Airplane Geeks Podcast,3,3,1,2,41,50
Langsam gesprochene Nachrichten | Deutsch lernen | Deutsche Welle,0,1,1,1,32,35
Top-Thema mit Vokabeln | Deutsch lernen | Deutsche Welle,0,0,0,0,3,3
Deutsche im Alltag - Alltagsdeutsch | Deutsch Lernen | Deutsche Welle,0,0,0,0,6,6
Reading Marx's Capital,0,0,0,1,3,4
Today's Walk Radio Podcast,0,0,0,0,4,4
Reading Marx's Capital (audio),0,0,0,0,7,7
Chop Bard,0,0,1,0,52,53
Stuff You Missed in History Class,134,76,58,64,386,718
Relic Radio Sci-Fi (old time radio),1,0,0,1,36,38
Snap Judgment,18,6,12,14,150,200
Ben Greenfield Fitness,10,2,2,0,36,50
The Survival Podcast,19,7,8,9,190,233
Dudes On Hockey,1,0,0,6,58,65
"Issues, Etc.",4,1,5,0,176,186
Market Wrap with Moe,7,1,2,2,16,28
RunRunLive 4.0 - Running Podcast,2,2,0,1,63,68
Learn Russian | RussianPod101.com,0,0,2,3,17,22
icqpodcast's Amateur / Ham Radio Podcast,0,0,0,1,3,4
Toolroom Radio,0,0,1,1,27,29
BLACK NIGHT MEDITATIONS - Underground Metal Radio,1,0,0,1,2,4
TMRO:Space,0,0,0,1,8,9
Never Not Knitting,2,2,2,10,50,66
"Dom, Meg & Randell Catchup Podcast - The Edge",8,2,2,4,62,78
inSocialWork - The Podcast Series of the University at Buffalo School of Social Work,0,0,0,0,2,2
the 12-Step Buddhist Podcast,0,0,2,1,9,12
THE RAGGED EDGE RADIO ....with Russ Dizdar,2,1,0,0,29,32
Above & Beyond: Group Therapy,8,1,13,13,465,500
Money Clinic with Claer Barrett,0,0,1,1,3,5
Ask the Naked Scientists,0,1,0,0,10,11
#321,0,1,2,0,13,16
Mousetalgia! - Your Disneyland Podcast,5,8,4,9,307,333
Love Worth Finding on Oneplace.com,0,2,3,3,141,149
Sarah and Vinnie Full Show,5,2,3,6,34,50
Matinee Movies,1,0,1,0,1,3
Science Fiction Theater,1,0,0,1,4,6
Mystery Theatre,2,1,1,1,18,23
NEI Podcast,0,0,1,2,2,5
Clarkesworld Magazine - Science Fiction & Fantasy,5,4,4,7,30,50
The Public Speaker's Quick and Dirty Tips for Improving Your Communication Skills,4,7,4,14,121,150
Dinosaurs: Before They Were Fuels (mp3),0,0,0,0,1,1
The Brewing Network Presents |  Brew Strong,2,4,1,1,19,27
MotorWeek,3,2,4,2,17,28
French Verb Drills (French Today),0,0,0,0,3,3
Freight Train Boogie Podcasts,0,0,0,0,14,14
The Nutrition Diva's Quick and Dirty Tips for Eating Well and Feeling Fabulous,5,6,8,6,25,50
Nicolas Canteloup - La revue de presque sur Europe 1,0,0,0,3,11,14
Meet the Microbiologist,0,0,0,2,3,5
Andy Stanley Leadership Podcast,5,1,4,6,119,135
La Ventana,3,0,0,0,3,6
Meditation Peace - Guided Meditations audio podcast,0,0,0,2,11,13
Laurent Gerra,2,0,0,1,10,13
Old Time Radio Mystery Theater,0,0,0,3,32,35
Biology 2110-2120: Anatomy and Physiology with Doc C,7,6,1,2,28,44
The Reality Check,6,6,3,4,64,83
AOPA Never Again,0,0,2,1,15,18
Biology 3020 -- Pathophysiology with Doc C,1,0,0,1,22,24
Planet Money,69,18,12,21,324,444
Focus on the Family Broadcast,5,2,0,1,42,50
Japanese Classical Literature Audiobooks,0,1,0,0,7,8
Torah Talk,0,0,0,0,5,5
Original Science Fiction – Makeshift Stories,0,0,1,1,10,12
Poetry Lectures,1,0,0,0,2,3
Essential American Poets,1,0,0,2,3,6
NEJM Journal Watch Podcasts: Clinical Conversations,0,1,0,0,4,5
All CNET Video Podcasts (video),3,0,5,2,17,27
Show Time Spanish,1,1,0,2,37,41
THEMIXLAB,0,0,0,1,3,4
Grace to You: Radio Podcast,1,0,0,0,77,78
The Gospel Truth,2,0,0,1,60,63
Surgery 101,1,0,0,5,9,15
Bowery Boys Archive: The Early Years,2,1,0,2,57,62
Brian Windhorst & The Hoop Collective,156,65,58,33,188,500
Calvary Chapel Kaneohe,0,1,0,0,9,10
Two Chairs No Waiting Andy Griffith Show Fan Podcast,0,0,0,1,34,35
Big Mad Morning Show,4,1,0,2,43,50
MSNBC Rachel Maddow (video),7,2,4,5,32,50
The Rachel Maddow Show,84,3,15,18,177,297
"""The Scarlet Letter"" Audiobook (Audio book)",5,0,2,8,21,36
The Art of Photography,4,1,1,7,87,100
Marketplace All-in-One,7,5,4,9,54,79
The Insightful Leader,0,0,1,0,4,5
Grace to You: Pulpit Podcast,6,0,2,0,41,49
"The 365 Days of Astronomy, the daily podcast of the International Year of Astronomy 2009",0,0,2,7,33,42
The Classic Metal Show,17,1,2,1,29,50
Dermcast.tv Dermatology Podcasts,0,0,0,0,15,15
Tritonia,2,3,4,6,44,59
Bloomberg Surveillance,56,16,13,4,66,155
The Child Whisperer Podcast with Carol Tuttle & Anne Brown,1,1,0,0,25,27
World Cricket Show,0,0,1,2,27,30
Climate One,1,0,0,1,27,29
CarStuff,7,7,2,3,31,50
"Question of the Week, from the Naked Scientists",0,0,0,0,1,1
Waffle On Podcast,0,0,0,1,13,14
AES Journal Podcast,0,0,1,0,2,3
the memory palace,0,2,1,4,43,50
Career Tools,3,3,7,4,54,71
Music and the Brain,0,0,0,3,1,4
Dharma Seed - dharmaseed.org: dharma talks and meditation instruction,0,0,1,3,11,15
"Walk, Talk and Learn French",0,0,0,1,33,34
Starship Excelsior: A Star Trek Fan Audio Drama,0,0,0,3,18,21
Tennis Psychology Podcast,1,0,0,1,3,5
The Bitcoin Knowledge Podcast,0,0,0,0,8,8
Anything Ghost Show,5,5,11,20,328,369
Rebel FM,2,3,0,1,44,50
The Naturist Living Show,1,0,0,0,37,38
LogoTalk Radio,0,0,0,0,2,2
Law of Attraction Talk Radio,8,2,2,0,19,31
People and Projects Podcast: Project Management Podcast,0,0,0,0,31,31
cocktailnation,0,0,0,0,16,16
"CNBC's ""Options Action""",11,3,5,1,18,38
Peach And Black - A Podcast About Prince,0,0,3,5,19,27
SEO Podcast The Unknown Secrets of Internet Marketing,9,5,2,0,34,50
UN News,0,0,1,1,6,8
The Chad Benson Show,0,0,0,0,16,16
First Draft,19,13,18,15,95,160
The Leviathan Chronicles,4,3,4,4,35,50
Switch Hit Podcast,1,0,0,2,3,6
Science for the People,1,2,1,3,30,37
SANS Internet Stormcenter Daily Network/Cyber Security and Information Security Stormcast,0,1,0,1,48,50
DH Unplugged,5,5,2,7,29,48
Spanish Podcast,5,2,4,0,39,50
Serving Worlds,0,0,1,2,19,22
Reading And Writing Podcast,0,1,0,4,32,37
Motley Fool Money,10,6,6,22,146,190
Noticias ONU,0,0,0,1,0,1
The Whole Child Podcast: Changing the Conversation About Education,0,1,0,0,1,2
Adam Carolla Show,60,30,30,22,154,296
Tri Swim Coach Triathlon Swimming Podcast,0,0,0,12,50,62
The World Next Week,7,3,5,6,61,82
Sound Retirement Radio,3,2,3,3,36,47
"Voice Over Training | Complete Training, Demo Development & Support",0,0,0,2,2,4
Three Moves Ahead,4,1,2,8,78,93
Seattle Insight Meditation Society,0,0,0,0,4,4
How She Really Does It,0,1,0,0,49,50
Superscoreboard,30,9,12,10,32,93
Perfecto Podcast: featuring Paul Oakenfold,2,5,2,7,52,68
Sustainable World Radio- Ecology and Permaculture Podcast,1,0,0,2,41,44
Erotic Awakening Podcast,4,0,1,4,66,75
Sounds True: Insights at the Edge,2,3,2,12,139,158
Pilots Journey Aviation Podcast,0,0,0,1,10,11
Iron Radio,0,0,0,2,48,50
A Mediocre Time with Tom and Dan,2,5,1,1,41,50
The Frank Skinner Show,4,0,4,4,37,49
Pharmacy Podcast Network,0,0,0,0,38,38
The Creative Penn Podcast For Writers,1,0,1,1,115,118
Smart Wrestling Fan,20,14,9,6,139,188
The Starting Zone: The World of Warcraft Podcast!,4,1,0,0,45,50
Common Ground Meditation Center: dharma talks and meditation instruction,0,0,0,0,6,6
Jim Harold's Campfire,13,8,16,11,452,500
WHY? - Philosophical Discussions About Everyday Life,0,0,0,0,4,4
The Psychology of Attractiveness Podcast,0,0,1,3,15,19
The Dog Trainer's Quick and Dirty Tips for Teaching and Caring for Your Pet,0,1,3,0,29,33
Luke's ENGLISH Podcast - Learn British English with Luke Thompson,0,1,0,0,45,46
Mormon Stories - LDS,62,10,14,6,408,500
"Your Money, Your Wealth",1,0,0,1,46,48
Solomonster Sounds Off,8,5,3,3,405,424
Anne Ortelee Weekly Weather Astrology,10,0,2,1,37,50
We're Alive,0,1,2,1,46,50
Against the Stream,2,1,2,1,35,41
Editor's Picks from The Economist,0,0,0,1,2,3
EMCrit Podcast - Critical Care and Resuscitation,0,1,0,1,48,50
BroadwayRadio,3,4,3,6,69,85
This Week in Startups - Video,8,3,2,8,65,86
This Week in Startups - Audio,18,11,9,8,265,311
IGN.com - Daily Fix (Video),10,0,8,9,82,109
IGN.com - Game Scoop! TV (Video),5,0,0,1,34,40
Show Archives – Armed American Radio |,8,1,5,3,33,50
Comedy Bang Bang: The Podcast,4,2,0,2,42,50
Learn Chinese | ChineseClass101.com,0,0,0,1,8,9
Voddie Baucham on SermonAudio,0,0,0,1,16,17
The MuscleCar Place,0,0,2,0,48,50
Recovery Radio Network,1,1,1,1,13,17
The Dressage Radio Show,0,0,0,0,10,10
Rooster Teeth Podcast,20,9,4,1,16,50
The Partially Examined Life Philosophy Podcast,7,11,3,12,272,305
The Reith Lectures,1,0,0,1,3,5
The Horse Racing Radio Network Podcast,1,1,0,0,7,9
Helping Writers Become Authors,1,5,3,1,128,138
Bhagavad Gita Discourses,0,0,0,0,2,2
MMA Fighting,26,9,11,14,323,383
The Strenuous Life Podcast with Stephan Kesting,1,1,2,3,74,81
Horse Tip Daily,0,0,0,0,1,1
Elucidations,0,0,0,0,33,33
Learn English | EnglishClass101.com,1,0,1,0,1,3
Insight Meditation Society - Forest Refuge: dharma talks and meditation instruction,0,0,0,1,1,2
Cut The Fat Weight Loss Podcast,2,1,0,1,46,50
Cheap Astronomy Podcasts,0,0,0,2,17,19
Couch to 5K (C25K) 5K101.com,0,1,0,2,47,50
CarCast,11,5,7,8,19,50
BreakPoint,4,1,2,4,74,85
Sri Rama Lila Ramayana,0,0,0,0,3,3
The Livin' La Vida Low-Carb Show With Jimmy Moore,9,3,2,3,33,50
"Naked Scientists, In Short Special Editions Podcast",1,0,0,0,1,2
Anime Addicts Anonymous,7,2,6,5,415,435
MonsterTalk,16,13,13,29,319,390
StarTalk Radio,0,0,0,0,8,8
The Porch,4,0,3,1,81,89
Gardeners' Question Time,1,0,1,0,18,20
Renaissance English History Podcast: A Show About the Tudors,4,1,3,1,41,50
This Week in Google (Audio),29,22,19,9,91,170
The Tape,15,7,12,4,24,62
Rick Steves Travel Talks,2,0,0,0,6,8
WSCAL - Office Hours,1,0,0,0,11,12
Rime Buddhist Center Dharma Talks,1,0,0,1,1,3
Ganesha - Ganesha selections read from The Lilas of the Sons of Shiva’s by Vanamali Mataji.    This ...,0,0,0,0,1,1
Blue Moon Podcast - A Manchester City Show,0,1,0,2,24,27
Fitzdog Radio,6,4,2,2,36,50
"Total Soccer Show: USMNT, Champions League, EPL, and more ...",14,6,15,12,453,500
Critical Hit: A Major Spoilers RPG Podcast,0,2,2,1,45,50
No Question About That - a Manchester United podcast,1,0,0,2,113,116
The Brutal Truth About Sales & Selling - B2B Social SaaStr Cold Calling SaaS Salesman Advanced Hacke...,6,1,4,4,185,200
This Week in Travel,4,4,4,3,29,44
Design Matters with Debbie Millman,1,4,2,1,128,136
Rob Has a Podcast | Survivor / Big Brother / Amazing Race - RHAP,19,13,10,8,449,499
the Building Performance Podcast,0,0,0,2,18,20
Escape From Illustration Island,0,0,0,2,27,29
The Shared Security Show,1,0,0,2,6,9
Deen Over Dunya,0,1,0,1,7,9
WTF with Marc Maron Podcast,102,38,62,42,756,1000
The Marty Sheargold Show  - Triple M Melbourne 105.1,20,4,10,9,32,75
Mysterious Universe,85,19,23,17,356,500
The Conspiracy Show with Richard Syrett,33,8,6,5,79,131
PedsCases: Pediatric Education Online,2,2,0,2,9,15
Shadow Nation,4,1,0,1,7,13
Talking Flutes!,0,0,0,0,1,1
Cruise Radio,2,2,1,3,171,179
Wildcat Radio: Arizona Football. Arizona Basketball,1,0,0,1,23,25
MGoBlog: The MGoPodcast,14,1,0,2,71,88
Quran Talk,9,0,0,0,14,23
Gardeners' Corner,0,0,0,0,6,6
Genesis Avalon audio drama,0,2,1,2,6,11
The Art of Manliness,11,2,4,12,471,500
Astronomy 141 - Life in the Universe - Autumn Quarter 2009,0,0,0,0,29,29
The Secular Buddhist,1,1,1,0,12,15
Science... sort of,8,5,7,14,325,359
Curry Smugglers - Bollywood | Hindi | Desi | Bhangra | Chill | Indian,0,0,0,2,18,20
Prophecyzoneradionews,2,0,1,1,1,5
Outlook,1,0,1,0,26,28
Criterion Cast: Master Audio Feed,5,1,0,4,50,60
Joseph Prince Audio Podcast,0,0,0,0,6,6
K-12 Greatest Hits:The Best Ideas in Education,0,0,2,0,3,5
The Social-Engineer Podcast,2,4,3,1,17,27
RISK!,25,10,16,10,139,200
The Game Informer Show,10,3,8,4,25,50
The Great Detectives of Old Time Radio,5,3,9,13,170,200
The Un-Billable Hour,0,0,0,0,3,3
Podcasts – Weird Things,11,6,7,5,112,141
Churchome with Judah Smith,4,3,4,3,74,88
Amaravati Podcast | Latest Dhamma Talks,0,0,0,0,3,3
IGN UK Podcast,2,0,1,0,46,49
Old Time Radio Westerns,1,1,0,4,46,52
Judge John Hodgman,6,2,0,0,42,50
Living Zen Podcast,1,0,0,1,57,59
Carry the One Radio: The Science Podcast,0,0,0,0,11,11
The Marital Intimacy Show,1,0,0,0,6,7
Audio Dharma: Gil Fronsdal's most recent Dharma talks,1,0,0,0,31,32
The Archers Omnibus,58,7,14,13,49,141
Tibetan Buddhist teachings and meditations,0,0,0,0,1,1
Village Zendo Teacher Talks,0,0,0,0,1,1
The Architecture Happy Hour,1,0,0,0,9,10
The Tobolowsky Files,1,1,1,3,494,500
Dishing Up Nutrition,9,5,3,4,29,50
TENNIS.com Podcast,3,4,6,4,31,48
Witness History,6,0,3,4,31,44
Bayyinah Institute,0,0,0,2,88,90
"Robb Wolf - The Paleo Solution Podcast - Paleo diet, nutrition, fitness, and health",5,4,1,4,35,49
This Week in Parasitism,0,1,1,1,116,119
Mojo For Running Podcast,2,1,0,6,195,204
RJ Bell's Dream Preview,70,42,47,23,223,405
Shnayim Mikra,0,0,0,1,4,5
Introduction to Psychology,2,2,0,5,13,22
Neuroscience & Behavior,0,1,0,0,2,3
Introduction to Computer Science and Programming,0,1,1,3,19,24
The Changelog: Software Dev & Open Source,0,0,0,1,33,34
"The Civil War and Reconstruction Era, 1845-1877 - Audio",3,0,0,1,46,50
Ancient Greek History - Audio,7,0,6,5,32,50
Psychology - Audio,0,0,0,0,14,14
Psychology - Video,0,1,1,2,21,25
"Wall Street Unplugged - Your Best Source for Finance, Investing & Economics",22,8,1,7,162,200
Desert Island Discs,0,0,0,0,18,18
The Food Programme,0,0,0,1,11,12
The Chris Voss Show,0,0,1,0,15,16
The Infinite Monkey Cage,46,16,28,40,458,588
Cooking with Paula McIntyre,0,0,0,0,2,2
Shannon Cason's Homemade Stories,1,1,1,7,190,200
"Kate, Tim and Joel",17,3,5,11,137,173
"Kid Friday - apps, websites, gadgets, games, fun!",2,0,2,2,44,50
Aro Buddhism Podcasts,0,0,0,0,4,4
Zenbitchslap Talks,1,0,0,2,7,10
PUCL: A Pokemon Podcast,3,1,1,1,44,50
Aeon Byte Gnostic Radio,4,3,3,3,39,52
Sadhguru,3,0,2,0,41,46
Sadhguru's Podcast,3,0,2,0,41,46
Best Stocks Now with Bill Gunderson,7,1,1,0,16,25
Anxiety Slayer™ with Shann and Ananga,5,0,1,3,41,50
This Week in Computer Hardware (Audio),8,2,7,3,29,49
TWiT News (Audio),0,0,0,0,10,10
Geek News Central Podcast (Video),0,1,0,0,4,5
"Naked Astronomy, from the Naked Scientists",0,0,0,0,11,11
The Square Ball: Leeds United Podcast,0,1,1,0,8,10
The Steve Matthes Show on RacerX,0,1,0,0,60,61
Spilled Milk,12,13,7,13,155,200
The PulpMX.com Show,9,1,3,2,117,132
New World Witchery - The Search for American Traditional Witchcraft,0,1,1,5,99,106
ONE Extraordinary Marriage Show,2,0,7,2,39,50
Korean Podcast for Beginners,0,0,0,0,1,1
Marathon Talk,0,1,0,0,42,43
Mangala Shri Bhuti - The Link,0,0,0,0,2,2
Strange Tales (Old Time Radio),0,0,0,4,43,47
Stuff To Blow Your Mind,37,30,31,32,370,500
Duncan Trussell Family Hour,4,1,2,5,38,50
The Sporkful,19,7,9,14,151,200
Know Direction Network,1,1,0,3,14,19
Talk To Me In Korean,0,0,2,0,46,48
A History of the World in 100 Objects,2,1,1,3,43,50
A Taste of the Past,7,10,4,3,21,45
Rationally Speaking Podcast,5,2,3,4,68,82
Paul van Dyk's VONYC Sessions Podcast,2,3,0,4,53,62
BacterioFiles,1,0,0,2,4,7
Timothy Keller Sermons Podcast by Gospel in Life,0,0,1,0,16,17
Messianic Messages with Izzy (Audio),1,0,0,0,7,8
The Gary Null Show,2,1,1,2,41,47
For Crying Out Loud,18,6,5,1,20,50
Hockey Central,35,13,14,13,51,126
Life on the Swingset - The Swinging & Polyamory Podcast,1,3,1,1,44,50
Freakonomics Radio,266,98,98,126,1155,1743
Rick Steves Britain & Ireland Audio Tours,0,0,0,0,3,3
Mahabharata Podcast,0,0,1,2,77,80
ID10T with Chris Hardwick,10,1,6,1,32,50
Today's Homeowner Podcast,0,0,1,0,10,11
The Math Dude Quick and Dirty Tips to Make Math Easier,1,0,3,4,42,50
The Hackers Paradise,3,0,0,2,48,53
Newshour,14,2,4,2,31,53
FanGraphs Baseball,18,4,8,17,91,138
Project Camelot,3,1,1,0,3,8
White Horse Inn,6,1,2,11,121,141
Hangar49,0,0,0,1,6,7
Three Guys On,0,0,0,1,49,50
NPR's Mountain Stage,2,0,0,1,32,35
Tell Em Steve-Dave,1,0,1,0,48,50
Lawdibles Audio – Lawdibles,0,1,2,0,0,3
RTL Matin,5,0,0,1,0,6
Government Accountability Office (GAO) Podcast: Watchdog Report,1,0,0,1,10,12
Home Studio Corner Podcast,0,0,0,1,49,50
Marathon Training Academy,0,1,0,1,48,50
Monstercat Silk Showcase,0,0,0,1,13,14
The Joe Rogan Experience,560,66,104,98,1172,2000
The FrogPants Studios Ultra Feed!,5,0,0,0,84,89
The Rush Hour Melbourne Catch Up - 105.1 Triple M Melbourne - James Brayshaw and Billy Brownless,8,2,3,5,61,79
The Bible Geek Show,1,2,2,5,58,68
This is Only a Test,8,17,11,13,127,176
This Week in League NRL Podcast,0,0,0,0,7,7
psychicteachers,4,3,0,1,42,50
Tiny Desk Concerts - Video,2,2,3,5,38,50
Beer Sessions Radio (TM),0,0,0,1,5,6
The Takeaway,7,6,5,2,27,47
Irish History Podcast,0,0,1,1,48,50
NBA Hang Time,9,0,8,5,36,58
MLF Bass Fishing Podcast,3,2,0,1,6,12
The Potter's Touch on Lightsource.com,0,0,0,0,9,9
Yosemite Trip Planning,1,0,0,0,1,2
"Veterinary Advice, Animal News & Views with hosts, Dr. Roger Welton & Dr. Karen Louis",0,1,0,1,7,9
Expanding Mind,0,0,3,5,45,53
Aaron's World,0,0,1,0,32,33
"Homilies by Fr. Richard Rohr, OFM",1,2,1,2,49,55
"My Brother, My Brother And Me",22,4,17,12,444,499
The Sports Junkies,33,9,10,16,119,187
Podcast Kid,3,1,1,4,33,42
Jason & Alexis,1,1,0,0,24,26
Lori & Julia,3,0,1,2,11,17
iRunFar,0,0,0,1,2,3
The Independent Characters - A Warhammer 40k Podcast | Radio,1,3,0,0,46,50
Taking Control: The ADHD Podcast,1,2,2,0,45,50
Sacredlearning All Podcast,0,0,0,0,12,12
The Strong Towns Podcast,0,1,1,2,37,41
Hypnosis With Joseph Clough,0,0,1,0,49,50
The H.P. Lovecraft Literary Podcast,0,2,3,4,191,200
Bass Fishing Tactics Videos [BassFishin.Com],0,0,0,2,4,6
Zencare Podcast,0,0,1,0,4,5
Military Mom Talk Radio,0,0,0,0,6,6
Russian Rulers History Podcast,2,3,2,2,41,50
"Robert Kelly's ""You Know What Dude!""",8,3,5,5,29,50
Family Talk on Oneplace.com,1,0,1,0,50,52
Get-Fit Guy's Quick and Dirty Tips to Get Moving and Shape Up,4,7,1,7,31,50
Revolution Health Radio,3,1,3,4,39,50
The Off-Kilter Quilt,0,0,0,0,50,50
The Digital Marketing Podcast,0,1,0,0,20,21
Your Money Minute,3,5,1,3,12,24
Krishna's Mercy,0,0,0,0,2,2
From The Rookery End - A show about Watford FC,0,0,0,0,7,7
Model Railroad Hobbyist,1,2,3,2,4,12
Tech News Weekly (Audio),122,29,28,35,222,436
LIGHTSPEED MAGAZINE - Science Fiction and Fantasy Story Podcast (Sci-Fi | Audiobook | Short Stories),2,0,5,5,38,50
Podcast from Italy: Ashley & Jason Bartner,0,0,0,2,52,54
Transformation Church - Audio Podcast,0,0,0,0,10,10
Positively Dog Training - The Official Victoria Stilwell Podcast,9,3,1,2,6,21
Inside The Mind of Teens and Tweens,2,0,1,0,1,4
ABA Journal Podcasts - Legal Talk Network,0,0,0,2,1,3
Did This Happen?,0,0,1,0,4,5
Frank Delaney's Re: Joyce,0,0,0,0,37,37
Fareed Zakaria GPS,25,13,17,15,138,208
"ExtraTime, the Official Podcast of Major League Soccer (MLS)",18,12,24,23,197,274
Alison Rosen Is Your New Best Friend,5,1,0,3,41,50
FT News in Focus,2,2,1,0,3,8
Astral Projection Podcast,0,1,0,0,10,11
The Beekeeper's Corner Beekeeping Podcast,4,0,2,0,44,50
The Wired Homeschool,0,0,0,0,15,15
"Space, Time and Consciousness - for iPod/iPhone",0,0,0,0,6,6
Deep Sunset House and Progressive Podcast - The Melodic Sessions by Prototype 202,0,0,0,1,42,43
Cooking Issues,3,1,0,3,27,34
Anthropology,1,0,0,0,0,1
The Morning Rumble Catchup Podcast,1,0,0,0,10,11
Knitting Pipeline,0,0,0,0,50,50
BlogAid WordPress Tips Tuesday,1,0,0,0,20,21
The Bob Cesca Show,16,4,6,5,285,316
Learn Greek | GreekPod101.com,1,0,0,0,1,2
Learn Portuguese | PortuguesePod101.com,3,0,0,1,5,9
Classical Podcasts,1,2,1,1,4,9
Perry Nickelston: Stop Chasing Pain,0,0,1,2,18,21
History of Art,4,1,0,1,0,6
Nietzsche on Mind and Nature,0,0,0,0,1,1
General Philosophy,0,0,1,2,3,6
Quantum Mechanics,2,0,0,1,7,10
Philosophy for Beginners,0,0,3,0,11,14
iOS Today (Audio),16,11,10,16,54,107
Intro to Buddhism,1,1,0,0,1,3
The Dave Hill Goodtime Hour (Formerly known as Dave Hill's Podcasting Incident and The Goddamn Dave ...,4,2,1,0,43,50
The Walking Dead ‘Cast,46,13,14,23,404,500
The Smart Passive Income Online Business and Blogging Podcast,7,3,2,2,186,200
Tafseer Quran - Shaarawy,1,1,0,1,17,20
Our Daily Bread Podcast | Our Daily Bread,1,2,3,2,42,50
LetsRun.com's Track Talk,6,2,1,0,37,46
Behind the Bets with Doug Kezirian,6,2,4,16,102,130
It's Rainmaking Time!®,0,0,0,1,12,13
Machine Learning,0,0,0,1,7,8
Spider-Man Crawlspace Podcast,5,4,3,2,36,50
In the Loop,1,0,1,1,30,33
Crime and Punishment,0,1,0,1,7,9
Dracula,0,0,2,0,8,10
It's Super Effective: A Pokemon Podcast,1,1,5,1,42,50
The Hermetic Hour,1,3,4,1,27,36
Limited Resources,1,0,0,2,47,50
Yokoji Zen Dharma Talks,0,1,0,0,10,11
The Science of Everything Podcast,1,0,2,5,105,113
The Save or Die Podcast!,4,1,3,2,40,50
Green Tech Today (Audio),0,0,0,0,2,2
Heart and Hand - The Rangers Podcast,0,0,1,1,8,10
Boomer & Gio,15,1,8,7,45,76
Carton & Roberts,23,3,9,5,63,103
Green Tech Today (Video),1,1,0,0,6,8
NEJM This Week — Audio Summaries,1,5,3,0,15,24
"The Sodshow, Garden Podcast - Sod Show",0,0,0,0,6,6
Story Worthy,1,2,1,4,42,50
The Amp Hour Electronics Podcast,0,0,1,0,34,35
Ending The Sexual Dark Age,0,2,0,0,48,50
The Tolkien Professor,0,1,1,3,10,15
C-SPAN Radio - Washington Today,2,1,3,3,17,26
Psychology,1,0,1,1,4,7
Resident by Hernan Cattaneo,0,0,2,4,31,37
Locked-Up: Prison in America,0,0,0,0,2,2
WallBuilders Live! with David Barton & Rick Green,6,2,2,1,87,98
Critical Reasoning for Beginners,1,4,2,3,9,19
Black Agenda Radio,3,1,0,1,24,29
Sonic Daydream,0,0,0,0,1,1
Portland Center for Spiritual Living Podcast,0,0,0,0,3,3
Daily Halacha Podcast - Daily Halacha By Rabbi Eli J. Mansour,0,0,0,0,9,9
Rex Factor,0,0,0,3,47,50
Talking Fussball,1,2,0,1,33,37
Advanced Clinical Pathophysiology (NUR 6951),0,0,0,1,17,18
Larry Miller Show,1,0,3,3,43,50
Les Enjeux internationaux,1,1,0,0,0,2
Les Chemins de la philosophie,0,0,0,0,1,1
La Revue de presse internationale,0,0,0,0,1,1
The Briefing - AlbertMohler.com,17,6,11,12,318,364
Thinking in Public - AlbertMohler.com,0,1,2,2,27,32
Locked On Jazz - Daily Podcast On The Utah Jazz,12,6,6,8,468,500
Toute une vie,0,0,0,1,1,2
The Chels - The Chelsea Podcast,0,1,1,2,9,13
Dr. Ross Greene,2,0,3,0,5,10
Buddhism on Air,0,0,0,0,5,5
Sex Chat with Dr. Kat and her Gay BF | Sexual Relationships Marriage and Dating Advice,2,0,0,1,17,20
The Twilight Zone Podcast,0,1,1,4,164,170
Bloomberg Businessweek,17,6,3,4,9,39
FIGARINO Geschichten,0,0,0,0,4,4
True Murder: The Most Shocking Killers,17,8,18,14,43,100
8-4 Play,13,4,8,8,184,217
DJcity Podcast,0,0,0,4,41,45
Edict Zero - FIS,4,1,0,4,80,89
Notes on the Week Ahead,2,0,2,0,2,6
NHS Couch to 5K,6,2,2,9,113,132
PBS NewsHour - Full Show,11,5,9,5,75,105
The Fretboard Journal Guitar Podcast,0,0,2,0,36,38
100 Words Or Less: The Podcast,2,3,3,10,116,134
99% Invisible,132,60,60,54,978,1284
Insights Now,2,0,1,0,3,6
Nauka XXI wieku,0,0,0,0,5,5
"MouseChat.net – Disney, Universal, Orlando FL News & Reviews",40,22,25,17,206,310
Geek's Guide to the Galaxy - A Science Fiction Podcast,14,9,8,11,158,200
The Story Collider,3,9,12,11,63,98
Cyclone Fanatic Podcast Network,3,3,1,1,42,50
History of Philosophy Without Any Gaps,1,2,1,5,105,114
The Shaft - A Minecraft Podcast,2,0,2,2,44,50
Coping with Depression - for iPod/iPhone,1,0,0,0,2,3
Baking & Pastry,2,1,1,2,8,14
BeerSmith Home and Beer Brewing Podcast,1,1,4,7,25,38
The Tournament Poker Edge Podcast,1,0,0,1,43,45
WordPress Plugins from A to Z,2,1,3,4,40,50
Bakugan Podcast,1,0,0,1,6,8
Approaching Shakespeare,1,1,0,1,15,18
In The Pattern Podcast,0,0,0,0,7,7
Left Handed Radio | A Sketch Comedy Podcast,1,1,0,2,46,50
"Developmental Psychology, Fall 2008",0,0,0,0,1,1
The Permaculture Podcast,0,1,0,2,50,53
Passion City Church Podcast,1,0,1,0,81,83
On Iowa Podcast,1,1,3,3,34,42
Felger & Massarotti,21,5,6,1,39,72
The David Pakman Show,15,9,7,12,234,277
The Majority Report with Sam Seder,35,19,19,8,419,500
"The Copyblogger Podcast: Content Marketing, Copywriting, and Social Media Marketing",2,3,2,7,107,121
The KiddChris Show,0,0,0,0,10,10
The Easiest Way to Learn the Tarot--EVER!!,0,0,2,3,12,17
Human Behavioral Biology,0,0,0,0,32,32
The WIRED Podcast,2,0,1,0,6,9
The Peter Schiff Show Podcast,28,5,6,4,157,200
Audio Tutor | Learning German | Deutsche Welle,0,0,1,0,4,5
We Hate Movies,23,14,10,16,437,500
Runner's Block,0,0,0,1,49,50
Knifepoint Horror,1,3,3,8,185,200
Tony Evans' Sermons on Oneplace.com,4,1,3,5,233,246
The Attractions Podcast,2,1,1,3,31,38
The Thrilling Adventure Hour,3,3,3,2,39,50
Learn Persian with Chai and Conversation,0,0,1,0,49,50
How Did This Get Made?,2,3,2,0,43,50
Tony Martignetti Nonprofit Radio,0,0,1,2,39,42
Spice | Romantic Stories of Love | Sex Charged Audio Stories Podcast,0,0,1,1,2,4
Conversations with Dr Bauchner,1,0,0,1,11,13
Under The Hood show,2,1,4,4,39,50
Emergency Medicine Cases,0,1,0,1,33,35
Comedy of the Week,7,3,1,5,3,19
TheThinkingAtheist,13,5,12,7,281,318
The History of England,1,0,0,0,49,50
Dragnet,0,0,0,2,9,11
The Longest Shortest Time,8,3,6,4,29,50
Catholic Stuff You Should Know,19,11,11,13,446,500
I Love Marketing,2,2,3,0,43,50
The Kyle & Jackie O Show,23,1,4,7,62,97
Alt.Latino,1,2,2,5,49,59
MarketFoolery,6,3,7,10,229,255
Awesome Vegans with Elysabeth Alfano,0,0,1,0,2,3
Wine for Normal People,8,11,5,10,166,200
Astrology & The Hermetic Arts: Holes to Heavens,1,0,3,3,273,280
Adam Beyer presents Drumcode,0,0,0,1,30,31
"Murphy, Sam & Jodi",1,0,2,1,4,8
Zen Parenting Radio,1,1,2,0,46,50
Eventual Millionaire Podcast,1,3,1,2,93,100
New Solo,1,0,0,0,18,19
"Jeep Talk Show, A Jeep podcast!",4,5,2,2,37,50
Dig Me Out - The 90s rock podcast,3,2,0,3,24,32
The Rizzuto Show,2,0,0,0,48,50
Back to Work,32,22,10,21,402,487
The Soulless Minions of Orthodoxy - Movie Commentaries,0,0,0,3,3,6
In The Rabbit Hole Urban Survival,1,0,2,4,85,92
The History Chicks,1,1,1,2,45,50
Driven Car Reviews,1,0,0,2,47,50
3 Martini Lunch,10,3,2,2,33,50
Breastfeeding Medicine Podcast,0,0,0,0,3,3
Treeleaf Zendo Podcasts,0,0,0,0,1,1
Cleveland Moto,2,0,1,3,44,50
Footballistically Arsenal,5,1,3,2,3,14
The Cloudcast,0,0,0,3,18,21
Fox News Sunday Audio Podcast,29,5,2,2,12,50
HCG Body For Life -How To Burn The Fat and Reveal The Muscle,1,0,0,0,11,12
Keeping It Real: Conversations with Jillian Michaels,11,5,4,4,26,50
Inside Forbes India,1,0,1,1,2,5
Journal de 19h,0,0,0,0,2,2
MASH 4077 Podcast,4,1,6,3,56,70
Ludology,2,1,0,5,42,50
11:11 Talk Radio,2,0,1,1,11,15
"Get In The Door Podcast | Sales Leadership, Training and Development by Scott ""The Professor""- Plum ...",2,0,1,1,48,52
Great Ideas in Psychology Podcast,0,0,0,0,13,13
Moonlight Audio Theatre,0,0,0,1,11,12
Nintendo Pulse – Nintendo Switch and 3DS News,1,0,1,1,47,50
The Creative Coding Podcast,0,0,0,2,22,24
The Familyman Show,0,1,0,0,20,21
Arming the Donkeys,1,0,0,1,5,7
How To Do Everything,17,4,5,17,213,256
Steve Dale's Pet World,0,0,0,0,1,1
Westminster Hour,3,0,0,0,0,3
The Projection Booth Podcast,2,4,0,5,136,147
Drama of the Week,3,1,2,3,29,38
This Week in Microbiology,0,1,0,2,92,95
The Sweep Spot - Former Disneyland Cast Members Talking Disneyland,0,3,6,8,136,153
Qalam Institute Podcast,0,0,1,1,46,48
The Parsha In My Life - By Rabbi Reuven Wolf - Maayon Yisroel,0,0,0,0,1,1
PSYC 213: Abnormal Psychology (DSM-IV-TR Edition),2,0,1,3,23,29
ASTR 104: Introduction to Stellar Astronomy - Complete,0,0,0,0,5,5
Anderson Cooper 360,94,17,13,25,104,253
New Books in Economics,1,0,0,2,0,3
New Books in Anthropology,0,1,1,0,2,4
New Books in Art,0,1,0,0,0,1
New Books in Architecture,0,0,0,0,1,1
"Oh No, Ross and Carrie",24,17,13,25,421,500
World Ocean Radio,0,0,0,0,3,3
New Books in Jewish Studies,0,0,0,2,5,7
New Books in Gender Studies,1,0,0,0,1,2
New Books in Political Science,1,0,1,2,7,11
New Books in African Studies,0,0,0,1,2,3
Joyce Meyer Ministries TV Podcast,9,2,1,1,92,105
New Books in Sociology,0,0,0,0,3,3
New Books in Public Policy,0,0,0,1,0,1
GuildSomm Podcast,4,1,2,4,23,34
Homesteading and Permaculture by Paul Wheaton,8,2,7,2,33,52
The Great Detectives Present Box 13,0,2,0,0,7,9
The Great Detectives Present Jeff Regan,0,0,0,0,1,1
New Books in Philosophy,1,0,1,0,2,4
Aesthetics and Philosophy of Art lectures,1,0,0,1,1,3
Understanding the Global Economy,0,0,0,1,0,1
Pro Football Talk Live with Mike Florio,58,11,11,19,96,195
Here & Now,12,7,4,3,24,50
Programming Throwdown,18,9,4,13,191,235
GeekWire,1,0,2,0,17,20
Mental Illness Happy Hour,2,0,1,1,46,50
Gunsmoke - OTRWesterns.com,0,0,0,0,17,17
The Six Shooter - OTRWesterns.com,0,0,0,0,5,5
The Lone Ranger - OTRWesterns.com,0,0,0,0,5,5
The Great Detectives Present the Thin Man,0,0,0,0,2,2
French Podcast,7,2,0,3,23,35
Far Post Podcast,1,2,3,2,16,24
COUN510 - Theories of Counseling,2,1,0,0,0,3
The Story of Psychology,0,1,1,0,7,9
Intro to Criminal Justice - Podcasts,0,0,0,0,2,2
The Speakeasy,0,0,1,3,26,30
Swami Sivananda,0,0,0,0,2,2
First Take,164,44,53,60,179,500
The Comic Conspiracy,21,2,8,11,96,138
The American Revolution - Audio,1,1,2,3,35,42
All About Android (Audio),3,4,2,4,19,32
Cook The Perfect...,0,0,0,0,1,1
Old Time Radio Nero Wolfe,2,0,0,2,7,11
The Great Detectives Present Let George Do It,0,0,0,1,2,3
Blue & Gold Illustrated: Notre Dame Football And Recruiting,7,3,8,8,42,68
The Great Detectives Present Sherlock Holmes,0,0,0,3,5,8
Listen to Dharma Talks – Orlando Insight Meditation Group,0,0,0,0,2,2
Great Detectives Present Yours Truly Johnny Dollar,0,1,1,2,20,24
The Baba Gonesh Podcast - Lessons in Indian Culture and Breaking News from the Homeland,0,0,0,0,1,1
Samurai Archives Japanese History Podcast,1,2,2,3,39,47
The Vergecast,70,40,23,21,346,500
Systematic Theology,0,1,1,0,1,3
Church History,0,0,0,1,0,1
Improvised Star Trek,0,0,0,0,50,50
PsychOut: Where We Explore Psychology Outside the Classroom,0,0,0,1,3,4
Foundations of Modern Social Theory - Audio,2,0,1,2,2,7
MLB Network: Intentional Talk,6,4,7,8,59,84
Jill on Money with Jill Schlesinger,3,3,5,1,188,200
Challenge of the Yukon - OTRWesterns.com,1,0,0,0,2,3
Have Gun Will Travel - OTRWesterns.com,0,1,1,0,5,7
Tales of the Texas Rangers - OTRWesterns.com,1,0,0,1,4,6
Unofficial Universal Orlando Podcast,1,3,3,4,120,131
All Things Gardening,0,0,0,0,1,1
Inside The Crew,0,0,0,0,8,8
The Vampire Diaries Reviews and After Show - AfterBuzz TV,2,1,7,8,86,104
The Psychic Viewpoint,3,2,2,1,11,19
The Corvette Mechanic,0,0,0,0,5,5
The House Of Ephraim,0,0,0,0,5,5
TechSNAP,0,1,0,0,39,40
Stories from the Borders of Sleep,1,0,0,1,48,50
PODCAST – Radio D,0,0,0,1,2,3
Decibel Geek Podcast,1,2,4,4,244,255
New Books in National Security,1,0,0,1,1,3
Mindful Meditations,0,1,0,4,24,29
The Game Of Thrones Podcast,45,24,15,18,80,182
Deeper Down The Rabbit Hole,3,0,1,3,10,17
AOPA Live This Week,1,0,0,0,2,3
The Voice Podcast - AfterBuzz TV,4,2,5,0,14,25
Ending Human Trafficking Podcast,0,0,0,0,22,22
BirdTalk Radio Podcast,1,0,2,1,3,7
Aetheryte Radio - A Final Fantasy XIV Shadowbringers Podcast,3,1,3,1,20,28
What On Earth Is Happening,2,1,1,1,44,49
Desert Island Discs: Archive 2000-2005,1,1,0,0,1,3
Desert Island Discs: Archive 2005-2010,0,0,0,0,2,2
American Patchwork & Quilting Podcast,5,9,3,3,40,60
The EntreLeadership Podcast,6,1,6,3,184,200
"Because Language - a podcast about linguistics, the science of language.",1,0,0,1,9,11
Minus Three,48,34,28,43,347,500
Easy Japanese: Grammar Lessons | NHK WORLD-JAPAN,0,1,0,2,13,16
Happiness Podcast,0,2,1,0,47,50
The Rise Guys,0,0,0,0,19,19
"Stuck Mic AvCast – An Aviation Podcast About Learning to Fly, Living to Fly, & Loving to Fly",0,2,2,1,9,14
Canine Nation,0,0,0,0,2,2
Stella Culinary School,0,1,0,0,19,20
ASTR 103: Introduction to Planetary Astronomy - Complete,0,0,0,0,1,1
UX Podcast,0,1,0,2,9,12
Learn German by Podcast,0,0,1,3,17,21
MRN Classic Races,0,0,1,5,17,23
The British History Podcast,7,5,5,1,32,50
Airline Pilot Guy - Aviation Podcast,0,4,3,0,43,50
The Micah Hanks Program,17,12,14,18,107,168
The Elements of Drawing,1,0,3,2,4,10
Irish Sports Daily Podcast,9,5,4,6,91,115
Family Vision with Dr. Rob & Amy Rienow,0,0,0,0,3,3
W&W Rave Culture Radio,1,0,0,0,35,36
Austin Zen Center Dharma Talks,0,0,0,0,3,3
Satellite Sisters,2,1,4,2,193,202
The NoSleep Podcast,9,4,6,3,28,50
Elevation with Steven Furtick,0,0,0,1,80,81
RNZ: Checkpoint,0,0,0,1,2,3
The Great Detectives Present Rogue's Gallery,0,0,0,1,0,1
Convert to Raid: The podcast for raiders in the World of Warcraft!,12,6,2,0,30,50
Epic Real Estate Investing,7,1,1,0,141,150
Prophetic News,10,1,0,1,5,17
Dog Training Q&A What Would Jeff Do?,2,0,0,0,14,16
Chairshot Radio Network,1,0,0,0,4,5
"DSR: Become a Better Man by Mastering Dating, Sex and Relationships (formerly Dating Skills Podcast)",4,0,0,2,44,50
FT Alphachat,0,1,2,3,34,40
Learn Dutch | DutchPod101.com,3,0,0,0,4,7
Learn Hebrew | HebrewPod101.com,0,0,1,1,0,2
HouseSmarts Radio with Lou Manfredini,0,0,0,0,2,2
Mohr Stories - JayMohr.com,12,3,0,1,34,50
Whence Came You? - Freemasonry discussed and Masonic research for today's Freemason,0,0,0,4,36,40
LSAT Kung Fu,1,1,1,0,8,11
WFO Radio Podcast,1,0,1,0,33,35
The 4x4 Podcast,0,1,2,1,46,50
Cast of Wonders,2,0,2,1,13,18
Bulletproof Radio,0,0,0,1,11,12
Kali Mandir Satsang,0,0,0,0,5,5
The Jim Hill Media Podcast Network,5,2,22,41,381,451
Cleveland Browns Daily & More,12,13,8,11,78,122
HowSound,0,0,1,0,49,50
EM Basic,0,0,0,1,49,50
Alien vs. Predator Galaxy Podcast,1,0,1,0,4,6
PSYC475 - Criminal Psychology,1,0,1,0,0,2
Physio Edge podcast,0,0,0,0,36,36
The World and Everything In It,4,1,9,4,482,500
Sex Nerd Sandra,2,6,3,4,35,50
Team Beachbody Coach Podcast,6,2,1,1,14,24
Jonathan Foust,0,0,0,1,33,34
TWFS,12,1,2,2,215,232
ILLUSIONOID,0,0,0,0,34,34
Radio 4 Quiz,1,0,0,3,2,6
"The Automotive Hour, Weekly Podcast of AGCO Automotive Corporation",0,1,0,1,48,50
DaUnknownAdmin Podcast,0,0,0,0,27,27
ASTR 104: Introduction to Stellar Astronomy - Fall 2019,0,0,0,0,1,1
Gleeman and The Geek,6,3,8,21,136,174
Professor Hallux: The Human Body Podcast for Kids,0,0,1,2,0,3
Mac Power Users,7,12,10,17,427,473
New Books in Buddhist Studies,0,0,0,1,1,2
Nuclear Hotseat hosted by Libbe HaLevy,1,0,0,0,1,2
Mel and Warp's Time-Travel Adventures: Story for Kids,3,1,1,0,4,9
Minecraft Me - SD Video,4,0,2,3,40,49
Hypnogoria,1,0,0,0,20,21
Gambling With an Edge,1,2,1,5,39,48
Markus Schulz presents Global DJ Broadcast,0,0,0,1,49,50
Geology 102 - Physical Geology,0,0,0,0,1,1
SoonerNation: Oklahoma Sooners,1,2,3,2,9,17
The Peak Prosperity Podcast,4,0,1,0,19,24
2 Knit Lit Chicks,6,1,2,1,40,50
Scriptnotes Podcast,3,8,8,12,424,455
The Kiss Me Quick's Erotica,9,1,1,3,130,144
WRESTLING SOUP,19,3,12,7,177,218
The Real Housewives of Beverly Hills After Show Podcast,29,23,15,6,32,105
In Our Time: History,5,2,7,10,24,48
In Our Time: Culture,1,1,6,4,11,23
In Our Time: Science,0,0,1,0,17,18
In Our Time: Religion,0,0,1,0,3,4
In Our Time: Philosophy,0,1,3,1,19,24
Watch Out for Fireballs!,15,9,4,10,312,350
NFL Fantasy Football Podcast,40,11,17,32,399,499
Sports Gambling Podcast,12,1,6,4,477,500
The Secret Cabal Gaming Podcast,1,1,1,4,43,50
Highly Questionable,21,4,11,5,111,152
Power Hour with Alex Epstein,4,1,0,1,32,38
Adventures in Urban Judaism,2,0,0,0,6,8
Down the Security Rabbithole Podcast,0,1,0,0,15,16
Amazin' Avenue: for New York Mets fans,7,4,2,2,43,58
The Cane and Rinse videogame podcast,2,0,1,3,44,50
Show-mp3 – Sunday Morning Linux Review,0,0,1,0,5,6
Miracle Internet Church Radio,0,0,0,0,4,4
Ari Shaffir's Skeptic Tank,11,2,0,0,37,50
Internet Box,3,0,2,0,45,50
Morelia pythons radio,1,0,0,0,15,16
Story Quest – Stories for Kids,0,0,0,2,9,11
Locked On Panthers - Daily Podcast On The Florida Panthers,0,1,1,0,7,9
The Life Scientific,0,0,3,2,10,15
The Unofficial WWE RAW After Show,33,10,8,11,121,183
Rewatchability,4,1,1,1,29,36
TED Talks Art,0,0,0,1,2,3
TED Business,0,0,0,0,4,4
TED Talks Kids and Family,1,0,0,2,11,14
TED Talks Music,2,0,0,0,6,8
TED Talks Science and Medicine,1,0,0,0,7,8
TED Talks Society and Culture,1,0,1,2,7,11
TED Talks Technology,0,0,0,1,3,4
"Soul Deep Sessions - ""House Made Sexy""",0,0,0,5,40,45
BrightFocus Chats: Macular Degeneration,0,0,0,0,1,1
Roderick on the Line,9,3,3,5,190,210
To The Best Of Our Knowledge,1,2,3,5,50,61
Hockey Night In New York,0,1,1,3,7,12
Comic Book Podcast | Talking Comics,22,13,10,12,116,173
Sexy Marriage Radio,0,6,2,0,42,50
Here's The Thing with Alec Baldwin,7,1,1,0,41,50
Decades of Horror 1980s,1,0,0,1,12,14
Watching Dead - Walking Dead Podcast,41,27,16,20,396,500
Washed Up Emo,1,0,0,2,23,26
Physics World Stories Podcast,0,0,1,1,3,5
Gita Wisdom Teachings by Joshua M. Greene (Yogesvara),0,0,0,0,3,3
The Rights To Ricky Sanchez: The Sixers (76ers) Podcast,15,2,7,3,473,500
London Real,16,1,1,1,31,50
Monocle 24: Monocle on Design,0,0,0,0,2,2
Monocle 24: The Urbanist,0,0,0,0,2,2
The New Psychology of Depression,1,0,1,0,9,11
Monocle 24: The Menu,0,1,0,0,2,3
You Made It Weird with Pete Holmes,7,4,5,2,32,50
Age of the Dinosaurs,2,1,0,0,6,9
The Once Upon A Time Podcast,15,7,7,21,96,146
You Need A Budget (YNAB),4,0,3,2,41,50
Taylor Talk: The Taylor Swift Podcast | reputation | 1989 | Red | Speak Now | Fearless | Taylor Swif...,1,0,2,5,42,50
I Didn't Know That!,12,1,4,2,17,36
This Week in Marvel,11,8,10,11,52,92
This Week in Tech (Video),5,1,1,1,6,14
Juke In The Back,0,0,0,0,14,14
Lacrosse All Stars Network,0,0,0,0,22,22
Sodajerker On Songwriting,0,0,0,1,49,50
The Modern Art Notes Podcast,1,1,1,3,44,50
improv4humans with Matt Besser,2,0,3,1,44,50
Podcast on the Brink,1,2,1,5,71,80
Information on Cruising the Great Loop,0,0,2,0,1,3
Monday Morning Podcast,55,13,18,16,398,500
The Real Housewives of Atlanta After Show Podcast,16,5,5,11,76,113
Thich Nhat Hanh Dharma Talks,1,2,1,1,17,22
Steve Deace Show,0,0,0,1,49,50
Horror a la Media Noche,3,0,0,1,12,16
The Conversation Art Podcast,2,0,3,1,48,54
CarProUSA Radio Show,1,0,0,0,11,12
The Citadel Cafe: A Sci-Fi and Fantasy Podcast,0,0,0,0,12,12
"Vos and Bonnie's ""My Wife Hates Me""",12,1,2,5,30,50
Podcast UFO,5,3,0,2,41,51
Official PlayStation Podcast,6,4,1,5,34,50
Universo Saint Seiya - Caballeros del Zodiaco,0,0,0,0,1,1
The Titanium Physicists Podcast,5,0,2,5,158,170
The China in Africa Podcast,1,1,0,0,21,23
Trail Runner Nation,1,6,8,6,132,153
Kerry Lutz's--Financial Survival Network,0,0,2,1,36,39
VO Buzz Weekly,0,0,0,0,15,15
Trinity Force Podcast - A League of Legends Podcast,2,1,2,1,44,50
Down N Dirty Sexy Hot Adult Stories from the Street,7,1,5,5,8,26
Philosophy Now,1,4,3,1,3,12
Tim and Sid,0,0,0,1,7,8
"Smart Podcast, Trashy Books: Reviews, Interviews, and Discussion About All the Romance Novels You Lo...",1,0,0,4,51,56
The China History Podcast,3,1,0,1,45,50
The Enormocast: a climbing podcast,5,1,3,6,314,329
The Podcast for Social Research,2,0,0,0,0,2
Strangers,28,17,13,19,423,500
Library Rap: The Hip Hop Interviews with Tim Einenkel,0,0,0,0,8,8
ASTR 103: Introduction to Planetary Astronomy - Spring 2019,0,0,0,1,0,1
Islamic History Podcast,2,1,3,5,51,62
Ultrarunnerpodcast.com,4,1,0,3,206,214
Simply Scottish,0,0,0,1,17,18
Chicken Thistle Farm CoopCast,2,1,2,11,484,500
Campfire Radio Theater,1,1,0,0,48,50
Tales to Terrify,11,2,6,7,79,105
Whoa Podcast About Horses Horsemanship,0,0,0,0,21,21
Changing Your World Podcast with Creflo Dollar,8,2,2,0,82,94
The History of WWII Podcast - by Ray Harris Jr,5,3,7,8,27,50
Justified Podcast,2,2,0,1,63,68
MLW Radio: The Flagship,22,6,6,7,162,203
The Ave Maria Hour Radio Show,0,0,0,0,4,4
War Rocket Ajax,5,4,2,3,154,168
Ultimately with R.C. Sproul,0,1,0,1,44,46
The Assembly Call IU Basketball Podcast and Postgame Show,2,1,0,1,57,61
HARDtalk,6,1,2,2,11,22
The DGDC - Deeply Graphic Designcast,4,4,5,12,153,178
A word from God,0,0,0,0,1,1
The Religious Studies Project,1,1,0,1,7,10
The Inside BJJ Podcast,5,2,6,12,242,267
The tastytrade network,2,0,0,1,17,20
The Exchange,18,10,5,8,20,61
TruSouL Radio,0,0,0,0,8,8
The Smoking Tire,12,8,2,3,25,50
All JavaScript Podcasts by Devchat.tv,1,3,3,5,38,50
Studio Break,0,0,0,0,6,6
State Of The Game,0,0,1,0,11,12
This Is Actually Happening,41,21,21,25,391,499
Talk Ultra,3,0,1,0,18,22
Federal Tax Update Podcast,0,0,0,0,1,1
Watch What Crappens,29,8,13,10,440,500
Dog Cancer Answers,0,0,0,1,5,6
The Lawfare Podcast,21,11,16,26,426,500
"New Books in Science, Technology, and Society",0,0,1,0,0,1
Admissions Straight Talk,0,1,0,0,9,10
True Story,5,6,5,7,32,55
The Kitchen Cabinet,0,0,0,0,3,3
C Tolle Run,0,1,4,4,117,126
The Yarniacs: A Knitting Podcast,0,1,2,3,44,50
Social Pros Podcast,1,1,2,1,45,50
Clinical Chemistry Podcast,0,0,0,0,1,1
SAF's Polite Society Podcast,2,0,1,5,29,37
Podcast Francais Authentique,0,0,0,0,22,22
Lexicon Valley,4,3,3,6,34,50
Tribulation-Now,3,1,1,0,13,18
Place to Be Wrestling Network,2,0,1,1,30,34
Psych 406: Psychology of Perception,1,0,1,0,0,2
"Animation Addicts Podcast - Disney, Pixar, & Animated Movie Reviews & Interviews | Rotoscopers",0,4,3,10,123,140
Diabetes Core Update,0,0,0,0,4,4
"The Fat-Burning Man Show with Abel James: Real Food, Real Results",5,4,2,3,36,50
The Truth,2,3,3,0,42,50
Half Size Me,2,0,1,1,46,50
Modern Woodworkers Association Podcast - Conversations Among Woodworkers,0,2,3,4,21,30
All the Kings Men | LA Kings,4,0,1,4,84,93
Data Stories,1,0,0,2,26,29
Hot Stove Radio,0,0,2,1,8,11
Adventures In Design,5,7,3,6,103,124
Your Mom's House with Christina P. and Tom Segura,63,17,11,21,387,499
The CultCast,27,15,14,13,431,500
Friday's | Hot Passionate Sex Stories to Heat Up Your Nights,0,0,1,1,1,3
Flower Mound Women's Bible Study,0,1,2,2,83,88
The WODcast Podcast,2,4,2,0,42,50
Shani Mantra,0,0,0,1,0,1
Physician Assistant Exam Review,1,2,5,14,318,340
The Besties,0,0,0,0,50,50
The RC Newb Podcast,0,0,0,2,5,7
Bloggingheads.tv: The Glenn Show,2,1,2,2,43,50
Inspirational Comedy with Dr. Michael Smalley,1,2,1,3,125,132
Jentezen Franklin Podcast,0,0,0,0,74,74
Daily Tanya (Audio) - by Manis Friedman,0,0,0,0,4,4
Rambam - 1 Chapter a Day (Audio),0,0,0,0,2,2
Lectures in History,2,2,2,3,19,28
Commuter Knitter Podcast,0,0,0,0,36,36
Legion of Skanks Podcast,0,1,0,0,49,50
The JV Club with Janet Varney,0,0,0,2,48,50
Techno Music - Techno Live Sets Podcast,4,0,3,1,42,50
"Good Job, Brain!",1,0,1,4,44,50
The Empire Film Podcast,0,6,0,7,52,65
Babbage from Economist Radio,0,0,1,1,33,35
Om Nama Shivaya - Shiva Mantra Chants recited by Sandeep Khurana,0,0,0,0,2,2
Game of Thrones The Podcast,124,36,27,16,297,500
Women Amplified,0,1,0,0,6,7
Shop Talk Live - Fine Woodworking,3,3,1,0,43,50
DFB Podcast,1,1,3,8,108,121
Chris Spangle Show - We Are Libertarians Podcast Network,11,9,6,5,109,140
Criterion Cast: Main Episodes,0,0,0,1,5,6
Down Cellar Studio Podcast,0,0,0,1,49,50
Barbell Shrugged,8,8,13,6,15,50
Ask Science,6,2,1,3,12,24
Razzball Fantasy Baseball,7,4,7,3,92,113
The Week in Doubt Podcast,3,0,1,4,20,28
The LRB Podcast,0,0,0,0,5,5
A Course in Miracles,1,1,1,3,93,99
American Journal of Gastroenterology Author Podcasts,0,0,0,2,2,4
Deep Energy Podcast,21,4,8,7,66,106
Satsang with Sitar,0,0,0,0,4,4
Troubled Waters,0,0,2,2,46,50
Photofocus Podcast,4,8,5,5,19,41
Gun Guy Radio,3,3,8,12,320,346
Mad Men Happy Hour,14,10,5,21,198,248
Your Success At Last DNA | Daily Motivation | Goal Setting,0,0,0,0,1,1
How to Think Like a Psychologist,4,2,2,2,7,17
The Star Spot,1,0,0,0,9,10
The Cleansed: A Post-Apocalyptic Saga,27,12,3,4,4,50
Ottoman History Podcast,1,1,2,2,19,25
Options Boot Camp,2,1,4,1,7,15
The Public Philosopher,0,0,0,0,2,2
Powertools Mixshow,1,0,0,1,28,30
Our Fair City,2,1,1,4,42,50
Hindu Mantras,1,0,1,0,3,5
Early Middle Ages,2,1,2,2,12,19
The Ancient World,0,2,0,2,46,50
Going Off Track,1,0,0,0,49,50
West Virginia Morning,0,0,0,0,4,4
Ram Dass Here And Now,0,2,7,13,116,138
Alvin and the Chipmunks,4,0,0,1,8,13
Scandal Reviews and After Show - AfterBuzz TV,14,16,28,26,251,335
Got Clutter? Get Organized! with Janet,0,0,0,0,7,7
Infectious Diseases Society of America,0,0,0,0,2,2
Intuitive Awareness by Ajahn Sumedho,0,0,0,0,1,1
You Are Not So Smart,7,6,10,26,146,195
Gold Derby: Predict Hollywood Races - GoldDerby,0,2,0,1,2,5
Fitness Confidential with Vinnie Tortorich,6,3,6,0,35,50
The Collected Teachings of Ajahn Chah - Audiobook,0,0,0,0,7,7
The Ars Technicast,1,8,3,2,3,17
TED Radio Hour,92,56,34,4,102,288
Winged Nation,0,0,0,0,11,11
Tales of a Red Clay Rambler: A pottery and ceramic art podcast,0,0,0,0,64,64
The Beerists Craft Beer Podcast,5,1,3,1,190,200
IELTS Podcast,0,0,0,3,8,11
Philosophy of Religion,0,0,1,0,2,3
Bad Dog Agility Podcast,0,1,0,0,17,18
The Broad Experience,1,1,1,6,191,200
Ask Me Another,1,1,2,2,44,50
Build My Online Store Podcast,0,1,2,3,44,50
Minnesota Today,1,1,0,1,5,8
"Naked Genetics, from the Naked Scientists",0,0,0,1,7,8
Words and Their Stories - VOA Learning English,0,0,0,0,2,2
Weird Medicine: The Podcast,3,1,0,0,46,50
The HoneyDew with Ryan Sickler,0,1,0,2,47,50
The History of Byzantium,1,0,1,1,47,50
Radio Ambulante,3,1,2,9,343,358
StoryCub - PRESCHOOL VIDEO STORYTIME! BUILT FOR KIDS 2-6.,1,4,1,2,21,29
Sex Out Loud with Tristan Taormino,0,0,4,1,30,35
The Talk Show With John Gruber,64,19,26,49,342,500
kiwimana Buzz Beekeeping Show - A Beekeeping Podcast/Show,0,0,0,0,21,21
Afterlife TV with Bob Olson,1,0,0,0,25,26
Xtended,0,0,1,1,6,8
Chef's Story,0,2,2,1,4,9
The Co-Main Event MMA Podcast,7,1,1,3,131,143
The Tennis Podcast,5,9,9,7,130,160
Andante: beginners' Italian - Audio,2,0,1,1,1,5
Fat Man Beyond,12,5,4,2,27,50
The Trail Show,2,2,1,4,173,182
The Full Feed - All of the Packet Pushers Podcasts,0,0,1,1,38,40
Intuitive Astrology  with Molly McCord,0,1,0,0,34,35
Manager Tools Basics,0,0,0,0,16,16
Transform Your Workplace,0,0,0,1,49,50
Run to the Top Podcast | The Ultimate Guide to Running,0,1,0,2,47,50
Learn Norwegian | NorwegianClass101.com,0,0,0,1,5,6
Learn Turkish | TurkishClass101.com,5,0,0,1,2,8
KFC Radio,2,0,0,0,48,50
Welcome to Night Vale,2,1,0,2,45,50
The Free Zone w/ Freeman Fly,12,4,2,4,51,73
Average Swingers,3,4,3,0,40,50
Dom Irrera Live from the Laugh Factory,3,0,1,7,39,50
I'll Drink to That! Wine Talk,2,0,2,0,196,200
The Potter's Touch,1,2,1,1,15,20
The History of English Podcast,1,1,1,1,42,46
Go Creative Show,1,1,0,1,66,69
Main Street Vegan,0,0,2,2,46,50
iPhone Ringtone Videos,1,0,0,1,0,2
The Hey My Man Podcast,0,1,0,0,38,39
Financial Independence Podcast,1,0,1,4,194,200
The Astrology Podcast,8,3,9,7,89,116
The Generation Why Podcast,89,34,54,29,290,496
Hospital and Internal Medicine Podcast,1,0,0,3,46,50
Inside the Great Outdoors,0,0,0,0,4,4
NASCAR Live,3,1,1,1,3,9
108 Talks by Ajahn Sumedho,0,0,1,0,4,5
Aviation Careers Podcast,2,0,1,1,20,24
Space Talk,0,0,1,0,0,1
Autonomy 🤸‍♂️🍔✊ GMB Fitness,2,0,0,1,29,32
Effectively Wild: A FanGraphs Baseball Podcast,11,14,17,13,445,500
Dice Tower Now,2,2,1,2,16,23
Improv Nerd With Jimmy Carrane,0,0,0,2,45,47
Runner Girls,1,3,1,4,46,55
Horror 101 Podcast,0,0,0,0,16,16
Tech News Weekly (Video),5,2,0,0,9,16
The Shinybees Knitting and Yarn Podcast,1,1,0,2,29,33
House Planning Help Podcast,0,0,0,0,14,14
"XR-U : The BDSM, Sex, and Fetish Show",1,0,0,0,11,12
Colleen & Bradley,0,0,1,1,6,8
The MovieFilm Podcast,0,0,0,1,60,61
NHS Strength and Flexibility,0,0,0,1,4,5
NHS Couch to 5K+,0,0,0,4,11,15
Social Media Marketing Podcast,0,0,0,0,3,3
Last Exit to Brooklyn,1,0,0,1,39,41
I've Got a Beatles Podcast!,1,3,1,2,16,23
SimpleFlight Radio,0,0,0,1,12,13
Mission Log: A Roddenberry Star Trek Podcast,14,9,8,16,169,216
Nehora School presents the Kabbalah of Rabbi Ashlag,0,0,0,0,1,1
Geology Rocks: Exploring the Earth Sciences,0,0,0,0,2,2
FroKnowsPhoto Photography Podcasts,21,6,9,9,130,175
"Surviving Divorce Podcast: Hope, Healing, Recovery, Personal Finance, Co-Parenting",1,0,0,2,47,50
Ken and Robin Talk About Stuff,1,0,0,0,31,32
Advice Worth Keeping,0,0,1,0,1,2
MacBreak Weekly (Video),7,4,6,1,13,31
iOS Today (Video),3,1,2,5,22,33
The Whole View,1,2,1,0,46,50
Beyond the To-Do List,2,3,5,8,182,200
Sex Afflictions & Porn Addictions,1,3,1,1,5,11
Palaeocast,1,0,0,0,18,19
Very Bad Wizards,15,3,5,9,423,455
Uncle Joey's Joint,7,1,1,0,41,50
ELECTRONYK PODCAST,0,1,1,1,29,32
"jewish, judaism, spirituality, torah,",1,1,1,1,11,15
Soul Music,1,0,0,0,17,18
Hardwell On Air Official Podcast,19,8,4,7,135,173
ESV Old Testament (Dramatized) - English Standard Version Bible,1,3,1,2,12,19
Relatively Prime: Stories from the Mathematical Domain,1,1,0,2,39,43
Protocol Radio,2,1,0,4,28,35
Note to Self,18,8,14,20,440,500
Tabula Rasa audio drama,1,0,1,2,3,7
Blurry Photos,16,6,11,7,332,372
The Moby-Dick Big Read,0,1,2,3,17,23
Things We Said Today Beatles Radio Show,3,0,4,5,4,16
The Grey's Anatomy After Show Podcast,8,7,3,9,41,68
Jayhawk Talk Podcast,1,1,0,3,92,97
The Pipes Magazine Radio Show Podcast,2,0,0,0,48,50
First Rounders,1,0,0,0,6,7
"Law Talk With Epstein, Yoo & Senik",4,2,0,1,47,54
London Calling,2,3,0,1,28,34
NCUSCR Events,1,0,0,1,1,3
Baby Geniuses,3,0,1,1,45,50
Entrepreneurs on Fire,10,0,6,5,179,200
Klezmer Podcast,0,0,0,0,1,1
Gambling Podcast: You Can Bet on That,0,0,0,1,49,50
Thinking Poker,1,0,0,2,47,50
Here Be Monsters,9,7,4,14,279,313
Daily Gemara Podcast - Daf Yomi By Rabbi Eli J. Mansour,0,0,0,0,8,8
The Homeland Podcast,7,12,7,11,29,66
Tangentially Speaking with Christopher Ryan,5,4,2,8,181,200
History of the Crusades,8,2,2,1,37,50
Nightmare Magazine - Horror and Dark Fantasy Story Podcast (Audiobook | Short Stories),7,3,2,3,35,50
Daily Daf Differently,0,0,1,0,1,2
The Drunken Taoist Podcast,9,3,3,7,282,304
#StudioInter,0,0,0,0,7,7
Curious City,1,2,0,1,37,41
PragerU: Five-Minute Videos,13,1,0,0,36,50
Ruby Ryder's Pegging Paradise,0,0,0,0,17,17
Islamic Finance Podcast with Almir Colan,0,0,0,0,4,4
Playing On Air: A Theater Podcast,0,0,0,0,20,20
The Pete and Sebastian Show,5,0,3,4,38,50
Heffron and Reep Show,0,0,0,0,42,42
Frisky Friday | Sexy Stories to Heat Up Your Nights,0,0,0,0,1,1
DJ Private Ryan's Podcast,1,1,0,1,49,52
Talking Flight,0,0,0,1,11,12
Dungeons & Randomness: A D&D Podcast,1,1,0,0,48,50
Dilettante Ball,0,0,0,0,50,50
Growth Marriage,0,0,0,1,42,43
Get Fit with Jodelle,0,0,0,1,35,36
AOKI'S HOUSE,1,1,2,3,33,40
Master Photography,7,2,4,0,87,100
Death and Dying Retreat by Ajahn Amaro,0,0,0,0,1,1
The Lords Hour,0,0,0,0,3,3
The Fighting Cock (Tottenham Hotspur Podcast),1,1,1,1,111,115
Hip to be a Square Quilting Podcast,1,0,0,0,45,46
Extreme Health Radio,1,2,2,2,43,50
CiRCE Institute Podcast Network,1,0,0,1,48,50
Tin Foil Hat With Sam Tripoli,11,3,5,1,30,50
The Game Design Round Table,0,0,1,5,42,48
Radar Contact,0,0,0,0,2,2
Lady to Lady,12,4,4,1,29,50
Strange Fruit,0,0,0,0,19,19
Hayward Sanitarium » Hayward Sanitarium Podcasts,3,1,2,3,5,14
The Civil War (1861-1865): A History Podcast,1,2,0,4,43,50
Deep Cuts Radio - Signal 7,0,0,0,0,3,3
The Bubble Hour,1,3,2,1,43,50
Magic: The Gathering Drive to Work Podcast,3,2,3,3,39,50
Thru the Bible on Oneplace.com,0,0,0,0,39,39
Greetings Adventurers - Dungeons and Dragons 5e Actual Play,2,0,0,0,48,50
The Rich Roll Podcast,4,8,8,8,632,660
French for Beginners,3,2,2,2,8,17
Nerd Poker,1,0,1,1,47,50
NL Hafta,11,3,0,2,31,47
The Gary Neville Podcast,4,2,4,0,20,30
Stuff Jews Should Know,0,0,1,2,62,65
No Challenges Remaining,8,2,7,5,90,112
All Work No Play,0,0,1,0,32,33
Discovering Truth with Dan Duval,1,1,0,2,21,25
Gita For Daily Living,3,6,6,7,57,79
Hawaii Travel Podcast,0,0,0,0,13,13
The Adam and Dr. Drew Show,10,7,10,0,23,50
The Wow! Signal Podcast,0,0,1,2,7,10
Inside The Ropes,2,1,0,0,19,22
Bertcast's podcast,9,5,2,1,33,50
AR-15 Podcast - Modern Sporting Rifle Radio,8,4,5,24,459,500
"Defensive Security Podcast - Malware, Hacking, Cyber Security & Infosec",1,1,2,2,94,100
Three Sides of the Coin – A KISS Podcast and Radio Show,20,10,10,14,181,235
Still Untitled: The Adam Savage Project,4,9,6,24,432,475
DTV Audio,0,0,0,0,3,3
Dharma Ocean,0,0,0,0,5,5
The Guardian's Audio Long Reads,12,4,10,22,54,102
"The Physician Assistant Life - Everything Physician Assistant. A Podcast for Practicing PAs, Pre-Phy...",0,0,0,0,1,1
Business of Architecture Podcast,0,2,1,1,61,65
Aarti - Sant Shri Asharamji Bapu Aarti,0,0,0,0,1,1
The John Batchelor Show,4,5,5,6,30,50
Youpreneur FM Podcast,1,0,1,1,147,150
Highway Diary with Eric Hollerbach,0,0,0,0,4,4
"Sips, Suds, & Smokes",3,1,0,1,59,64
This Week in Guns,12,5,11,4,98,130
History of the Papacy Podcast,3,2,1,4,40,50
The Holy Post,24,14,9,18,348,413
MyNDTALK with Dr. Pamela Brewer,0,0,0,0,2,2
The Recovery Show » Finding serenity through 12 step recovery in Al-Anon – a podcast,0,0,1,0,49,50
Revelations Radio News,0,0,1,0,15,16
Good Luck High Five,3,1,0,1,45,50
The eLearning Coach Podcast,0,0,0,1,17,18
The Dr. Drew Podcast,24,1,1,1,23,50
All About Android (Video),0,0,0,0,5,5
Sean and Robot's Comedy Circuit,22,5,3,1,19,50
Muscle Maven Radio,1,0,1,0,48,50
Mufti Menk,0,0,0,1,26,27
PEM Currents: The Pediatric Emergency Medicine Podcast,0,0,0,0,6,6
Pat Mayo Experience,2,0,2,5,490,499
Security Now (Video),0,1,1,1,5,8
Windows Weekly (Video),0,0,0,0,2,2
EntreArchitect Podcast with Mark R. LePage,0,0,0,6,59,65
Bald Move Pulp,5,1,2,13,91,112
Bonfireside Chat - A Dark Souls and Bloodborne Podcast,8,2,9,1,30,50
Rebel Force Radio: Star Wars Podcast,82,19,8,9,382,500
TWiT News (Video),1,1,0,0,1,3
Nouman Ali Khan,2,0,0,0,32,34
Global Dispatches -- World News That Matters,0,0,0,2,76,78
HelixTalk - Rosalind Franklin University's College of Pharmacy Podcast,1,0,0,1,48,50
The None to Run Podcast,0,0,0,0,5,5
New Books in Critical Theory,1,3,0,1,3,8
This Jewish Life - With Rabbi Yaakov Wolbe,0,1,0,0,12,13
Hardcore Gaming 101,5,3,1,2,174,185
BiggerPockets Real Estate Podcast,10,10,12,10,234,276
The Vanderpump Rules After Show Podcast,30,6,10,2,70,118
Historical Astronomy,1,0,0,0,0,1
Online Marketing Made Easy with Amy Porterfield,3,0,0,0,197,200
EY Cross-Border Taxation Alerts,0,0,1,0,0,1
The FlightBridgeED Podcast,0,0,0,1,28,29
Simple Suttas,0,0,0,0,2,2
The Wicked Library,3,2,4,0,41,50
"Pixar Post Podcast: Animation News, Interviews & Reviews",0,0,0,1,17,18
"Naked Neuroscience, from the Naked Scientists",0,0,0,0,7,7
Coffee Break German,1,0,3,2,44,50
Dose of Leadership with Richard Rierson | Authentic & Courageous Leadership Development,1,0,0,4,95,100
The Heart,5,3,6,1,35,50
Private Jet Podcast,0,0,0,1,5,6
The School of Greatness,77,28,84,42,3360,3591
Italian Podcast,3,0,0,1,8,12
Heroes and Villains podcast,1,1,0,2,67,71
Where Did the Road Go?,4,3,1,1,49,58
Be Reasonable,0,1,0,0,32,33
Mat Men Pro Wrestling Podcast,1,0,0,0,38,39
Statistics for the Social Sciences,0,0,0,1,17,18
"The Practice of the Practice Podcast | Innovative Ideas to Start, Grow, and Scale a Private Practice",1,1,2,2,101,107
The Young Turks,199,28,10,14,216,467
Survivor: Winners at War - Recaps from Rob has a Podcast | RHAP,3,1,5,2,118,129
The Inforium,4,1,1,0,44,50
Abdul Basit,0,0,0,0,2,2
Practice Portuguese,0,0,0,0,28,28
Archispeak,1,0,1,3,39,44
Down to Dunk OKC Thunder Podcast,5,0,1,2,381,389
The Church of Eleven22,0,0,0,0,9,9
Mad About Movies,61,38,23,13,323,458
ResortLoop.com - A Walt Disney World Podcast!,1,0,2,5,147,155
Consulting Success Podcast,0,0,0,1,35,36
The RealLife English Podcast,2,0,2,2,30,36
Abhayagiri Talks,0,0,0,0,1,1
Vidjagame Apocalypse,14,4,10,4,264,296
Mindful Meditation at the Hammer,2,1,2,1,11,17
Trial Lawyer Confidential,1,1,1,3,44,50
Overdue,22,14,4,4,156,200
Buddha at the Gas Pump,2,3,3,2,67,77
Cantina Cast,7,6,6,6,136,161
"Space Boffins, from the Naked Scientists",0,0,0,1,1,2
Footnoting History,1,2,6,6,35,50
The Dale Jr. Download - Dirty Mo Media,5,1,12,10,472,500
Sasquatch Chronicles,18,10,12,20,440,500
Wine for Sophisticated Homies podcast,10,2,5,1,126,144
Yasir Qadhi,0,0,0,0,20,20
Speech and Language Kids Podcast,1,0,1,7,41,50
Gardening with the RHS,0,0,0,0,1,1
The Chase Down: A Cleveland Cavaliers Pod,0,0,0,1,147,148
Dates & Mates with Damona Hoffman,0,1,3,1,50,55
The Wings Over New Zealand Show,0,0,0,0,3,3
Dynasty Fantasy Football - Under The Helmet,17,8,11,5,121,162
Breaking Bread with Tom Papa,1,0,3,4,130,138
Big Brother All-Stars Recaps & BB22 Live Feed Updates from Rob Has a Podcast,8,4,7,13,106,138
Punks in Parkas,0,0,0,0,3,3
Firearms Radio Network (All Shows),3,0,1,3,46,53
The Gay Man's Guide,0,0,0,0,5,5
MOOC Podcast: Intro to Anatomy and Physiology with Doc C,0,0,0,0,4,4
Out of Bounds with Bo Bounds,0,1,1,1,5,8
Pathway to Victory on Oneplace.com,2,0,0,0,22,24
CBS Evening News,46,12,17,7,12,94
New Books in Mathematics,0,0,0,1,0,1
Hooniverse,1,1,2,4,42,50
"Soil, Stones, & Rocks",0,0,0,0,1,1
Animals,0,0,0,0,3,3
La Corneta,1,0,1,2,46,50
Khalid Yasin,1,0,0,0,2,3
Yusuf Estes,0,0,0,0,1,1
Accidental Tech Podcast,56,30,28,26,330,470
Law of Attraction Radio Network,3,0,0,1,2,6
Student of the Gun Radio,29,13,10,3,285,340
Ask Pastor John,4,2,3,2,137,148
Aloha Bible Prophecy,0,0,0,0,16,16
The Read,0,1,0,2,47,50
BASS TALK LIVE,0,1,3,7,487,498
The Glenn Beck Program,22,6,8,4,242,282
The Land O'Lakers Podcast by the Kamenetzky Brothers,2,1,1,1,10,15
Fit Womens Weekly Podcast,1,2,1,2,44,50
Law Abiding Biker | Street Biker Motorcycle Podcast,7,2,0,2,39,50
The Touch MBA Admissions Podcast,0,0,0,0,34,34
Power Athlete Radio,1,0,0,2,47,50
Fitness Mentor- with Tommy Caldwell,0,0,0,1,4,5
Beginner Spanish with Spanish Obsessed,1,0,3,1,27,32
Intermediate Spanish - Spanish Obsessed,0,0,0,3,46,49
Advanced Spanish with Spanish Obsessed,0,0,0,1,21,22
The Property Podcast,2,3,2,5,488,500
Who Shot Ya?,13,3,6,13,369,404
Speaking of Sex with The Pleasure Mechanics,1,1,1,0,47,50
Mishary Rashid Alafasy,0,0,0,0,6,6
The History of Egypt Podcast,1,0,0,1,48,50
Subconscious Mind Mastery Podcast,3,0,0,2,83,88
Kyle Kingsbury Podcast,5,0,2,0,43,50
The Urban Chicken Podcast  - The Urbanite's Podcast Resource for Keeping Backyard Chickens,0,0,0,0,34,34
Saad al-Ghamdi,0,0,0,0,4,4
The Omniplex,1,0,0,0,2,3
Climate Cast,0,0,0,0,4,4
Three Sides of the Coin Video,3,0,2,2,27,34
"Bliss Bringers - Sex, Swinging & Kink Podcast",0,0,0,1,11,12
The Steve Austin Show,27,7,12,17,436,499
Talking Cars (HQ),2,6,0,2,12,22
Pastor Rick's Daily Hope,0,0,0,0,5,5
Hagmann Report,5,1,1,2,41,50
Just Plane Radio,0,0,0,0,4,4
W.B. Walker's Old Soul Radio Show,1,1,0,1,152,155
Shoot the Defence,0,0,0,0,2,2
The History Hour,4,1,0,1,21,27
The Science Hour,1,3,1,2,9,16
What's Wrong With Wrestling? WWE Recap Show,14,2,2,2,203,223
The Michael Savage Show,90,13,13,20,364,500
Beginners – Lightspeed Spanish,0,0,0,0,3,3
Life Lessons: The Gintama Manga Cast,0,0,0,0,2,2
History of Japan,1,2,1,4,42,50
Early Intermediate – Lightspeed Spanish,0,0,0,0,3,3
Daily Buddhism,0,0,0,0,4,4
AFL Exchange,15,12,5,8,54,94
The Most Accurate Podcast,5,1,5,16,191,218
RotoGraphs Fantasy Baseball,16,7,16,24,399,462
Amy Myers MD,0,1,1,1,12,15
Por el Placer de Vivir,0,0,0,1,14,15
The Model Health Show,3,0,0,0,47,50
The Let's Talk Bitcoin Network,8,3,2,4,46,63
Miette's Bedtime Story Podcast,0,0,0,0,13,13
Extra Pack of Peanuts Travel Podcast,6,5,11,16,275,313
The Confidence Podcast,0,0,0,0,50,50
9to5Mac Happy Hour,28,16,16,6,104,170
Down These Mean Streets (Old Time Radio Detectives),0,0,1,6,56,63
Your Kick Ass Life Podcast,3,0,0,3,44,50
"Hypnosis and NLP with Donald Currie, Registered Psychotherapist",0,0,0,1,15,16
Off Camera with Sam Jones,4,3,4,2,168,181
Houston Matters,4,0,3,0,5,12
Doggy Dan Podcast Show,3,1,0,1,8,13
The Dollop with Dave Anthony and Gareth Reynolds,6,5,5,1,33,50
Fish Nerds Fishing Podcast,1,2,0,3,95,101
Craft Industry Alliance,1,1,0,1,43,46
Dei Musicale | The Musical Gods,0,0,0,0,7,7
The Avid Woodworker,0,0,1,0,22,23
Weekly Shonen Jump Podcast,1,2,1,5,14,23
Book Riot - The Podcast,19,16,18,10,137,200
"Coffee With Kenobi: Star Wars Discussion, Analysis, and Rhetoric",9,0,6,4,154,173
Good Life Project,3,0,1,5,41,50
The Stacking Benjamins Show,11,9,9,6,165,200
El Podcast de Marco Antonio Regil,0,0,0,0,50,50
Ask Women Podcast: What Women Want,6,6,7,2,29,50
The MetalSucks Podcast,6,3,0,2,39,50
Classical Classroom,0,0,3,0,117,120
Kreative Kontrol,0,1,1,1,17,20
Dave & Chuck the Freak Podcast,11,1,1,2,35,50
The Grimerica Show,8,4,2,4,250,268
ROCK AND/OR ROLL,2,0,0,2,57,61
AMMO NYC,0,0,0,0,32,32
Restoring Human Movement,0,0,0,0,30,30
The Side Hustle Show,4,0,3,2,191,200
Temple of Witchcraft,0,0,0,0,1,1
Skyrim Addict: An Elder Scrolls podcast,0,0,0,0,31,31
Laura Erickson's For the Birds,0,0,2,0,9,11
Star Wars Minute,11,3,7,7,334,362
The Retirement and IRA Show,0,0,1,0,7,8
Horsemanship Radio,0,0,0,0,7,7
Tiny Desk Concerts - Audio,0,0,0,0,2,2
Landmark Theatres Q&A Podcast,0,0,0,0,1,1
"Sex Is Medicine ~ Intimate conversations about sexuality, spirituality, PLEASURE, and personal growt...",1,0,0,1,13,15
Taking Back Birth,4,0,1,2,43,50
Talking Tech,3,3,2,1,24,33
Philosophize This!,0,1,0,0,30,31
The Peace Revolution Podcast,0,0,0,1,13,14
Kim Komando Explains,2,1,1,1,51,56
The Kings Herald Show | A Sacramento Kings podcast featuring Jerry Reynolds,0,0,2,1,24,27
Torah Means Teacher: Lessons from the First Five Books of the Bible: Dr. Nahum Roman Footnick ~ Insp...,0,0,1,1,8,10
CYB3RPVNK Radio,0,0,0,1,14,15
Bhagavadgita Discourse,0,0,0,0,5,5
The What Cast,2,1,5,4,51,63
The Energy Gang,1,3,2,4,190,200
Apex Magazine Podcast,1,0,1,0,2,4
ANTIC The Atari 8-bit Podcast,0,0,0,1,45,46
The Go Diaper Free Podcast,0,0,0,1,29,30
Hillsdale Dialogues Podcast,6,2,2,5,28,43
The Marketing Companion,1,0,1,0,43,45
Latin American Spanish,1,3,2,2,14,22
The Alton Browncast,7,3,3,6,31,50
The Good Friends of Jackson Elias,0,0,0,1,39,40
Rumble Strip,0,1,1,5,145,152
Sawbones: A Marital Tour of Misguided Medicine,9,1,1,3,36,50
Vegetarian Zen,0,0,0,0,50,50
The Ensemblist,0,0,0,1,26,27
ADHD Experts Podcast,3,5,6,10,26,50
The Making Agents Rich Show with Darin Persinger & Jonathan Rivera,1,0,0,0,115,116
The 5 AM Miracle with Jeff Sanders,1,0,0,1,48,50
Canning Season®,0,0,0,6,93,99
LET IT OUT,3,4,7,4,365,383
"Tennis Quick Tips | Fun, Fast and Easy Tennis - No Lessons Required",0,0,0,1,20,21
"Blue Peg, Pink Peg",6,1,1,4,38,50
BBC Inside Science,3,3,1,0,18,25
"Project Management Podcast: Project Management for the Masses with Cesar Abeid, PMP",0,1,1,0,30,32
"The Agents of Change: SEO, Social Media, and Mobile Marketing for Small Business",0,0,0,0,50,50
AI in Business,4,0,2,3,22,31
C4 Canucks Hockey Podcast,0,0,0,0,6,6
The Torch: The Great Courses Podcast,0,1,0,1,7,9
Muscle for Life with Mike Matthews,1,0,0,2,47,50
HiPPiE WiTCH : Magick For A New Age,1,1,1,5,128,136
The JTrain Podcast,2,0,4,6,38,50
Retronauts,10,3,2,2,33,50
Razha va Niazha,2,0,0,1,6,9
News in Slow Japanese / The Podcast,0,0,0,0,3,3
The Poundcast,1,1,4,0,44,50
Read to Lead Podcast,0,0,4,6,189,199
David Sedaris: Meet the Author,0,0,0,1,1,2
Obstacle Racing Media Podcast,3,0,3,1,96,103
Yasmin Mogahed,1,0,1,0,6,8
Rolling Dice & Taking Names Gaming Podcast,0,2,1,3,44,50
Farm Land,2,2,0,2,97,103
Bitch Talk,0,0,0,0,4,4
The Handgun Radio Show,3,3,3,4,94,107
Pioneering Today with Melissa K. Norris,0,1,0,3,46,50
30 Minute Italian,3,2,0,1,19,25
Surf Splendor,4,0,6,2,136,148
Dr. Stu's Podcast,0,1,0,0,28,29
SLOW FLOWERS with Debra Prinzing,0,2,3,2,39,46
Reel Spoilers,3,0,4,4,129,140
eCommerce Fuel,0,0,0,1,93,94
"Sixers Beat: a Philadelphia 76ers, NBA Podcast",3,2,3,8,136,152
Strange Horizons,0,1,0,1,3,5
Dharmapunx NYC,0,0,1,1,27,29
The Save The Marriage Podcast,0,1,0,0,40,41
Around the NFL,51,13,12,8,416,500
F*ck Silence with Joe Walsh,10,1,1,4,34,50
War on the Rocks,3,2,4,2,39,50
Extra Hot Great: This Week In TV,10,2,2,7,130,151
5 Minutes in Church History with Stephen Nichols,0,2,1,2,66,71
Royal Caribbean Blog Podcast,1,0,1,2,130,134
Learning Spanish for Beginners Podcast,1,1,1,3,12,18
The PCOS Diet Support Podcast,0,0,0,0,3,3
Top Coach Podcast,1,0,1,1,9,12
Sea Hawkers Podcast: for Seattle Seahawks fans,5,2,2,8,206,223
Let's Go Tribe: for Cleveland Indians fans,3,1,3,2,11,20
Afrojack - JACKED Radio (Official Podcast),1,0,0,0,18,19
The Old Paths Broadcast,2,0,0,0,0,2
Joe & Charlie “Big Book Comes Alive”,0,0,1,0,11,12
Salah Bukhatir,0,0,0,0,1,1
Motorcycles & Misfits,2,0,1,1,46,50
LINUX Unplugged,5,0,1,1,28,35
The Spanish Football Podcast,2,2,1,11,156,172
Country Squire Radio,0,1,0,0,49,50
Let's Master English! An English podcast for English learners,2,1,0,0,39,42
One Shot,0,2,4,1,43,50
Let's Talk New Mexico,0,0,0,0,1,1
Castle Super Beast,9,1,1,3,36,50
The Golf Podcast Presented by Golficity,2,1,2,1,105,111
podcasts – Yarns at Yin Hoo,0,1,1,1,47,50
Veterinary Clinical Podcasts,0,0,1,1,48,50
Dr Taylor Marshall Catholic Show,39,6,10,14,431,500
The Cracked Podcast,28,3,4,2,13,50
Cricket Unfiltered,6,0,0,0,18,24
Gaming illuminaughty,3,0,1,0,46,50
Casual Fridays Podcast,2,0,0,2,46,50
The UAV Digest,0,0,1,0,38,39
Run Talk Run,0,0,0,0,7,7
FOREVER MIDNIGHT - Horror Movie Podcast.,5,3,0,0,82,90
Tricycle Talks,0,0,0,0,7,7
Bilal Assad,0,0,0,0,9,9
Saad Tasleem,0,0,0,0,1,1
Said Rageah,0,0,0,0,3,3
The Survivalist Prepper Podcast,9,3,5,1,32,50
Cyborgs: A Bionic Podcast,1,0,1,0,11,13
IKAR Los Angeles,0,0,0,0,8,8
TalentCulture #WorkTrends,0,0,0,0,8,8
The Mexican Soccer Show,0,1,0,2,31,34
Fireside Tattoo Podcast,0,0,0,0,18,18
Flite Test: Aviation - RC Planes - Multirotors,1,0,1,2,46,50
Beginner's Shiva Puja,0,0,0,0,1,1
Athlon Sports Cover 2 College Football Podcast,23,10,4,9,61,107
Ricochet Podcast,2,4,1,3,40,50
Bitesize Irish Podcast,0,0,0,1,56,57
Double Loop Podcast,1,0,0,0,4,5
Food Psych Podcast with Christy Harrison,9,4,3,0,34,50
BSD Now,0,0,0,0,11,11
Board Gamers Anonymous,0,1,0,4,18,23
Aspen Ideas to Go,3,0,1,1,16,21
The EggChasers Rugby Podcast,3,2,2,0,40,47
A Slob Comes Clean,0,1,1,0,48,50
Brains On! Science podcast for kids,1,0,1,3,45,50
Bawdy Storytelling,2,3,2,1,118,126
Revolutions,8,16,12,8,656,700
Streetwise Hebrew,0,0,0,0,50,50
We Like Shooting,8,3,7,4,426,448
Outkick The Show with Clay Travis,43,8,5,3,222,281
Completely Unnecessary Podcast,10,3,6,2,29,50
Tuesdays with Stories!,6,1,1,1,41,50
Speaking of Psychology,3,1,2,2,18,26
Lions of Liberty,3,0,3,3,179,188
The Fighter & The Kid,325,21,18,18,118,500
Expanded Perspectives,32,6,4,13,444,499
Intelligence Squared,12,5,6,5,25,53
50% Facts with Silent Mike & Jim McD,1,1,0,1,47,50
The Once And Future Nerd,1,2,1,5,41,50
On the Wind Sailing,0,2,4,4,114,124
The Stem Cell Podcast,0,0,1,0,22,23
Inquiring Minds,8,8,5,20,106,147
Alex Barker,0,0,0,1,92,93
The Popcast With Knox and Jamie,22,9,5,2,462,500
The Ripple Effect Podcast,6,1,3,2,35,47
Sea Control - CIMSEC,0,0,1,1,18,20
Bless You Boys: for Detroit Tigers fans,1,2,4,3,17,27
The Motorcycle Mentor Podcast,0,0,0,4,46,50
"The Naked Vocalist | Advice and Lessons on Singing Technique, Voice Care and Style - Chris Johnson a...",0,1,1,2,25,29
The Tom Woods Show,3,4,1,9,313,330
The Source,0,0,0,0,1,1
Mindful Mama - Parenting with Mindfulness,0,2,0,1,47,50
The History of the Early Church,1,3,4,3,25,36
Parenthood Reviews and After Show - AfterBuzz TV,0,0,1,1,11,13
The Brookings Cafeteria,1,0,1,3,12,17
Ultimate Homeschool Radio Show,0,0,0,0,1,1
Current Issues and The Constitution,0,0,0,1,1,2
The Homeschool Sanity Show,1,1,1,1,16,20
Vintage Homeschool Moms,0,0,0,0,7,7
Ear Biscuits,10,3,1,1,35,50
Industry Focus,8,9,7,9,121,154
Happen To Your Career,0,1,0,0,125,126
The Weekly Planet,6,4,2,1,487,500
Brown Vegan,2,0,0,0,46,48
Wealth Formula by Buck Joffrey,3,0,0,0,47,50
Stories for Grown-Ups,0,0,0,0,7,7
Story Pirates,1,0,0,4,45,50
Pop Shop Podcast,0,1,2,3,29,35
The eLife Podcast,0,0,0,0,2,2
Dr. Laura Call of the Day,18,1,4,0,27,50
CANADALAND,2,1,2,0,10,15
Capitalism.com with Ryan Daniel Moran,5,0,0,2,43,50
Learn Polish: Kids & Beginner's Guide for How to Speak Polish,2,0,1,0,1,4
Summit Life with J.D. Greear,1,0,0,0,31,32
Pride and Prejudice by Jane Austen,0,0,0,0,15,15
KUT Weekend,1,0,0,0,15,16
The Angry Chicken: A Hearthstone & Battlegrounds Podcast,15,7,5,7,466,500
Reiki Radio Podcast,0,1,0,0,26,27
Keeping Karlsson Fantasy Hockey Podcast,0,0,2,0,127,129
"""Walking The Floor"" with Chris Shiflett",4,1,1,4,40,50
The Adventures of Sherlock Holmes by Sir Arthur Conan Doyle,0,1,0,1,3,5
Dollars & Sense,0,0,0,0,2,2
The Return of Sherlock Holmes by Sir Arthur Conan Doyle,0,0,1,0,1,2
Curious Handmade with Helen Stewart,0,0,1,1,48,50
Free Thoughts,5,2,2,2,45,56
Miscellaneous Adventures from the World of Mike Carano,2,0,2,1,45,50
John Dalton - gently does it . . .,0,0,0,0,20,20
The Great Detectives Present Nick Carter,0,0,0,0,1,1
"Across the Pond, a Premier League Podcast",2,0,0,1,55,58
Brain Matters,0,0,0,0,33,33
Jalen & Jacoby,29,12,9,20,430,500
Ranger Danger: A Power Rangers Podcast,3,0,0,5,37,45
Blow Your Mind (season 01),0,0,2,1,8,11
"Good Day, Sir! Show, a Salesforce Podcast",1,0,0,2,35,38
The Game Design Dojo Podcast,0,0,0,4,45,49
Stuff They Don't Want You To Know,96,20,16,10,148,290
Grimms' Fairy Tales by Jacob & Wilhelm Grimm,0,1,0,2,18,21
Making Sense with Sam Harris,80,15,25,20,725,865
Houston Zen Center Dharma Talks,0,0,0,0,1,1
The Beauty Brains,4,7,5,14,170,200
Medgeeks Clinical Review Podcast,0,0,0,4,46,50
The Tariq Elite Radio Show,15,2,3,4,111,135
Art + Music + Technology,0,0,1,0,10,11
Politics by Aristotle,0,0,0,0,2,2
Mindfulness Man,0,0,0,0,2,2
"Intelligent Science, Intelligent Design",1,0,0,0,0,1
Drummer's Resource,1,0,0,1,48,50
It's All Dead - Music Podcast,0,0,0,0,5,5
China in the World,3,1,1,1,11,17
Bros Watch PLL Too - A Pretty Little Liars podcast,5,0,1,3,315,324
Bonita Radio,0,0,0,0,4,4
Plane Talking UK's Podcast,0,0,0,1,5,6
OPB's State of Wonder,1,0,0,0,0,1
TubeTalk: Your YouTube How-To Guide,0,0,0,1,12,13
Sleep With Me,132,24,26,32,784,998
The History of China,3,1,2,1,43,50
Don't Mom Alone Podcast,0,2,0,0,48,50
Modern Sewciety Podcast,0,1,0,4,95,100
Your Teen with Sue and Steph,2,0,0,0,34,36
The Overwhelmed Brain,0,1,2,2,45,50
The Dough Roller Money Podcast,1,1,2,6,90,100
The Matt Beck Podcast,0,0,0,0,8,8
"The SAP - Comedians Talk Motivation, Dating and Relationships",0,1,1,0,48,50
All Ears English Podcast,5,1,0,2,42,50
Low Pressure Podcast: The Podcast for Skiers,0,0,0,0,19,19
Sky Sports Cricket Podcast,6,1,4,1,27,39
The Art of Composing Podcast,1,0,0,1,20,22
GRE SAT Advanced English Vocabulary Podcast!,0,0,1,4,45,50
Daily Strides Podcast for Equestrians,0,0,1,0,28,29
The PosCast with Joe Posnanski & Michael Schur,1,2,2,3,76,84
The Proverbs 31 Ministries Podcast,0,0,0,1,2,3
Hemmings Collector-Car Radio,0,0,0,0,1,1
The Logo Geek Podcast,0,0,0,1,37,38
Fighting In The War Room: A Movies And Pop Culture Podcast,10,8,11,27,444,500
The Disney Story Origins Podcast,1,1,5,8,185,200
The Millionaire Matchmaker Love Report with Patti Stanger,0,0,0,1,2,3
DaZPod | German as a Second Language | Learning German - language and culture,0,0,1,0,15,16
Talk Is Jericho,70,8,15,14,392,499
Psychology In Seattle Podcast,8,1,2,4,35,50
The Promised Podcast,1,1,2,4,100,108
Coding Blocks,1,2,1,7,479,490
The Pulse,0,0,3,5,37,45
Arrested DevOps,1,0,0,0,24,25
Mom and Dad Are Fighting | Slate's parenting show,4,5,11,7,23,50
Talking Headways: A Streetsblog Podcast,1,0,2,0,20,23
The Same 24 Hours,1,1,0,2,46,50
The Prog Report,0,0,0,0,4,4
Zero To Travel Podcast,3,9,2,8,173,195
"FoodTruckr School - How to Start, Run and Grow a Successful Food Truck Business",0,0,0,1,28,29
Cheap Heat with Peter Rosenberg,63,17,9,9,401,499
Compleatly Beatles,2,2,7,6,33,50
Strictly Anonymous,7,6,3,3,31,50
Can't Bowl Can't Throw Cricket Show,0,0,0,1,7,8
The New Yorker: Poetry,1,0,1,2,19,23
The BOB & TOM Show Free Podcast,4,1,4,3,38,50
The Lucid Dreaming Podcast,1,1,0,0,12,14
Super Agents Live- Selling Real Estate,2,1,1,1,10,15
Oral Argument,1,1,0,1,16,19
Song Exploder,3,3,4,21,469,500
"Hank Watson's Garage Hour - Cars, Trucks, Beers & Guns",0,0,0,0,3,3
Binge Dieting   Learn how to change your relationship with Eating,0,0,0,0,50,50
"A History of Europe, Key Battles",2,0,1,5,42,50
Primal Blueprint Podcast,6,3,9,8,24,50
Anthony Metivier's Magnetic Memory Method Podcast,3,0,1,9,37,50
Sword and Scale,207,63,57,36,354,717
Daily Tech News Show,5,4,5,5,463,482
Wellpreneur,0,0,0,0,63,63
Real Estate Investing for Cash Flow with Kevin Bupp,0,0,0,2,98,100
"Epicenter - Learn about Crypto, Blockchain, Ethereum, Bitcoin and Distributed Technologies",2,1,0,6,63,72
House of #EdTech,0,0,1,0,49,50
Conspiracy Theories & Unpopular Culture,54,12,16,22,396,500
The One You Feed,4,4,1,2,39,50
Theater People,1,0,2,5,142,150
Supernatural: The Crossroads,0,1,0,6,35,42
Personality Hacker Podcast,2,1,1,0,46,50
Beekeeping,0,0,0,0,1,1
The James Altucher Show,2,0,0,1,47,50
Universe Today podcasts with Fraser Cain,0,0,0,0,11,11
My Favorite Album with Jeremy Dylan,0,0,1,2,25,28
DLC,9,1,3,2,35,50
88 Miles Per Hour Podcast,1,0,0,0,23,24
Modern Life Insurance Selling Podcast,0,0,0,0,25,25
Making Biblical Family Life Practical,0,0,0,0,19,19
The Office of Rabbi Sacks,0,0,0,1,18,19
Abdul Nasir Jangda,0,0,0,0,1,1
Psychiatry,0,0,1,1,0,2
Bucknuts Morning 5,8,3,7,7,253,278
Fedde Le Grand - Darklight Sessions,1,0,0,0,6,7
The Plant Report- Every Plant Has A Story,0,2,0,0,5,7
Off The Bench with Heidi St. John,13,3,2,0,482,500
Why Are People Into That?!,2,1,3,1,26,33
Brakeing Down Security Podcast,1,0,0,1,22,24
AviatorCast: Flight Training & Aviation Podcast,0,1,1,1,47,50
Wrestling Compadres,9,3,1,3,211,227
Swim Coaches Base,0,1,0,2,7,10
The Geology Flannelcast,2,1,2,0,36,41
The Muslim Life Hackers Podcast: Personal Growth | Leadership | Legacy Building | Life Hacks | Islam,0,0,0,1,7,8
The Savvy Psychologist's Quick and Dirty Tips for Better Mental Health,3,6,2,5,34,50
True Blue LA: for Los Angeles Dodgers fans,1,0,0,1,4,6
Coding 101 (Audio),0,0,0,0,3,3
The Creative Writer's Toolbelt,0,0,0,2,22,24
Tales of Tamriel | An Elder Scrolls Online Podcast,1,1,3,3,122,130
Rocketship.fm,0,0,0,0,86,86
"10,000 HOURS",0,1,1,0,17,19
The Painting Experience Podcast,0,0,0,1,1,2
The Girl Next Door Podcast,1,1,2,1,179,184
History of the Earth,0,0,0,0,18,18
Criminal,148,60,52,72,1548,1880
NJ 101.5 News,1,1,1,0,2,5
The KYLO Show,0,0,0,0,17,17
Me & Paranormal You with Ryan Singer,3,1,2,6,99,111
The BizChix Podcast:  Female Entrepreneurs | Women Small Business | Biz Chix,0,1,1,0,48,50
The Mexico Podcast: History & Present,3,0,0,0,23,26
Good Show,0,0,1,0,6,7
Sex Gets Real with Dawn Serra,8,2,3,2,35,50
The Kitchen Sisters Present,1,4,3,4,67,79
The Moment with Brian Koppelman,21,10,13,21,215,280
Park Avenue Podcast,0,0,0,0,4,4
Girl Boner Radio,0,0,0,0,50,50
The Nursing Crash Cart,0,0,1,0,14,15
The KrisAnne Hall Show,3,2,1,0,35,41
The Lively Show,18,15,13,6,414,466
Post Show Recaps: TV & Movie Podcasts from Josh Wigler and Friends,7,4,4,5,125,145
Geek History Lesson,14,16,15,17,420,482
Saud Al-Shuraim,0,0,0,0,1,1
Locked On Fantasy Basketball – Daily NBA Fantasy Basketball Podcast,9,2,2,7,480,500
The Children's Book Podcast,0,0,1,1,48,50
FoundMyFitness,3,2,6,1,38,50
Whiskey Knife Fight,2,0,1,1,17,21
Total Party Kill,1,0,2,0,39,42
ELISE GETS CRAFTY,0,0,4,5,61,70
Future Thinkers,2,2,0,1,57,62
Achieve Your Goals with Hal Elrod,2,1,1,3,43,50
PodCraft | Learn the Art of Podcasting in Focussed Seasons,1,0,1,0,17,19
THE BRENDON SHOW,0,0,0,1,49,50
League Rundown - A League of Legends Esports Podcast,6,6,2,3,34,51
Good Beer Hunting,1,1,3,4,43,52
Yasser Al Dossari,0,0,0,0,1,1
Unauthorized Disclosure,2,6,0,0,21,29
The Cardone Zone,13,6,4,3,174,200
The World Crypto Network Podcast,5,0,0,0,11,16
Decades of Horror | Movie Reviews of 1970s Classic Horror Films,0,0,1,2,11,14
Exponent,10,8,5,7,70,100
Sailor Moon News Roundup,0,0,0,0,6,6
Front End Chatter,0,0,0,0,26,26
Happy Sad Confused,12,5,4,10,97,128
Join Us in France Travel Podcast,2,1,0,6,147,156
Short Time Wrestling Podcast,0,1,0,2,47,50
Classic Movie Reviews,0,2,0,2,9,13
Brand You Personal Branding,0,0,0,0,50,50
Teamsters,0,0,0,1,3,4
Coach Glass Podcast,0,3,0,0,47,50
The Cyberlaw Podcast,4,2,1,3,41,51
Critical Care Practitioner,0,0,0,0,1,1
SAYER,3,0,1,2,44,50
Couple Friends,1,1,1,0,47,50
Talk Nerdy with Cara Santa Maria,7,7,3,4,182,203
CFO THOUGHT LEADER,2,1,2,2,51,58
Real Estate Rockstars,12,6,8,12,162,200
Part Of The Problem,5,0,3,2,40,50
Revision Path,0,0,0,5,78,83
Retirement Answer Man,2,1,1,2,194,200
Restaurant Unstoppable with Eric Cacciatore,1,0,1,1,47,50
Guided Sleep Meditations,2,1,2,5,40,50
Savvy Painter Podcast with Antrese Wood,0,1,1,2,196,200
The Legendarium,2,4,2,3,71,82
Pop Fashion,3,0,0,1,89,93
RotoWire Fantasy Baseball Podcast,4,8,11,15,164,202
The Erasable Podcast,0,0,1,1,23,25
"Wealth, Power & Influence with Jason Stapleton",28,8,8,2,104,150
Going Beyond Ministries with Priscilla Shirer,0,0,0,3,38,41
Aviation Week's Check 6 Podcast,16,10,16,6,4,52
Relationship Advice,3,3,4,2,38,50
Gnostic Teachings Podcast,1,0,0,0,26,27
No Such Thing As A Fish,8,4,8,24,592,636
Sex with Strangers,0,0,1,1,48,50
The Bunker,6,1,1,2,40,50
Power Your Parenting: Moms With Teens,0,0,1,2,30,33
AFL Fantasy with The Traders,4,0,2,3,79,88
Futility Closet,3,5,4,2,36,50
YouTube Creators Hub,0,1,1,2,46,50
"The Secret To Success with CJ, Karl, Jemal & Eric Thomas",0,0,0,1,14,15
Business of Photography Podcast,0,0,0,1,20,21
Dynasty Nerds Podcast | Dynasty Fantasy Football,14,10,8,6,462,500
KUT » Two Guys on Your Head,2,0,1,0,21,24
XoneBros: A Positive Gaming & Xbox Series X Community,2,1,4,1,42,50
JUMP with Traveling Jackie,2,1,2,2,125,132
Wheeler Dealer Radio - A Ridiculous Tottenham Hotspur Podcast,6,2,2,0,31,41
Apartment Building Investing with Michael Blank Podcast,0,0,1,1,91,93
"The Performance Podcast | Strength Training, Olympic Weightlifting, Performance, Fitness, Speed  | W...",1,0,0,0,49,50
Thinking about It,0,0,0,0,1,1
ESPN FC,55,32,31,32,143,293
"Dating Tips, Attracting Women & Dating Advice For Men Podcast! | Win The Woman",2,0,0,0,3,5
ADHD reWired,2,0,0,1,47,50
The Slow Ride: A Cycling Podcast,2,3,3,11,174,193
Real Estate Coaching Radio,5,10,6,1,28,50
Plane Safety Podcast - Safety from the flightdeck,0,0,0,0,12,12
FutureSox Podcast,1,0,0,0,3,4
Emperors of Rome,0,1,1,2,46,50
Azeroth Roundtable: A World of Warcraft Podcast,12,1,0,0,37,50
Podigious: A Digimon Adventure 2020 Podcast,0,0,1,1,38,40
Wired To Hunt Podcast,6,2,6,9,477,500
The Secrets of Mathematics,0,0,0,0,2,2
Submarine Sea Stories | Ever wonder what it's like to spend the cold war under water with 100 other ...,0,0,0,1,106,107
What's Up Fool? Podcast,1,0,0,1,48,50
"FREE Ringtones, Funny Ringtones by Ringtone Mafia",4,0,0,0,6,10
Renegade Radio with Jay Ferruggia: Fitness | Nutrition | Lifestyle | Strength Training | Self Help |...,0,0,0,0,50,50
Random Thoughts,0,0,0,0,19,19
Into the Nexus: The Heroes of the Storm Podcast,3,6,4,4,287,304
Daf Yomi Shiur by Rabbi Shalom Rosner,0,0,0,1,5,6
Hamza Tzortzis,0,0,0,0,1,1
BlizzPro's Westmarch Workshop - A Diablo 3 Podcast,0,0,0,1,44,45
RuPaul: What's The Tee with Michelle Visage,10,1,0,2,37,50
The Dealer Playbook,1,1,0,2,58,62
Sigma Nutrition Radio,3,2,1,0,44,50
"People Behind the Science Podcast - Stories from Scientists about Science, Life, Research, and Scien...",0,0,1,0,190,191
The Daily Evolver,0,0,0,0,12,12
"The Love, Happiness and Success Podcast With Dr. Lisa Marie Bobby",1,3,0,0,65,69
The My Wife Quit Her Job Podcast With Steve Chou,1,0,0,1,48,50
Westerns OTR,0,0,0,0,1,1
"The Turkey Hunter Podcast with Andy Gagliano | Turkey Hunting Tips, Strategies, and Stories",14,4,1,1,30,50
KUT » In Black America,3,0,0,2,6,11
Kevin Hates Hip-Hop,0,0,0,0,45,45
Geekin' On WDW Podcast | A Family Friendly Community of Walt Disney World Fans | Travel tips on reso...,3,1,1,3,166,174
Fargo - An Unofficial Podcast,8,5,2,2,79,96
In Penny Stock | Stock Trader & Teacher / How To Trade Stocks / Stock Market / Bitcoin & Crypto,4,2,4,3,30,43
Jay & Miles X-Plain the X-Men,9,10,11,4,166,200
Cosmic Gate: WYM Radio,0,0,0,0,8,8
The Brilliant Idiots,10,5,6,2,27,50
Texas Standard,1,2,2,2,13,20
Long Riders Radio,0,0,1,0,10,11
Fargo Reviews and After Show - AfterBuzz TV,5,3,3,1,13,25
The Tim Ferriss Show,245,119,154,217,3381,4116
The Manwhore Podcast: A Sex-Positive Quest,1,1,0,3,45,50
The Psychedelic Secret,1,0,0,0,2,3
Mind Body Musings,5,1,1,4,233,244
Meditations by Marcus Aurelius,0,0,0,0,1,1
The Critique of Pure Reason by Immanuel Kant,1,0,0,0,0,1
Research Perch,0,0,0,0,2,2
Kabbalah for Everyone,0,0,1,1,1,3
Amazing Spider-Talk: A Spider-Man Podcast,0,0,0,1,31,32
MtnMeister,1,1,0,1,109,112
Walkabout the Galaxy,1,0,2,1,17,21
CLO Level 1 Lessons,0,0,2,1,3,6
"Star Singer; Voice Lessons, Singing Lessons and Tips About Singing",1,0,1,1,29,32
Bare Naked Agent- Selling Homes Today- Timely Topics!!!,0,0,0,0,19,19
The TLS Podcast,0,0,2,1,32,35
The DIS Unplugged: Universal Edition - A Weekly Discussion About All Things Universal Orlando,8,3,5,7,111,134
The Woody Show,6,2,1,0,41,50
All TWiT.tv Shows (Video),0,0,0,0,3,3
"Right to R.E.A.L. Love: Advice for Christians on Dating, Relationships, Faith and Sex",1,1,2,2,304,310
Around the House with Eric G®,1,0,0,0,6,7
Do You Need A Ride?,1,0,0,0,49,50
Leading Saints Podcast,0,1,2,2,73,78
LifeSpa: Ayurveda Meets Modern Science,0,1,0,1,10,12
The Potters Cast | Pottery | Ceramics | Art | Craft,0,0,0,0,100,100
Bald Move Prestige,16,8,2,1,58,85
The Masonic Roundtable - Freemasonry Today for Today's Freemasons,2,0,0,1,23,26
God Centered Success With Mia Rene,5,1,1,3,190,200
Read-Aloud Revival,0,0,3,1,46,50
The Life Coach School Podcast,15,3,5,2,175,200
The Trucking Podcast,3,0,1,1,25,30
Be Wealthy & Smart,0,0,1,0,49,50
Pencil Kings | Inspiring Artist Interviews with Today's Best Artists,0,0,1,2,39,42
"Death, Sex & Money",25,17,14,20,424,500
"Legendary Life Podcast: Lose Weight, Fight Disease & Live A Longer, Healthier Life",0,0,0,0,50,50
SAGE Psychology & Psychiatry,0,0,1,0,0,1
SAGE Sociology,0,0,0,0,1,1
Bobby Owsinski's Inner Circle Podcast,0,0,0,1,17,18
This Anthro Life,0,1,1,0,15,17
Screw The Nine to Five,0,0,0,0,50,50
Caught Offside,5,2,3,7,483,500
Porn Free Radio,0,1,0,0,49,50
The Audio Guide to Babylon 5,0,6,0,1,14,21
Regret Labs Podcast: Science | Comedy | Humility,0,0,0,2,13,15
Ginger Runner LIVE,1,0,0,2,26,29
Chrystal's Chronicles,0,0,0,6,207,213
Tips for Lawyers Podcast,0,0,0,0,6,6
BioTech Nation Radio Podcast,0,0,0,0,2,2
The RPG Academy,0,0,0,0,50,50
Radio Cherry Bombe,2,0,1,5,44,52
Slate Money,25,22,22,28,103,200
Talkhouse Podcast,1,0,1,1,14,17
Daily Easy English Expression Podcast,1,1,0,0,48,50
BNI & The Power of One,0,1,0,0,34,35
Bhagavad Gita Chapter 01,0,0,0,0,1,1
Bhagavad Gita Chapter 02,0,0,0,0,1,1
Bhagavad Gita Chapter 09,0,0,0,0,1,1
Brhadaranyaka Upanishad,0,0,0,0,1,1
Katha Upanishad,0,1,0,0,0,1
FOAMcast -  Emergency Medicine Core Content,0,0,0,1,31,32
Homesteady - Stories of Living off the Land,1,6,8,8,172,195
The Anjunadeep Edition,0,0,1,1,48,50
The Marriage Podcast for Smart People,1,0,4,2,104,111
Marketing Online,1,0,0,0,26,27
RunBuzz Running Podcast,2,1,1,0,95,99
The Mac Observer's Daily Observations,10,5,1,1,16,33
Jajam Shlomo (Sally) Zaed,0,0,0,0,1,1
The Happy Hour with Jamie Ivey,5,4,10,7,474,500
Real Ghost Stories Online,82,45,33,26,314,500
Reality TV RHAP-ups: Reality TV Podcasts,7,1,3,7,123,141
Bachelor RHAPups Podcast: A Reality TV RHAPups Podcast,14,12,11,4,86,127
CarStories,4,2,1,2,32,41
No Laying Up - Golf Podcast,25,11,15,16,433,500
Ultima Final Fantasy | The Ultimate Final Fantasy Podcast,7,5,4,8,172,196
Fix It Home Improvement,3,5,10,2,30,50
The W. Edwards Deming Institute® Podcast,0,0,0,0,2,2
Radio Fitness Revolucionario,0,0,0,0,8,8
Eatweeds Podcast: For People Who Love Plants,0,0,0,0,3,3
Call Your Girlfriend,31,20,24,24,401,500
Diego Dreyfus,0,0,0,1,26,27
The Accidental Wrestling Fan,0,0,0,0,9,9
Contractor Success Map with Randal DeHart | Contractor Bookkeeping And Accounting Services,0,0,1,1,2,4
Copeland Coaching Podcast,0,1,0,0,23,24
Money For the Rest of Us,10,7,5,5,173,200
Gilbert Gottfried's Amazing Colossal Podcast,5,1,4,6,84,100
The Reloading Podcast,7,5,3,3,73,91
I Love Learning Chinese,0,0,0,1,18,19
Eat the Rudecast - A Podcast about Hannibal Lecter,0,0,0,2,8,10
The Audible with Stew & Bruce: A show about college football,19,9,10,10,133,181
Inside EMS,0,1,0,5,10,16
The Honest Real Estate Agent |  Sales and Marketing Tips for Realtors | And Much More!,0,0,0,1,58,59
Happy English Podcast,0,0,0,3,21,24
Meeple Nation Board Game Podcast,0,0,0,1,7,8
"""We Do Science"" - The Performance Nutrition Podcast",0,1,1,0,13,15
The State of the Scene (SOTS Podcast),3,1,0,0,27,31
Guys We F****d,1,0,0,0,49,50
Reveal,0,0,1,0,49,50
The Wellness Mama Podcast,1,0,0,0,49,50
Brilliant Business Moms with Beth Anne Schwamberger,0,1,1,2,96,100
100 Near Death Experiences,2,2,1,2,2,9
Thinking LSAT,4,0,1,2,43,50
American Fashion Podcast,0,2,1,1,22,26
The Pedalshift Project: Bicycle Touring Podcast,0,0,0,1,65,66
GFNY Cycling,0,0,0,0,1,1
The Unschooling Life,0,0,0,0,10,10
Quantum Physics I,0,0,0,0,3,3
The Challenge RHAP-up | Rob has a Podcast,14,7,10,8,461,500
That Sober Guy Podcast,9,2,2,0,37,50
The Clever Cookstr's Quick and Dirty Tips from the World's Best Cooks,0,3,1,0,2,6
The Stories of Mahabharata,1,1,8,11,96,117
Friendly Atheist Podcast,19,6,9,13,235,282
PleasureTown,1,0,2,9,78,90
"The SDR Show (Sex, Drugs, & Rock-n-Roll Show) w/Ralph Sutton & Big Jay Oakerson",1,0,0,0,49,50
Octane Personal Training with Jason Benavides,0,0,0,1,49,50
Data Skeptic,6,12,9,9,75,111
REBEL Cast,0,0,0,0,4,4
The Dental Hacks Podcast,1,1,0,1,47,50
Sow Edible  Podcast,0,1,1,2,95,99
"Chasing Tone - Guitar Podcast About Gear, Effects, Amps and Tone",3,2,5,3,37,50
Halo Podcast Evolved,1,1,0,3,20,25
Relentless Health Value,0,0,0,0,32,32
Obstacle Dominator,5,5,5,4,50,69
Adventure Rider Radio Motorcycle Podcast,0,1,0,0,49,50
Radio Westeros ASoIaF Podcasts,0,0,1,2,160,163
NPK Hydroponics Live,0,0,0,0,2,2
Open Air with Cheri Huber,0,0,0,0,2,2
True Blood Authority,0,1,0,0,45,46
Pod Van Dam: A Wrestling Adjacent Podcast,1,0,0,0,15,16
Ask the Expert,0,0,0,0,3,3
The Simpsons Show,14,18,8,16,144,200
Science Fiction Film Podcast (2019),7,5,1,4,164,181
Teaching in Higher Ed,1,1,0,5,43,50
Adventure of The Month - Kids and Children,4,0,3,0,11,18
Legend of the Innkeeper : A Hearthstone Podcast for Casual Players,2,1,0,1,46,50
Barbell Life,0,0,0,2,27,29
TG Geeks Webcast,0,0,0,0,5,5
Move Your DNA with Katy Bowman,0,2,1,1,46,50
History Of The Great War,0,2,1,3,44,50
Earbud Theater,0,0,0,0,50,50
The Mating Grounds Podcast,4,4,2,1,39,50
TWiT Bits (Audio),0,0,0,0,2,2
TWiT Bits (Video),0,1,0,0,1,2
We Do: A Watchmen Podcast,8,6,6,4,150,174
APA Journals Dialogue,0,0,3,0,0,3
The Curious Couple,2,1,1,2,33,39
The Productive Woman,0,1,2,1,46,50
Help Me Be Me,1,0,0,2,47,50
Radical Personal Finance,31,14,7,7,141,200
Seincast: A Seinfeld Podcast,9,4,7,12,393,425
Jewels from the Crown: for Los Angeles Kings fans,2,0,0,0,0,2
Big Seance: My Paranormal World,2,0,0,0,72,74
The Love and Respect Podcast: Relationships | Marriage | Theology | Psychology,1,1,3,4,172,181
The Eddie Trunk Podcast,10,4,7,3,26,50
Nora En Pure - Purified Radio,0,0,0,0,44,44
The Command Zone,0,2,3,0,45,50
The Audio PANCE and PANRE Physician Assistant Board Review Podcast,0,0,1,1,14,16
The Mixology Talk Podcast: Better Bartending and Making Great Drinks,0,0,1,1,33,35
Rock & Metal Combat Podcast,2,0,0,2,46,50
Ask Iliza Anything,3,0,0,1,45,49
The Trauma Therapist,1,0,4,2,43,50
Rotoviz Radio,7,3,2,16,472,500
DucksNPucks Podcast,4,2,2,1,23,32
Trust and Believe with Shaun T,0,0,2,1,47,50
5 Minute Biographies,0,1,0,2,20,23
The Cult of Pedagogy Podcast,1,0,1,1,47,50
Dhamma Discourse,0,0,0,0,1,1
Real Ass Podcast,5,0,0,1,44,50
Shopify Masters | The ecommerce business and marketing podcast for ambitious entrepreneurs,3,3,4,2,88,100
Everyday Driver Car Debate,2,0,3,0,45,50
BYU Sports Nation,5,0,1,2,26,34
Nourish Balance Thrive,1,0,0,0,49,50
Arizona Diamondbacks Podcast,0,1,0,0,4,5
Atlanta Braves Podcast,1,0,1,0,2,4
Kansas City Royals Podcast,0,0,0,0,3,3
Phillies Backstage with Brazer and Burgoyne,0,1,1,1,3,6
Dungeon Master's Block,3,0,0,1,46,50
United Hour,0,0,0,0,5,5
X-Men: The Audio Drama,4,0,1,2,33,40
Detroit Bad Boys: for Detroit Pistons fans,0,0,1,1,10,12
The Liturgists Podcast,39,18,14,18,369,458
A History of Philosophy by Dr. Arthur F. Holmes,0,0,0,2,5,7
The Auto Detailing Podcast,2,0,0,3,45,50
Brant & Sherri Oddcast,1,0,1,2,258,262
QSO Today Podcast - Interviews with the leaders in amateur radio,0,0,0,1,16,17
Rotary Wing Show - Interviews from the Helicopter Industry,0,1,0,0,14,15
Thus Spake Zarathustra: A Book for All and None by Friedrich Nietzsche,0,0,0,0,1,1
The Flipping 50 Show,1,1,0,2,42,46
"The Struggle Bus: Self-Care, Mental Health, and Other Hilarious Stuff",1,2,2,3,42,50
Best Real Estate Investing Advice Ever,4,2,0,6,188,200
Home Front,2,1,0,1,10,14
The Blue Testament: for Sporting KC fans,3,1,1,2,2,9
Boop,1,0,0,2,16,19
Case Interview Preparation & Management Consulting | Strategy | Critical Thinking,0,1,0,0,31,32
The Jeff Nippard Podcast,1,0,0,5,44,50
WE DON'T DIE® Radio Show with host Sandra Champlain,1,0,2,0,71,74
Blood Brothers Horror Podcast,0,0,2,0,8,10
The Burning Couch,0,0,0,0,13,13
The Jasta Show,3,3,2,1,41,50
a ModelersLife,1,0,0,0,24,25
Behind the Steel Curtain: for Pittsburgh Steelers fans,3,3,3,4,44,57
The Inside Winemaking Podcast with Jim Duane,1,1,1,2,45,50
Coroner Talk™ | Death Investigation Training | Police and Law Enforcement,6,1,2,1,40,50
Back To My Garden - Discover Your Passion For Gardening,1,0,1,0,24,26
From the Front Porch,10,13,7,10,160,200
Sustainable Dish Podcast,3,0,1,2,22,28
The Girlfriend Doctor w/ Dr. Anna Cabeca,0,0,0,0,32,32
BLACK ENTREPRENEUR BLUEPRINT,2,1,1,2,101,107
Beating The Book with Gill Alexander,7,2,2,3,63,77
Nature Bats Last,0,0,0,0,3,3
Marvel Cinematic Universe Podcast: WandaVision,14,5,6,4,311,340
Outlander Cast: The Outlander Podcast With Mary & Blake,12,8,6,24,398,448
The Highly Sensitive Person Podcast,0,1,0,1,48,50
The Future of Work With Jacob Morgan,1,1,0,3,66,71
Stephen King Cast,5,1,6,12,176,200
Lead Through Strengths,0,1,0,1,120,122
The World Wanderers Podcast,23,7,2,4,105,141
The Anxiety Coaches Podcast,2,2,3,1,42,50
Men In Blazers,14,8,11,11,306,350
Analog(ue),2,0,3,2,37,44
Stock Trading University,1,0,1,2,12,16
The HP Outdoors Waterfowl Podcast,2,2,1,6,456,467
Climate Connections,1,0,0,1,5,7
Celtics Beat,4,3,5,7,270,289
Connected,9,4,0,2,55,70
Wolf 359,0,0,0,1,49,50
The College Prep Podcast,0,0,0,4,46,50
Jenna & Julien Podcast,0,0,0,0,50,50
Informed Pregnancy Podcast,5,2,0,2,41,50
"Scarlet Lovella: BDSM, Fetish and Sexuality",0,0,0,0,12,12
The Simple Sophisticate - Intelligent Living Paired with Signature Style,2,4,3,3,38,50
The Official Outlander Podcast,4,11,16,8,76,115
Dark Winter Nights: True Stories from Alaska,0,0,0,1,2,3
Outdoor Radio,0,0,0,0,3,3
Build Your Tribe | Grow Your Business with Social Media,2,1,1,2,194,200
"The Chalene Show | Diet, Fitness & Life Balance",2,0,0,1,47,50
Ask The Health Expert,0,1,0,2,47,50
Clapcast from Claptone,0,0,0,0,22,22
Film Photography Podcast,1,1,2,1,35,40
So Wizard Podcast,0,0,0,0,131,131
The AuburnSports.com Rundown,0,0,0,1,8,9
Bruins Beat,2,0,1,0,25,28
Jungianthology Podcast,0,0,0,2,12,14
Mountain Cloud Zen Podcasts,0,0,0,0,3,3
The Positive Psychology Podcast - Bringing the Science of Happiness to your Earbuds with Kristen Tru...,0,0,0,4,40,44
Dogman Encounters Radio,1,2,6,11,51,71
Boomerang,0,0,0,1,0,1
The Carey Nieuwhof Leadership Podcast: Lead Like Never Before,1,2,5,10,482,500
PM Point of View,0,0,0,0,6,6
Multiamory,0,0,1,4,45,50
The Productivityist Podcast,1,2,1,2,25,31
The Functional Medicine Radio Show With Dr. Carri,1,0,0,1,23,25
Tel Aviv Review,1,1,0,3,37,42
The PFF NFL Podcast,21,7,12,9,451,500
StartUp Podcast,32,24,14,13,117,200
Mastering Marriage:  Marriage Advice & Coaching | Destroying Divorce | Mend Our Marriage,1,0,0,4,45,50
The Laura Ingraham Show,20,0,3,2,25,50
The Salesforce Admins Podcast,3,1,1,1,46,52
The Incomparable Radio Theater,1,0,0,1,14,16
"It's About Time - A time-travel comedy, modern audio drama",1,1,0,6,42,50
Evolution Talk,1,1,0,3,50,55
Economics Detective Radio,2,0,2,0,8,12
Warrior Life - Modern Combat & Survival | Tactical Firearms | Urban Survival | Close Quarters Combat...,10,7,5,4,66,92
London Is Blue - Chelsea FC Soccer Podcast,5,2,3,6,484,500
Clear Your Clutter Inside & Out,3,4,3,1,36,47
The Contracting Coachcast: Construction Business Improvement,0,0,0,0,11,11
Organize 365 Podcast,2,2,4,0,42,50
Secrets of Doctor Who,0,0,0,1,29,30
NFL: Move the Sticks with Daniel Jeremiah & Bucky Brooks,17,6,5,19,453,500
PreMarket Prep,2,1,0,0,3,6
The MMQB NFL Podcast,73,15,18,28,207,341
Imaginary Worlds,3,3,7,2,185,200
Earth to Humans!,0,0,0,1,20,21
The Byron Chronicles –,1,0,0,2,17,20
Speakeasy - A Boardwalk Empire Podcast,0,0,0,1,22,23
Money Tree Investing,9,3,1,0,60,73
Mountain Bike Radio,6,2,6,6,100,120
Where My Mom's At? w/ Christina P.,5,1,0,1,43,50
Dentistry Uncensored with Howard Farran,0,1,1,1,39,42
"The SaaS Podcast - SaaS, Startups, Growth Hacking & Entrepreneurship",0,0,0,0,50,50
The Kitchen Counter - Home Cooking Tips and Inspiration,0,0,0,2,42,44
History Goes Bump Podcast,5,1,1,2,41,50
The Blacklist Exposed,0,0,2,1,80,83
Fantasy Footballers - Fantasy Football Podcast,13,1,4,3,479,500
The Poker Coaching Podcast with Jonathan Little,0,3,0,3,44,50
Serial,670,105,160,145,1205,2285
Upgrade,11,4,3,2,48,68
Little Sprigs Podcast,0,0,0,0,25,25
The MM Cast,7,3,5,6,29,50
The Unofficial Shopify Podcast,2,0,0,0,48,50
All About the Gear,0,2,1,2,21,26
Gastropod,12,6,14,9,159,200
Phoenix Helix: Autoimmune Health,0,0,0,0,50,50
The Reboot Podcast,0,0,3,0,55,58
The 18STRONG Podcast,2,1,0,3,117,123
CodeNewbie,3,4,4,2,63,76
Working Class Audio,0,0,0,2,41,43
Bedside Rounds,0,0,0,0,46,46
Beyond the Business Suit with Kailei Carr,0,0,0,0,32,32
The Human Experience Podcast,2,0,1,1,111,115
The Woolly Thistle podcast,0,0,0,1,29,30
VOMRadio,0,0,0,0,115,115
Hypnotherapy and Mental Health by Paula Sweet at Absolute Mind,0,1,1,1,40,43
Fantasy Team Advice,0,0,0,0,13,13
Rental Income Podcast With Dan Lane,3,1,3,1,192,200
The GRID: A Power Rangers Podcast,0,0,1,0,3,4
Noxious Deejay Podcast,1,0,0,2,33,36
The Tikvah Podcast,0,0,0,3,38,41
The RV Atlas Podcast,4,4,4,6,204,222
The Ultimate Health Podcast,3,0,0,3,44,50
The Peggy Smedley Show,0,0,0,0,2,2
The Worst Bestsellers,7,7,4,6,95,119
C10 Talk,0,0,0,0,50,50
The Wandering DP Podcast,0,0,0,2,94,96
Search Engine Journal Show,0,3,2,0,24,29
Heart Wisdom with Jack Kornfield,1,0,0,1,46,48
Pilgrim Heart with Krishna Das,2,0,0,0,16,18
Metta Hour with Sharon Salzberg,0,0,0,0,18,18
The How To Get Away With Murder Podcast,4,7,3,2,20,36
Astonishing Legends,41,43,49,32,335,500
Mat Talk Podcast Network,0,1,0,1,15,17
Purple Daily - A Minnesota Vikings Podcast,25,7,2,9,87,130
Out on the Lanai: A Golden Girls Podcast,7,11,10,5,94,127
Gilmore Guys,8,1,3,7,31,50
In This League Fantasy Basketball,2,1,1,0,103,107
"Smart Women, Smart Power",2,0,0,0,8,10
UNC Hoops Talk Podcast,0,0,0,0,11,11
BlacksmitHER Radio,0,0,0,0,5,5
"CannaInsider - Interviews with the Business Leaders of The Legal Cannabis, Marijuana, CBD Industry",1,1,3,1,142,148
The Criminal Minds Podcast,0,0,3,0,5,8
BBC Learning English Drama,3,1,0,1,5,10
Blended Family Podcast,0,0,2,1,47,50
RV Podcast,5,8,6,14,138,171
American Horror Story Podcast,13,5,4,3,47,72
Stories of an Unschooling Family,0,0,0,0,23,23
Manga Machinations,0,0,0,0,8,8
The Rich Eisen Show,16,4,10,5,35,70
Superman and Lois TV Talk,0,0,1,2,60,63
Twisted Stitches,0,0,0,1,5,6
Campaign: Skyjacks,0,0,1,3,46,50
Get Rich Education,2,0,2,0,196,200
EOS 10,0,0,0,3,47,50
The GaryVee Audio Experience,1,0,0,0,29,30
The Walking Dead Talk Through,2,1,1,3,24,31
Mamamia Out Loud,58,20,32,38,502,650
Soul of Islam Radio,0,0,0,1,28,29
The Dog's Way Podcast: Dog Training for Real Life,1,1,0,2,21,25
"Amicus With Dahlia Lithwick | Law, justice, and the courts",5,5,4,2,34,50
Two Ewes Fiber Adventures,1,0,0,1,41,43
We Study Billionaires - The Investor’s Podcast Network,0,0,0,2,38,40
Speak English With A British Accent,0,0,0,0,1,1
Louder with Crowder,8,2,0,0,260,270
Responsa Radio - Hadar Institute,0,0,0,0,6,6
Creative Pep Talk,1,5,2,4,188,200
Radical with David Platt,0,0,0,2,64,66
Tanach Study,0,0,0,0,2,2
Working,8,4,3,6,29,50
Fireside Mystery Theatre,3,2,0,3,42,50
GRE Vocabulary Podcast by VictorPrep,0,0,0,0,50,50
So Many Damn Books,1,0,0,2,79,82
Full Stack Radio,0,0,0,2,27,29
Veterinary ECC Small Talk,0,0,0,2,31,33
The Option Alpha Podcast,3,1,1,2,193,200
Marriage More Podcast - Making Your Marriage More - Relationships | Couples | Intimacy | Christian |,4,3,5,3,35,50
The Food Chain,1,0,1,1,19,22
The His and Her Money Show,0,0,1,2,47,50
Hypnobirthing Hub,1,1,0,0,2,4
Nursing Podcast by NURSING.com (NRSNG) (NCLEX® Prep for Nurses and Nursing Students),1,0,1,1,47,50
Werewolf Ambulance: A Horror Movie Comedy Podcast,1,0,0,3,139,143
Switched on Pop,8,2,1,0,39,50
The Mind Muscle Project,1,1,3,0,45,50
The Dan Le Batard Show with Stugotz,40,24,12,4,630,710
MedMaster Show (Nursing Podcast: Pharmacology and Medications for Nurses and Nursing Students) by NU...,1,0,1,1,8,11
Finding the Missing Peace by Ajahn Amaro,0,0,0,0,3,3
Ajahn Sumedho Podcast by Amaravati,0,0,0,0,2,2
Designer Notes,1,0,0,0,13,14
Retro Disney World Podcast,1,1,2,4,83,91
Medieval Death Trip,0,1,0,0,42,43
The Allender Center Podcast,2,1,3,2,45,53
"MMHMM, GIRL",3,3,5,5,34,50
Chat 10 Looks 3,2,4,2,7,122,137
Caalo Xan: A Sci-Fi Audio Drama,0,0,0,1,6,7
Atomic Moms,0,0,0,1,49,50
We Gotta Thing - A Swinger Podcast,1,3,1,1,44,50
Bridechilla- Wedding Planning Podcast,3,0,1,3,181,188
The Kinda Funny Podcast,25,3,2,0,20,50
"Alba Salix, Royal Physician",0,1,1,3,45,50
76ers Podcast Network,1,1,0,2,11,15
Anjunabeats Worldwide,1,1,1,2,9,14
Gravy,0,1,0,1,47,49
"Noob Spearo Podcast | Spearfishing Tips, Stories and Interviews",0,0,0,0,46,46
Fastbreak Breakfast NBA Podcast,3,0,2,1,139,145
UI Breakfast: UI/UX Design and Product Strategy,0,1,2,1,18,22
"Making It With Jimmy Diresta, Bob Clagett and David Picciuto",3,1,1,0,45,50
Naked Mormonism Podcast,7,1,6,6,115,135
Go Natural English Podcast | Listening & Speaking Lessons,1,0,1,3,23,28
Shift and Steer,2,2,2,1,43,50
The Entrepreneurship Elevated Podcast,0,0,0,4,46,50
Turned Out A Punk,1,1,2,5,118,127
Uncovered with Dr. Laura Berman: Highlights,1,0,0,0,9,10
The YouTube Power Hour Podcast,4,3,0,1,42,50
Linear Digressions,0,0,0,2,61,63
State of the Arts,0,0,0,0,13,13
The Adult Chair,0,0,0,0,50,50
Economic Rockstar,0,0,0,1,49,50
SmashBoxxTV's Disc Golf Podcast,0,1,2,2,12,17
The Pensky Podcast,0,0,0,1,27,28
Reply All,191,51,31,12,215,500
Bedtime Stories Podcast Fairytales and Folk Tales from the Lilypad for kids,2,1,5,4,38,50
Teaching Your Brain to Knit,0,0,0,0,27,27
French Voices Podcast | Learn French | Interviews with Native French Speakers | French Culture,0,0,0,0,33,33
Myleik Teele's Podcast,2,0,1,3,194,200
Golf Talk Live,0,0,1,0,0,1
The Psychology Podcast with Scott Barry Kaufman,0,0,0,0,6,6
For The Wild,0,0,1,0,90,91
Today In Space,0,0,0,0,1,1
The Nonprofit Exchange: Leadership Tools & Strategies,0,0,0,0,6,6
The Rental Rookie Podcast,1,1,0,2,46,50
Libertarian,9,3,1,0,37,50
Dr. Pompa & Cellular Healing TV,1,0,3,3,33,40
Foundr Magazine Podcast with Nathan Chan,0,0,0,3,47,50
Boats & Billfish,0,0,0,0,4,4
Here We Are,3,0,3,9,408,423
Muscles by Brussels Radio!,0,2,0,1,40,43
That Sounds Fun with Annie F. Downs,6,4,3,8,479,500
Adult Film Star Network,3,2,1,0,32,38
Totally Deep Backcountry Skiing Podcast,0,1,2,2,49,54
Managing Madrid: for Real Madrid fans,1,0,0,1,54,56
Top Level Podcast,0,3,3,4,21,31
FUN Japanese Listening » podcasts,0,0,0,2,0,2
Journey With Deanna,0,0,0,0,2,2
Government Contracting Officer Podcast,0,0,0,0,46,46
Ben Franklin's World,4,8,7,3,28,50
The Observatory,1,0,3,1,27,32
Design Details,2,3,2,8,111,126
The Columbo Podcast,0,0,0,0,55,55
The HighExistence Podcast,0,0,0,7,69,76
Design Review,0,0,0,1,39,40
The Adventure Zone,7,3,1,3,36,50
Content Inc with Joe Pulizzi,0,0,0,1,37,38
Exchanges at Goldman Sachs,6,4,6,7,25,48
Stories Podcast: A Bedtime Show for Kids of All Ages,31,11,31,47,375,495
Crime Writers On...True Crime Review,66,23,25,17,369,500
The Citizen's Guide to the Supreme Court,8,1,2,3,36,50
MISC on LMC Radio Network,0,0,1,0,1,2
Dear Sugars,29,21,22,28,382,482
The Orbital Mechanics Podcast,0,0,1,1,62,64
The Nail Hub Podcast,0,0,0,0,11,11
Sky News Daily,1,2,1,0,1,5
Weekly Manga Recap,0,1,0,1,48,50
The Taz Show,21,3,7,8,356,395
Nocturne,8,3,3,3,185,202
Frightday,8,2,1,1,136,148
The Paul Kirtley Podcast,0,0,0,0,22,22
Anchored with April Vokey,4,1,3,1,182,191
Lawyerist Podcast,0,0,0,0,30,30
2017 California Driver Audio Handbook,2,1,0,1,7,11
Mystery Show,15,5,7,16,457,500
Country-ish,0,0,0,1,49,50
Spartan Up! - A Spartan Race for the Mind!,5,1,1,2,41,50
How To Talk To Girls Podcast,5,0,3,3,39,50
The Storm: A Lost Rewatch Podcast,19,12,10,22,437,500
Invisibilia,92,37,21,27,323,500
Fertility Friday Radio | Fertility Awareness for Pregnancy and Hormone-free birth control,2,1,4,4,39,50
The Safety Pro Podcast,0,0,0,0,50,50
MAKING CHIPS Podcast for Manufacturing Leaders with Jason Zenger & Jim Carr,0,0,1,2,30,33
NURSING.com NCLEX® Question of the Day (Nursing Podcast for NCLEX® Prep and Nursing School) by NURSI...,0,0,0,0,5,5
Straight Chilling: Horror Movie Review,4,3,1,0,38,46
Shipping & Handling,2,0,0,0,27,29
Mortgage Lending Mastery,1,1,0,0,62,64
Motley Fool Answers,9,3,7,6,175,200
Elite Man Podcast,20,1,2,1,26,50
Mind Pump: Raw Fitness Truth,0,2,0,1,47,50
The Joy of Text - Jewish Public Media,2,2,0,0,7,11
"Lens Shark Photography Podcast - the latest in DSLR, mirrorless, lenses, photo software, tips, trick...",0,0,0,0,9,9
Angela Watson's Truth for Teachers,0,0,0,0,50,50
Fashion Is Your Business - a retail technology podcast,0,0,0,0,36,36
The Benjamin Dixon Show,24,3,3,3,95,128
New Books in Indian Religions,0,0,1,0,0,1
Duke Basketball Report,1,3,2,1,35,42
Primal Potential,0,1,0,0,49,50
Professional Organizer's Think Tank podcast,1,0,1,0,3,5
The Inspired Pilot Podcast,0,0,0,0,48,48
The Productivity Show: Time Management | GTD | Smart Personal Development | Business | Mac,6,2,3,10,108,129
Sermon of the Day,2,0,0,1,28,31
Sky Tour Astronomy Podcast,0,0,0,2,17,19
The Elysium Project,2,1,2,4,23,32
Super Speeders,2,1,0,0,22,25
Songcraft: Spotlight on Songwriters,0,1,0,2,34,37
The Digital Analytics Power Hour,0,0,0,0,31,31
The Great Albums,5,5,5,1,34,50
Between Now and Success,0,0,0,1,31,32
The Art of Online Business,0,0,0,0,50,50
Doctor Tottenham,0,0,0,0,24,24
Pop Culture PileDriver,1,0,0,0,17,18
Developer Tea,0,2,1,4,143,150
LST's I Am The Law,0,0,0,0,3,3
The Unbeatable Mind Podcast with Mark Divine,0,1,3,3,43,50
Catholic Answers Focus,1,0,3,2,55,61
So Money with Farnoosh Torabi,8,4,8,2,178,200
12 Tribes of Israel Congregation | 12T.CO,0,0,0,0,1,1
No Redeeming Qualities,0,0,0,0,14,14
"1001 Heroes, Legends, Histories & Mysteries Podcast",6,1,3,0,40,50
Rational Security,2,0,3,2,43,50
"Being Boss: Mindset, Habits, Tactics, and Lifestyle for Creative Entrepreneurs",3,4,1,0,42,50
Strength & Scotch: Get Fitter While Enjoying Life,1,0,1,3,45,50
The Body Serve,0,0,3,2,70,75
MTGGoldfish Podcast,5,5,4,4,31,49
Bailey and Southside Podcast,3,1,0,1,10,15
Dollars to Donuts,0,0,0,0,20,20
The RobCast,30,8,6,12,431,487
The Cozy Robot Show (Formerly Ask Science Mike),2,0,1,4,250,257
In This League Fantasy Baseball,7,2,5,5,166,185
Special Operations Medical Association,0,0,1,1,6,8
Millennial Money,8,4,4,6,28,50
Kinda Funny Gamescast,15,7,3,2,23,50
Messy Family Podcast : Catholic conversations on marriage and family,0,0,1,0,49,50
Espresso English Podcast,0,0,0,0,17,17
The Nurse Keith Show,1,0,0,1,42,44
Chat With Traders,1,1,0,1,197,200
Dear Handmade Life,0,1,1,1,78,81
The Homeschool Snapshots Podcast,0,0,1,1,48,50
The Allusionist,2,5,3,7,183,200
So you want to be a photographer: Transform your skills and build a profitable photography business,1,0,1,0,48,50
The Muscle Car Guy Podcast,0,0,1,1,5,7
Plant Trainers Podcast - Plant Based Nutrition & Fitness,1,0,0,1,48,50
Coffee Break Italian,1,0,0,2,47,50
The Twenty Minute VC: Venture Capital | Startup Funding | The Pitch,2,2,4,1,47,56
Game Of Thrones,4,1,3,3,160,171
The Trap Set with Joe Wong,0,1,4,3,106,114
Ask a Spaceman!,2,2,0,2,101,107
Slow American English,0,0,0,1,2,3
Fireteam Chat: IGN's Destiny Podcast,29,17,23,25,259,353
Accounting Play Podcast: Learn Accounting,0,0,2,0,14,16
Buddhism Guide,0,1,1,1,30,33
Photobomb Photography Podcast,1,1,0,1,85,88
The Police Podcast,1,0,0,0,33,34
Sustainababble,0,1,0,0,20,21
"A History of Architecture, the Fundamental Process Podcast",0,0,0,0,10,10
Pseudo-Archaeology,2,1,5,2,18,28
D1Baseball,1,0,1,2,20,24
Golf Strategy School Podcast,0,1,0,0,33,34
The Bookmonger,0,0,1,2,27,30
Everyday Zen Podcast,0,0,0,0,1,1
Kevin Ward's YES Talk | Real Estate Coaching and Success Training for Agents,0,1,0,0,21,22
Assistive Technology FAQ (ATFAQ) Podcast,0,0,0,0,2,2
BallSh!t | Ball Python Industry PodCast | EbNMedia.tv,0,0,0,0,15,15
Ike Live Fishing Talk Show with Mike Iaconelli,3,2,0,3,68,76
The Realistic Prepper,5,1,0,3,32,41
Gallup Theme Thursday,0,0,0,0,6,6
The Ricochet Audio Network Superfeed,6,1,3,1,39,50
From the Head of the Bed,1,0,0,0,14,15
The MeatEater Podcast,23,12,12,7,446,500
Everyday Ayurveda and Yoga at Hale Pule,0,0,0,0,16,16
I Know Dino: The Big Dinosaur Podcast,1,1,0,3,48,53
The Dark Place: Conversations About Mental Health | Depression | Anxiety,1,0,0,0,10,11
Defenders TV Podcast. A WandaVision podcast from TV Podcast Industries,2,0,0,4,25,31
The Naked Bible Podcast,10,7,1,4,411,433
Year of Polygamy Podcast,5,1,1,1,42,50
The Hunting Dog Podcast,6,8,7,14,400,435
The Marketing Book Podcast,0,0,0,0,50,50
Talking Dirty with Rebecca Love,1,1,0,0,19,21
Sick Addictions with Joclyn Stone,0,0,1,1,18,20
FloWrestling Radio Live,7,2,2,5,73,89
Rude Alchemy,1,0,0,1,48,50
ADHD People | The Tom Nardone Show | An Enema of ADHD,3,1,0,0,25,29
Mastering Business Analysis,0,0,0,0,22,22
Coffee With a Sign Painter,0,0,2,1,25,28
Batman: The Long Halloween - Audio Drama,5,0,0,1,19,25
Juicebox Podcast: Type 1 Diabetes,1,0,0,1,48,50
Better Cast Saul - Better Call Saul Unofficial Podcast,37,8,5,5,102,157
Godsfall  | A Dungeons and Dragons Podcast,5,1,1,2,41,50
TSR Speed Shop RC podcast,0,0,0,0,1,1
The Pickleball Show with Chris Allen,0,0,0,1,31,32
JSE Direct with Simon Brown,0,1,0,1,38,40
GREEN Organic Garden Podcast,0,4,2,1,43,50
Two Man Power Trip of Wrestling Podcast,2,1,0,4,20,27
PreAccident Investigation Podcast,0,0,0,0,18,18
Supergirl Radio,1,0,1,0,55,57
The Growth Show,0,1,1,3,45,50
AppleInsider Podcast,28,27,21,13,94,183
Kind World,4,0,5,3,142,154
Rock Your Brand Podcast,3,1,1,1,44,50
Grow Milkweed Plants,0,0,0,0,3,3
Grief Out Loud,0,0,0,0,21,21
Scrum Master Toolbox Podcast,0,0,1,0,14,15
Meditation Minis Podcast,0,0,1,1,48,50
Swimming Ideas Podast,1,0,0,0,0,1
The Tolkien Road,6,2,0,0,60,68
Don Diablo Presents Hexagon Radio,1,0,1,0,31,33
Multiplier Mindset® with Dan Sullivan,0,0,0,0,13,13
The Style Success Podcast,3,5,3,4,38,53
Veterinary Secrets,0,1,0,1,8,10
Song Talk Radio | Songwriting Tips | Lyrics | Arranging | Live Feedback,1,0,0,0,2,3
The Contractor Fight with Tom Reber,1,0,1,0,48,50
Transistor,0,0,0,1,6,7
Sick,3,6,6,6,109,130
GSD Mode,0,0,1,0,45,46
Trivial Warfare Trivia,15,7,4,2,22,50
Rose Chat Podcast,1,0,1,1,3,6
The Mortified Podcast,2,7,5,8,151,173
Political Rewind,3,1,1,1,12,18
layovers ✈︎ air travel and commercial aviation,0,0,1,0,36,37
Urbanomic,0,0,0,0,1,1
The Dan Bongino Show,34,0,4,2,140,180
Write Now with Sarah Werner,1,1,0,3,98,103
Arizona Spotlight,0,0,0,1,1,2
The Everyday Innovator Podcast for Product Managers,0,0,0,0,22,22
Highly Intuitive People - 7 Steps to Purpose,0,0,0,0,3,3
Locked On Heat - Daily Podcast On The Miami Heat,5,3,2,5,103,118
Dishin' Days,0,0,1,0,64,65
48 Hours,127,79,97,78,78,459
The Bitch Bible,4,1,1,1,43,50
Triple Play Performance Podcast,0,0,0,0,37,37
That's So Retrograde,2,3,5,2,38,50
NursEM - Nursing in Emergency,0,1,2,0,5,8
Man Meat BBQ,3,8,0,2,24,37
PsychCrunch,0,0,0,0,1,1
The Down & Dirty Radio Show,0,1,0,1,24,26
30something Movie Podcast,0,0,0,0,8,8
Gritty Podcast,25,10,6,5,454,500
Dude Soup,10,7,5,5,308,335
Getting In: A College Coach Conversation,0,0,0,4,46,50
Daily Tanya (Audio) - by Yehoshua B. Gordon,0,0,0,0,5,5
Daily Chumash with Rashi (Audio) - by Yehoshua B. Gordon,0,0,0,0,10,10
Daily Chumash with Rashi (Video) - by Yehoshua B. Gordon - by Yehoshua B. Gordon,0,0,0,0,1,1
Rambam - 3 Chapters a Day (Audio) - by Yehoshua B. Gordon,0,0,0,0,3,3
Rambam - 1 Chapter a Day (Audio) - by Yehoshua B. Gordon,0,0,1,0,0,1
ACG - The Best Gaming Podcast,1,0,0,1,48,50
Attack Style Wrestling Podcast,0,0,0,0,2,2
Zen Community of Oregon Dharma Talks,0,0,0,0,2,2
Ask Drone U,6,3,5,4,32,50
Transgender News Center,2,0,1,0,1,4
True Romance - Dating Advice For Women,13,1,0,1,7,22
Clutter Free Academy,3,0,0,1,27,31
"Delight Your Marriage | Sexual Intimacy, Relationship Advice, & Christianity",1,0,0,0,49,50
On The Mat,0,0,0,0,4,4
The Archive Project,0,0,0,0,1,1
The Landscape Architecture Podcast,1,1,1,0,25,28
Well-Fed Women,0,0,0,0,50,50
Lets Truck with Kevin Rutherford,2,2,1,2,3,10
"The Anxious Truth - REAL Help For Panic, Anxiety and Agoraphobia",0,0,0,1,49,50
The Blizzard,1,2,0,0,35,38
Adventures Through The Mind,0,0,1,0,26,27
How We Roll Podcast,0,0,0,1,49,50
IELTS Energy English Podcast,0,0,1,2,5,8
The Brass Junkies Podcast - Pedal Note Media,0,1,0,0,100,101
The Ex Boyfriend Recovery Podcast,2,2,2,2,42,50
From Founder To CEO,0,0,0,1,95,96
Happier with Gretchen Rubin,2,2,2,1,43,50
Trucking with Authority,0,1,1,0,4,6
Burnt Toast,6,2,4,4,34,50
Axe of the Blood God: An RPG Podcast,4,0,4,2,40,50
Winged Wheel Podcast - A Detroit Red Wings Podcast,4,1,4,2,144,155
Transformation Sequence,0,0,0,0,47,47
Empowered Relationship Podcast: Your Relationship Resource And Guide,1,0,0,0,42,43
The Property Couch,3,1,6,4,125,139
Courtside with Greenberg & Dakich,21,4,6,7,21,59
Jay Scott Outdoors Western Big Game Hunting and Fishing Podcast,1,4,9,7,292,313
80 of the 80s Music Podcast,0,1,0,1,6,8
"Healthy Living With Naturopath Angela Busby - Your Health, Nutrition and Wellness Resource",1,0,0,0,35,36
Bread4Soul Sessions,0,0,0,0,17,17
The Food For Fitness Podcast | Nutrition | Training | Lifestyle | Healthy Living,0,0,0,0,19,19
WSJ Opinion: Potomac Watch,104,34,22,26,104,290
The CX Cast®,0,0,0,0,3,3
10K Rinks Radio - A Minnesota Wild Podcast,1,1,0,2,31,35
We Got This with Mark and Hal,1,2,1,1,45,50
IT'S TIME w/Bruce Buffer,6,2,0,0,14,22
Recovery Elevator,4,3,0,1,42,50
Something Wild,0,1,1,1,5,8
Blind Abilities,0,0,0,2,4,6
Adventure Sports Podcast,5,3,4,3,79,94
Quran For Busy People: Weekly insights into the simple beauty and spiritual depth of Islam – from th...,2,0,0,0,19,21
The Gardening with Joey & Holly radio show Podcast/Garden talk radio show (heard across the country),2,0,0,0,4,6
Royals Review: for Kansas City Royals fans,3,0,0,0,5,8
"""Doctor Mom"" Podcast",0,0,0,0,50,50
Bats and Balls Podcast,0,0,0,0,14,14
"Coaching Soccer Weekly: Methods, Trends, Techniques and Tactics from WORLD CLASS COACHING",0,1,0,4,119,124
Joe DeFranco's Industrial Strength Show,0,0,0,0,50,50
Page 94: The Private Eye Podcast,1,2,1,6,65,75
The Dentist Freedom Blueprint,0,0,0,0,27,27
The Leaf Report: A show about the Toronto Maple Leafs,1,0,1,1,1,4
Morning Joe,92,56,63,73,216,500
Working Class Bowhunter,1,0,2,2,182,187
High Sierra 4×4 Podcast,1,0,1,0,48,50
Hello From The Magic Tavern,0,0,1,0,49,50
French Your Way Podcast: Learn French with Jessica | French Grammar | French Vocabulary | French Exp...,1,1,1,2,45,50
Food As Medicine with Dr. Anh,1,1,1,3,44,50
This is Product Management,0,1,0,2,16,19
5 Things,10,6,12,6,45,79
Trading Stocks Made Easy with Tyrone Jackson,2,0,3,1,44,50
Bourbon Pursuit,2,3,4,7,171,187
The Whisky Topic,0,0,0,0,40,40
Out There,2,0,0,2,89,93
Down And Nerdy Podcast,0,0,0,0,7,7
Payne's Politics,13,7,8,8,14,50
Dining at Disney Podcast,0,1,1,0,8,10
Book Club Girl Podcast,1,0,0,0,8,9
The Apple WatchCast Podcast - A podcast dedicated to the Apple Watch,1,0,2,3,128,134
The Self-ish Latina Podcast,0,0,0,0,14,14
Photo Field Notes Podcast: Career Advice for Photographers,0,0,0,1,25,26
"CleanTech Talk — EVs, Solar, Batteries, AI, Tesla",1,0,2,0,8,11
Above the Law - Thinking Like a Lawyer,14,4,4,9,66,97
Herbal Radio,1,1,0,0,5,7
Psychology of Video Games Podcast,0,0,0,1,13,14
Food Non-Fiction,1,2,5,7,71,86
Primal Edge Health,0,1,1,0,15,17
Women Taking the Lead with Jodi Flynn,0,0,0,6,194,200
Someone Else's Movie,0,0,0,0,6,6
Section 10 Podcast,20,3,5,10,242,280
Ten Junk Miles,0,2,1,9,488,500
The Politics Guys,15,6,4,4,21,50
The Talent Grow Show: Grow Your Leadership and Communication Skills,0,0,0,0,37,37
Real English Conversations Podcast - Listen to English Conversation Lessons,0,0,0,0,5,5
The Bronx Pinstripes Show - Yankees MLB Podcast,6,1,2,3,488,500
The Power and Speed Podcast,1,0,0,1,36,38
Donna & Steve,0,0,0,0,6,6
Another Round,6,1,2,5,486,500
40 Acres & a Fool,1,0,0,0,9,10
HuskerOnline Podcast,0,2,0,2,9,13
Lets Go Blues Radio - St. Louis Blues Hockey Podcast,0,1,2,2,11,16
Lore,57,54,30,51,825,1017
The Real Pod,0,0,1,1,74,76
MLM Nation,3,0,2,5,190,200
The Martyrmade Podcast,0,0,0,1,49,50
"Relationship Radio: Marriage, Sex, Limerence & Avoiding Divorce",1,0,0,0,56,57
Travelers In The Night,0,0,0,0,9,9
The ATP Project's Podcast,0,0,1,0,22,23
The LogBook - Aviation Storytelling Podcast,0,0,0,0,10,10
Talk Python To Me,0,0,0,2,67,69
Cyrus Says,2,1,2,3,39,47
The Stock Trading Reality Podcast,1,2,0,2,92,97
(Podcast) Child Psychology,0,3,1,0,0,4
Redefining HR,0,0,1,0,19,20
The Countdown: Movie and TV Reviews,2,0,2,2,115,121
Theoretical Physics - From Outer Space to Plasma,0,0,1,0,0,1
Order of Man: Protect | Provide | Preside,9,2,2,2,185,200
The Ghastly Tales Podcast,0,0,1,0,30,31
What is Wrong with UX,0,1,1,0,16,18
The Beauty Biz™ Show,0,0,0,1,49,50
Tom & Lorenzo's Pop Style Opinionfest,9,4,7,5,74,99
Photo Taco Podcast,0,0,2,0,81,83
Pageant Junkies | Hopelessly Addicted to the Miss America Program,0,0,0,0,6,6
Behind The Knife: The Surgery Podcast,0,0,2,0,48,50
Blank Check with Griffin & David,21,8,18,19,433,499
This Glorious Mess,8,9,8,4,116,145
The Rich Outdoors,22,1,1,5,470,499
The Python Podcast.__init__,3,1,2,3,15,24
The WW2 Podcast,1,0,1,5,43,50
MCU Fan Show - WandaVision and more Marvel Studios commentary,15,2,14,11,182,224
Golf Unfiltered Podcast,0,0,0,2,37,39
Sound Bites A Nutrition Podcast,0,0,1,0,49,50
Origin Stories,0,0,0,2,40,42
The Right Time with Bomani Jones,18,8,4,10,460,500
Everyday MBA,0,0,0,1,39,40
Krishna Temple Talks,0,0,0,0,10,10
The Poker Life and HSPLO Podcasts,1,0,1,1,23,26
Mom Is In Control Podcast,0,2,0,1,47,50
The 2 Robbies,17,9,19,38,294,377
I Will Teach You A Language,0,0,0,0,50,50
Sharp Tongue,0,1,1,1,47,50
The Hot Mess Comedy Hour,1,0,2,1,46,50
Awakening Now with Lama Surya Das,0,0,1,1,5,7
What's Cooking with Paula Deen,0,0,2,4,16,22
"Dr. Ruscio Radio: Health, Nutrition and Functional Medicine",1,3,3,1,42,50
The Show Before the Show,1,0,0,1,31,33
Supply Chain Radio,0,0,0,0,2,2
Back to the Future: The Podcast,0,0,1,1,18,20
Federalist Radio Hour,37,30,19,34,314,434
Conversations with Tyler,0,3,1,1,45,50
Living Homegrown Podcast with Theresa Loe,2,0,0,6,108,116
The SKOR North Twins Show,3,3,3,1,109,119
Homebrew Happy Hour,2,1,0,1,13,17
"The Writer Files: Writing, Productivity, Creativity, and Neuroscience",0,0,3,1,13,17
Townhall Review | Conservative Commentary On Today's News,3,1,2,4,13,23
The Dating Den,2,1,1,1,26,31
The Nomad Capitalist Audio Experience,1,1,0,1,23,26
Tumble Science Podcast for Kids,9,4,4,2,31,50
Cloudbase Mayhem Podcast,0,0,1,0,39,40
Undisclosed,8,5,5,5,27,50
The Slow Home Podcast,0,0,1,0,49,50
The Learning Leader Show With Ryan Hawk,0,0,1,0,49,50
WGN Radio Theatre,2,0,3,2,14,21
Becoming Ultra,1,0,0,0,38,39
First Things Podcast,3,2,6,5,21,37
TIME's Top Stories,2,1,0,1,4,8
Collider Witching Hour,10,2,5,6,47,70
Better System Trader,0,0,1,0,82,83
Anik and Florian,11,1,4,8,76,100
TIME's The Brief,1,1,0,1,4,7
US Modernist Radio - Architecture You Love,0,0,0,0,11,11
WTFFF?! 3D Printing Podcast: Digital Manufacturing From Design to Print,3,1,0,0,12,16
Italian for Beginners,4,1,0,0,7,12
The Mom Hour,1,0,0,1,48,50
The Dad Edge Podcast (formerly The Good Dad Project Podcast),0,2,0,0,48,50
The Lowe Post,48,19,21,25,387,500
History in the Bible,2,3,1,0,44,50
The Michael Caz Podcast,1,0,1,0,48,50
Dunc'd On Basketball NBA Podcast,54,12,17,18,399,500
"Agency Nation Radio - Insurance Marketing, Sales and Technology",0,0,2,0,12,14
Bear All Podcast,0,0,0,0,1,1
The Psychology of Eating Podcast,1,2,3,0,44,50
20/20,98,60,34,20,38,250
Cafe Mocha Radio,0,0,0,0,1,1
Hay House Radio Podcast,0,1,0,0,8,9
Dr. Wayne W. Dyer Podcast,3,1,0,2,39,45
Hay House Live!® Podcast,1,0,0,1,3,5
What Healthy Couples Know That You Don't,0,0,0,3,33,36
"Overland Roundtable - Overland Travel in a Jeep, Toyota, Nissan, Land Rover or on an adventure bike",0,0,0,2,8,10
Mendelspod Podcast,0,0,0,0,2,2
Align Podcast,1,2,1,0,46,50
Clifford Baptist,0,0,0,0,1,1
Adult ADHD ADD Tips and Support,1,0,5,2,28,36
Punk Rock Libertarians Podcast,2,2,2,0,3,9
This Week in Photo,2,0,1,1,11,15
The Fitness Business Podcast,0,0,0,0,29,29
The Qwipster Film Review Podcast,1,0,0,0,18,19
The Yale Law Journal Podcast,0,0,0,0,2,2
She Thinks,1,1,0,0,21,23
Lodging Leaders,1,0,1,0,31,33
The Knowledge Project with Shane Parrish,0,0,0,0,7,7
Truth & Justice with Bob Ruff,65,28,27,31,349,500
TOPcast: The Teaching Online Podcast,0,0,0,0,22,22
Women at Warp: A Roddenberry Star Trek Podcast,1,2,3,3,51,60
Writing Excuses,10,7,10,12,80,119
Myths and Legends,3,0,3,8,186,200
Euphomet,6,6,5,6,168,191
ASIAN AMERICA: THE KEN FONG PODCAST,0,1,0,1,80,82
The Eric Metaxas Show,15,7,5,5,120,152
Top Of The League Podcast,0,0,0,0,2,2
Us & Them,1,3,1,4,66,75
Story Time,0,0,2,7,41,50
The Hippo Education Podcast,0,0,0,0,22,22
Social Anxiety Solutions - your journey to social confidence!,4,1,1,0,44,50
Action: The Pursuit Of Acting Excellence,0,1,0,2,133,136
Main Podcast – SeekersGuidance,0,0,0,0,3,3
Lost in Translationmon - A Digimon Podcast,0,0,1,2,20,23
Guitar Nerds,1,0,0,1,20,22
Agile for Humans with Ryan Ripley,0,0,0,0,25,25
The School Leadership Show,0,0,0,0,8,8
The Empowered Parent Podcast,0,0,0,0,24,24
Turncloaks - D&D5E Dark Fantasy Actual Play,0,1,2,0,47,50
Berkeley Zen Center Dharma Talks,0,1,0,0,0,1
Science Underground,0,0,1,1,18,20
Eater's Digest,36,23,13,4,89,165
The Positive Head Podcast,8,4,4,3,481,500
Angela Yee's Lip Service,5,9,4,9,23,50
Dirshu Mishnah Brurah Yomi,0,1,0,0,0,1
Paralyzed,4,1,5,8,32,50
BYU Speeches,0,1,0,1,15,17
GovLove - A Podcast About Local Government,0,0,0,1,49,50
All the Books!,11,15,12,17,145,200
The Press Room from Deloitte Insights,0,0,0,0,1,1
The No Proscenium Podcast,0,0,0,0,7,7
The Fatal Charm of Italy: A Question and Answer Podcast with Rick Zullo,0,0,0,0,8,8
The Civil Engineering Podcast,0,0,0,0,7,7
Trends Like These,8,3,4,4,31,50
DC's Legends of Tomorrow Podcast,4,4,0,0,25,33
A Thing or Two with Claire and Erica,0,1,0,1,48,50
Flash Forward,4,8,13,15,406,446
The Internet of Things Podcast - Stacey On IoT,4,2,1,0,20,27
Fashion Friends,0,0,0,0,3,3
The Perception & Action Podcast,0,0,0,0,5,5
Japan Eats!,0,0,1,0,8,9
A Corporate Time with Tom and Dan,0,0,0,0,50,50
NRL Boom Rookies,0,0,0,0,3,3
The Other Half,0,0,0,0,2,2
Here To Make Friends - A Bachelor Recap Show,135,68,61,27,209,500
No Filter,11,1,6,3,109,130
Locked On Hornets - Daily Podcast On The Charlotte Hornets,3,1,0,2,53,59
Sup Doc: A Documentary Podcast,1,0,1,0,29,31
"Just Shoot It: A Podcast about Filmmaking, Screenwriting and Directing",0,0,0,1,114,115
BRAVE Church,0,0,0,0,3,3
The Jealous Curator : ART FOR YOUR EAR,1,0,0,0,79,80
Wheat Pete's Word,0,0,0,0,1,1
The Giant Beastcast,12,5,2,4,27,50
Ron Paul Liberty Report,3,2,0,0,45,50
Dead Earth: Tales of Survival in the Zombie Apocalypse,2,0,2,2,14,20
The Relationship School Podcast,2,5,3,4,248,262
The Long War - Warhammer 40k Podcast,5,3,0,5,30,43
The Black Tapes,2,5,4,6,33,50
Sports Illustrated Media Podcast,20,4,8,10,157,199
Locked On Saints - Daily Podcast On The New Orleans Saints,6,4,1,2,91,104
Friday Night Quests: A D&D Podcast,0,0,1,1,48,50
Robot or Not?,0,0,0,0,11,11
RV Maintenance Tips and Information for the DIY,0,0,1,0,4,5
Retrovaniacs,0,0,1,2,17,20
Marriage Is Funny,2,1,0,1,167,171
Casefile True Crime,70,48,78,54,750,1000
"Accelerated Spanish: Learn Spanish online the fastest and best way, by Master of Memory",5,3,4,2,36,50
The Building Science Podcast,0,0,1,1,42,44
Haunted Talks - The Official Podcast of The Haunted Walk,0,0,0,0,17,17
Listen To Your Body Podcast,0,1,0,1,48,50
Pass the Real Estate Exam with PrepAgent,0,0,0,2,21,23
Weekly Games Chat,7,0,2,2,67,78
The Jurassic Park Podcast,0,0,0,0,74,74
Total Reboot with Cameron James & Alexei Toliopoulos,0,0,0,0,17,17
The Skift Podcast,0,0,0,0,5,5
Twitter Smarter Podcast with Madalyn Sklar - The Best Twitter Tips from the Pros,0,0,0,2,48,50
L/L Research's Law of One Podcast,0,0,0,0,4,4
PT Pintcast - Physical Therapy,1,0,0,0,49,50
The Bitcoin Podcast Network,4,0,1,1,21,27
Giant Thinkers Podcast,0,0,0,0,38,38
SoulFood FM,0,0,0,0,30,30
Cortex,5,5,5,8,78,101
No Jumper,19,3,3,10,172,207
Sharpened Artist | Colored Pencil podcast,2,0,0,0,74,76
Exponential Wisdom,2,0,2,0,18,22
Hedrich Files,1,0,1,2,58,62
Think Again – a Big Think Podcast,6,4,5,9,117,141
Examining Ethics,0,0,0,1,18,19
Rusty Quill Gaming Podcast,0,0,0,1,49,50
Booking The Territory Pro Wrestling Podcast,3,0,0,1,173,177
Ballpark Dimensions,4,2,7,4,32,49
TALKING TESLA,6,2,5,7,170,190
Dear Hank & John,4,1,5,12,478,500
"SuperCreativity Podcast with James Taylor | Creativity, Innovation and Inspiring Ideas",0,0,0,0,39,39
Running Inside Out Podcast,0,0,0,1,8,9
The Detroit Lions Podcast,3,4,6,4,103,120
Bollywood Weekly,0,0,1,2,1,4
Trumpet Daily,2,0,0,0,14,16
Unlocking The Magic: Talking all things Disney World and Disneyland,5,5,5,9,476,500
The Action Network Sports Betting Podcast,11,3,5,10,334,363
The DC3cast!,0,0,0,1,8,9
Alpha and Omega Ministries,11,2,0,2,69,84
Leading With Purpose,1,0,0,1,43,45
Wrestling Inc. Podcast,27,7,4,4,41,83
Drop Zone - GOLF Podcast,3,3,1,1,18,26
Universal Orlando Podcast by Orlando Informer,2,2,3,4,44,55
Keep Your Daydream,0,0,0,3,292,295
Beyond The Baseline: SI's Tennis Podcast with Jon Wertheim,2,2,4,5,26,39
Twin Peaks Unwrapped,1,2,4,1,48,56
Motorcycle Men,3,0,2,1,10,16
eCommerce MasterPlan,0,0,0,0,34,34
Core EM - Emergency Medicine Podcast,0,0,1,1,14,16
Cult Of Us,2,0,0,0,48,50
Sneak Attack!,1,0,1,1,47,50
Logical Progression (LP) - logicalprogression,0,0,0,0,2,2
ars PARADOXICA,4,2,5,5,34,50
Talking Biotech Podcast,0,0,2,3,79,84
Off Panel: A Comics Interview Podcast,1,1,0,1,52,55
Always A Lesson's Empowering Educators Podcast,1,0,0,0,49,50
Passive Real Estate Investing,3,1,3,8,185,200
Lighthouse Hockey: for New York Islanders fans,2,5,2,1,13,23
The Homemaking Foundations Podcast,0,3,2,2,43,50
Missing,205,80,49,24,142,500
The Glass Cannon Podcast,0,0,1,0,49,50
"Salesman.org - Salesman Podcast, This Week In Sales, Sales School And More...",0,0,0,6,62,68
InvestED: The Rule #1 Investing Podcast,19,12,24,10,135,200
The Pitch,4,7,8,13,118,150
Rabbi Daniel Kalish Shas Illuminated,0,0,0,0,2,2
Maed in India,0,0,0,0,11,11
SlipAngle powered by TrackTuned,0,0,1,1,47,49
Wellness Force,2,0,0,0,48,50
SiftPop,0,1,1,0,22,24
NFL Talking Heads Fantasy Football Podcast,4,1,1,6,46,58
Real Estate Uncensored - Real Estate Sales & Marketing Training Podcast,5,0,0,0,45,50
Bloke In A Bar,0,0,0,0,2,2
Matty & The Caddie,3,3,0,1,33,40
Private Pilot Podcast by MzeroA.com,0,0,0,0,14,14
Instrument Pilot Podcast by MzeroA.com,0,0,1,0,6,7
CFI Podcast by MzeroA.com,0,0,0,0,5,5
Inspire Aviation Podcast by MzeroA.com,0,0,0,0,1,1
CBS Sunday Morning with Jane Pauley,5,4,4,5,13,31
Speak Up For The Ocean Blue,1,0,1,1,82,85
Best Drum and Bass Podcast,0,0,0,0,50,50
Decoder with Nilay Patel,75,34,23,11,57,200
Physical Preparation Podcast – Robertson Training Systems,0,0,0,1,41,42
The Renaissance: A History of Renaissance Art.,3,0,3,2,25,33
Spiritual Psychic with Sara Wiseman Show,0,0,0,0,3,3
Overly Animated Podcast,4,3,2,2,26,37
REAL AF with Andy Frisella,0,2,2,2,292,298
LearnDoBecome Radio,1,2,0,0,25,28
Hunt Talk Radio,8,3,2,4,212,229
Ear Snacks,10,1,4,2,33,50
Padre Peregrino,1,0,0,0,68,69
Boss Girl Creative | Unconventional Business Wisdom,0,0,1,0,49,50
The Food Blogger Pro Podcast,0,0,1,2,144,147
Conan Neutron's Protonic Reversal,0,2,2,0,12,16
Hearts of the Dulcimer,0,0,0,0,26,26
Victor Davis Hanson's The Classicist,3,0,0,2,45,50
From The Runway Up: An Airport and Aviation Podcast,0,0,0,0,10,10
Tabletop Champions - Real Play D&D 5E (DND 5e),1,0,0,2,47,50
Advanced TV Herstory,1,0,0,0,8,9
ManTalks Podcast,1,2,0,1,73,77
Hot Copy,0,0,1,1,28,30
The Good Phight: for Philadelphia Phillies fans,14,13,15,8,157,207
The Infinite Now,1,0,0,1,19,21
Urban Wildlife Podcast,0,0,0,4,4,8
Book Club for Kids,2,1,6,3,38,50
Daily Zen,1,0,1,0,7,9
Ghostbusters Interdimensional Crossrip,0,0,0,0,36,36
Activity Quest,3,0,0,0,6,9
King Falls AM,2,1,1,3,43,50
Weird Tales and the Unexplainable,7,2,1,3,54,67
Autism Science Foundation Weekly Science Report,1,1,0,0,3,5
Omar Suleiman,0,0,0,0,8,8
Insight Hour with Joseph Goldstein,1,0,0,0,24,25
Nutrition Matters Podcast,4,1,2,0,43,50
Fallout Off the Record - A Fallout Podcast,7,4,3,5,218,237
Rule Breaker Investing,4,0,2,0,97,103
Loving Without Boundaries,1,0,0,0,18,19
Cop Doctors,0,0,0,0,7,7
Cookery by the Book,0,1,0,2,5,8
Fantasy Bites,3,0,1,0,30,34
Commander's Brew,2,0,0,1,47,50
The Construction Leading Edge Podcast,0,1,0,0,40,41
Hello PhD,1,0,1,2,25,29
Loan Officer Leadership,0,0,0,0,15,15
The Jenkins & Jonez Podcast,4,0,2,2,130,138
OK Talk - Paranormal Tales of Mysterious Travels,1,1,2,3,87,94
Theology in the Raw,5,1,0,1,67,74
The Modern West,1,0,0,1,22,24
Software Engineering Daily,0,0,0,0,2,2
Rabbi Daniel Lapin,2,0,0,0,55,57
The Perez Hilton Podcast with Chris Booker,45,7,11,25,412,500
In Plain Cite,0,0,0,0,6,6
Bilal Philips,1,0,0,0,0,1
Zakir Naik,0,0,0,0,1,1
No Guitar Is Safe,0,0,0,0,50,50
The Real Story,1,1,1,1,14,18
Unorthodox,5,3,0,11,238,257
Fit + Vibrant You,1,0,0,0,37,38
The Hunt Backcountry Podcast,2,0,0,8,490,500
HOME Podcast,4,8,4,6,247,269
Retro Warriors,1,0,0,1,48,50
The SweetGeorgia Show,0,0,0,0,14,14
Double Tap – A Podcast for the Fighting Game Community,0,0,0,0,16,16
Quanta Science Podcast,1,0,3,1,17,22
Mind of The Warrior,2,0,0,2,46,50
Our Fake History,4,0,1,4,41,50
"Ann Kroeker, Writing Coach",0,0,0,0,17,17
"The Strategy Skills Podcast: Management Consulting | Strategy, Operations & Implementation | Critica...",0,0,0,0,7,7
Better Than Happy,2,1,1,0,46,50
The Weekly Briefing,0,0,0,0,8,8
The Jacki Daily Show,0,2,0,0,4,6
Perpetual Traffic,2,2,2,1,43,50
The Membership Guys Podcast with Mike Morrison,0,0,0,0,44,44
Reasonable Doubt,11,8,2,7,22,50
The Elective Rotation: A Critical Care Hospital Pharmacy Podcast,0,0,2,0,45,47
The Pelvic Health Podcast,0,0,0,0,5,5
GeekVerse Podcast,21,7,2,2,37,69
Marina Ventura: Kids Guide to Our Planet,0,0,0,0,2,2
Super J-Cast,6,1,2,3,56,68
Buddhist Society of Western Australia,0,0,1,1,17,19
Saints Happy Hour,3,2,3,2,67,77
Lore Watch,1,7,6,5,27,46
Harris Fantasy Football Podcast,23,5,12,3,457,500
Black Men Can't Jump [In Hollywood],4,3,1,18,445,471
Wanderlust Swingers - Swinging Lifestyle,0,0,0,1,49,50
SBJ Morning Buzzcast,2,0,1,1,2,6
Pats Pulpit: for New England Patriots fans,5,1,2,3,20,31
Watching the Throne: A Lyrical Analysis of Kanye West,2,1,1,2,44,50
"SaaS Interviews with CEOs, Startups, Founders",5,2,1,2,90,100
Indie Film Hustle® - A Filmmaking Podcast with Alex Ferrari,1,1,0,6,78,86
FML FPL - Fantasy Premier League Podcast,1,0,1,1,28,31
Love Over Addiction,0,0,1,1,48,50
The Arts of Language Podcast,0,0,0,0,14,14
HumaNature,0,0,0,0,56,56
Sell or Die with Jeffrey Gitomer and Jennifer Gluckow,2,0,0,4,126,132
Limetown,6,3,8,9,24,50
Hardwood Knocks: An NBA Podcast,9,1,0,5,106,121
High and Mighty,3,1,0,1,45,50
Skidmarks Show,0,0,0,0,44,44
Entrepreneur Network Podcast,1,1,0,1,6,9
Style Matters,2,2,1,1,31,37
The Thriving Artist,0,0,1,0,11,12
Finding Mastery,5,2,2,2,39,50
Ride the Lightning: Tesla Motors Unofficial Podcast,2,2,1,2,43,50
Spacepod,0,0,1,2,159,162
English Premier League podcast: EPLpod,6,5,4,8,175,198
Coin Concede: A Hearthstone Podcast,0,1,1,0,48,50
What It Takes,1,1,1,0,73,76
Audiotrainer | Deutsch lernen | Deutsche Welle,0,0,0,0,2,2
Briefly with OZY,4,1,1,1,9,16
Cruise Radio News Briefs,0,0,0,0,21,21
Natural Meditation podcast,0,0,0,0,3,3
Out on the Wire,0,0,0,1,23,24
Edit Your Life,2,0,3,5,40,50
JAMA Clinical Reviews,6,1,2,2,39,50
Hoge and Jahns: a show about the Chicago Bears,10,4,4,9,302,329
"The Law School Toolbox Podcast: Tools for Law Students from 1L to the Bar Exam, and Beyond",3,5,2,3,37,50
Local Mouthful: A podcast about food and home cooking,0,0,0,2,3,5
FlightCast,0,0,1,0,12,13
Get Booked,5,1,8,13,86,113
The Elite Advisor Blueprint®: A Podcast for Financial Advisors,0,0,0,2,48,50
The Yarn,0,0,1,2,29,32
Hidden Brain,204,114,102,120,2160,2700
The Modern Customer Podcast,0,0,0,1,33,34
Detective,9,10,22,16,196,253
Weapon Wheel Podcast,5,0,0,3,28,36
Airline Weekly Lounge,7,5,0,1,12,25
8 Minute Millionaire: Learn the Secrets of Millionaire Entrepreneurs,3,2,2,1,42,50
House Call With Dr. Hyman,2,1,0,1,16,20
J. Brown Yoga Talks,6,1,3,3,37,50
Live Awake,0,0,0,0,50,50
Respectful Parenting: Janet Lansbury Unruffled,0,0,0,0,5,5
Ghost Stories the Podcast,0,1,1,4,31,37
Your Morning Basket,0,0,0,3,47,50
Living The Gimmick: A Pro Wrestling Podcast,1,1,0,1,27,30
"4x4 Earth - The 4WD, Camping, Fishing and Outdoors podcast.",0,0,0,0,6,6
SLEEP MEDITATION with Lauren Ostrowski Fenton,1,1,0,1,27,30
Our Lifestyle Podcast (OLP),0,0,0,0,50,50
The Sensibly Speaking Podcast,0,1,1,0,17,19
The Sugar Daddy Formula Podcast,3,0,2,0,15,20
Therapy Chat,0,2,1,1,46,50
Food Heals,0,0,1,0,49,50
10 Minute Bhagavad Gita Sessions from Ask Sri Vishwanath Show. How Bhagavad Gita Can Help You Solve ...,0,0,0,0,2,2
DC on SCREEN: Zack Snyder's Justice League,0,0,0,0,10,10
The Ten Minute Bible Hour Podcast,0,1,0,1,323,325
Yahoo Fantasy Football Forecast,21,17,13,14,143,208
The Indian Startup Show,0,1,0,3,5,9
The ASMR Podcast,5,1,2,3,10,21
The Straight Shooters,0,0,0,1,6,7
Speech Therapy: Storm of the Brains,0,0,0,2,27,29
Top of Mind with Julie Rose,0,0,0,1,5,6
The Friend Zone,2,6,9,8,25,50
College Football Live,18,8,7,3,8,44
The Boss Mom Podcast - Business Strategy - Work / Life Balance - -Digital Marketing - Content Strate...,8,2,0,0,40,50
Help Me Teach The Bible,0,0,0,2,38,40
Always Cheating: A Fantasy Premier League Podcast (FPL),3,0,1,2,48,54
Galleycast,0,0,0,0,2,2
The Joan Hamburg Show,1,0,2,0,4,7
The Baggage Reclaim Sessions,0,0,0,0,101,101
Mindfulness Meditation Podcast,0,0,1,0,7,8
Life After God,0,0,1,0,30,31
The Tone Mob Podcast,0,1,2,2,64,69
The Astral Hustle with Cory Allen,0,0,1,2,197,200
The Mindset Mentor,42,21,35,42,1435,1575
End-of-Life University,0,0,0,0,16,16
The Earth Collective,0,0,0,2,31,33
OPTIMIZE with Brian Johnson | More Wisdom in Less Time,0,0,1,2,47,50
Grants Rants Hollywood Talk,8,3,3,5,83,102
Live Happy Now,4,1,1,1,43,50
Night Owl Radio,0,1,2,2,45,50
Clear To Send: Wireless Network Engineering,0,0,0,1,21,22
Locked On Lakers - Daily Podcast On The Los Angeles Lakers,39,7,7,5,442,500
The Modern Drummer Podcast,17,3,2,2,244,268
The Western Bowhunter Podcast,0,0,0,7,165,172
Loving BDSM,2,1,2,2,43,50
The Haunted Estate,3,5,4,8,67,87
Around The World With The Archibald Project,0,1,0,3,46,50
The Fantasy Authority Fantasy Football Podcast,2,2,3,6,45,58
The Lead with Jake Tapper,29,6,9,4,36,84
The Tao of Self Confidence,0,0,0,2,198,200
What's This Tao All About?,2,1,0,5,51,59
Daily Motivation Podcast,0,0,0,2,1,3
The Cooligans: A Comedic Soccer Podcast,1,4,1,2,378,386
Pediatric Emergency Playbook,0,0,0,1,29,30
Bad Boy Running,0,0,0,1,13,14
Leadership and Business,0,0,0,0,16,16
#WizardTeam: A Harry Potter Podcast,0,1,3,2,64,70
The Better Leaders Better Schools Podcast with Daniel Bauer,0,0,0,1,49,50
Song by Song,1,0,0,0,5,6
Scene on Radio,2,0,4,4,490,500
SweetWhispers Podcast,15,4,5,2,24,50
6 Minute Vocabulary,0,0,0,2,4,6
Claude VonStroke presents The Birdhouse,0,0,0,1,20,21
The Movie Graveyard,0,0,0,1,17,18
Artist Decoded,1,1,2,1,71,76
Animals Today Radio,0,1,0,0,0,1
The Fit2Fat2Fit Experience,0,1,1,1,47,50
Editors in Conversation,0,0,0,0,1,1
Leading Learning  - The Learning Business Podcast,0,0,0,0,13,13
Relationship Alive!,1,1,0,2,83,87
Into The Wilderness with Byron Pace,0,0,0,0,22,22
Technology Flows : Salesforce Architecture Podcast,0,0,0,0,1,1
Agile Answers,0,0,0,0,15,15
The Hookblast Podcast with Mike McCready,0,0,0,1,3,4
The Spanish Dude Podcast (Audio),1,0,0,1,30,32
Matters of State - Underreported Issues in World News & International Relations,0,0,0,1,17,18
Headcanon,0,0,0,0,56,56
The Terri Cole Show,0,0,1,0,49,50
Steal the Show with Michael Port,0,0,1,4,162,167
Business of Dentistry,0,0,0,0,14,14
Grow My Accounting Practice | Tips for Accountants & Bookkeepers to Grow Their Business,3,0,0,1,27,31
Good Morning Vogue,11,7,5,0,13,36
Awards Chatter,5,2,4,5,143,159
Locked On Magic - Daily Podcast On The Orlando Magic,4,2,2,0,29,37
The Early Childhood Research Podcast,0,0,0,0,15,15
TurfNet RADIO,0,0,0,0,2,2
Kotaku Splitscreen,8,5,7,4,26,50
The Potter's House At One LA,0,1,0,0,12,13
Little Stories for Tiny People: Anytime and bedtime stories for kids,0,0,0,0,2,2
A Small Voice: Conversations With Photographers,1,0,0,1,31,33
Inspire Nation Show with Michael Sandler,3,4,7,10,204,228
Bodega Boys,1,1,1,3,44,50
Recording Studio Rockstars,2,1,1,3,210,217
The Tastes of India Podcast in Hindi : Healthy Living Tips and Cookery Show,0,0,0,1,8,9
Wooden Overcoats,0,0,1,0,49,50
A Sustainable Mind - environment & sustainability podcast,0,0,0,2,74,76
Brown Ambition,3,1,1,2,193,200
The History of the Twentieth Century,0,0,0,1,49,50
Teacher Tactics: High school teaching strategies,0,0,0,0,12,12
Jesse Lee Peterson Radio Show,39,1,2,1,57,100
PetaPixel Photography Podcast,0,0,3,9,38,50
The Chicago Audible - Chicago Bears Podcast and Postgame Show,5,2,0,12,335,354
History of Indian and Africana Philosophy,0,1,0,2,14,17
End of All Hope,5,13,13,7,12,50
The Cashflow Academy Show,2,0,0,0,20,22
Chicago's Morning Answer with Dan Proft & Amy Jacobson,1,0,0,0,11,12
Business Game Changers with Sarah Westall,2,0,0,1,10,13
The Six Figure Photography Podcast With Ben Hartley,1,0,0,0,49,50
Pride of Detroit: for Detroit Lions fans,18,9,11,20,152,210
THE ADAM BUXTON PODCAST,10,4,4,16,714,748
Resourceful Designer,0,0,0,1,57,58
Not So Standard Deviations,4,11,9,2,27,53
Becoming Your Best | The Principles of Highly Successful Leaders,0,0,0,3,96,99
Design Notes,0,0,0,0,3,3
Flying and Life Podcast,0,0,0,0,5,5
Seamwork Radio: Sewing Stories,0,0,0,1,49,50
Girlboss Radio,25,22,17,25,111,200
Oddball Pilot Radio: Fuel for an unconventional flying career,0,0,0,0,3,3
TigerBelly,6,1,4,4,35,50
Liverpool FC - KopTalk,0,0,0,0,1,1
At Home With Sally,1,0,0,1,48,50
The History of India Podcast,0,1,1,3,15,20
The Birth Hour - A Birth Story Podcast,4,2,3,6,35,50
Food Heaven Podcast,0,0,1,0,49,50
CORE - Core Gaming for Core Gamers,4,0,2,0,44,50
DJ Shinski Mixes,0,0,0,0,15,15
God Awful Movies,8,4,1,3,356,372
Brunch,7,0,1,4,251,263
Undressed,0,0,0,1,35,36
iNTO THE FRAY RADIO - An Encounter with the Abyss that is the Paranormal,16,10,8,6,208,248
NFL Live,20,6,8,8,18,60
My Wife is Going to Kill Me,2,1,0,2,43,48
Best of Roula & Ryan,0,1,0,0,5,6
The Car Pro Show,1,0,1,0,1,3
KILL TONY,17,1,1,2,29,50
The Herd with Colin Cowherd,206,80,86,100,278,750
PS I Love You XOXO - A Kinda Funny PlayStation Podcast,27,4,1,1,17,50
ICNYU Podcasts,0,0,0,0,2,2
The Weeds,12,5,12,6,15,50
Little Gold Men,12,9,9,13,174,217
Street Soldiers Radio,1,0,0,0,2,3
Affirmation Pod,3,0,2,0,45,50
The Effortless Swimming Podcast,0,0,0,1,4,5
Dan Snow's History Hit,10,8,16,16,284,334
The Chris Moyles Show on Radio X Podcast,12,1,1,5,113,132
Science Of Ultra,0,0,1,1,39,41
Dirty South Soccer: for Atlanta United FC fans,2,3,4,4,23,36
VOUS Church,0,1,0,0,86,87
Spooked!,5,0,0,1,5,11
Wharton FinTech Podcast,0,1,1,0,17,19
Agile in 3 Minutes,0,0,0,0,8,8
The Dig,0,0,4,3,146,153
The Cricket Sadist Hour,0,0,0,0,10,10
The Axe Files with David Axelrod,3,3,3,4,37,50
The Bill Simmons Podcast,192,43,38,28,197,498
Office 365 Exposed,0,0,0,1,0,1
A Delectable Education Charlotte Mason Podcast,0,0,1,1,48,50
Pregnancy Podcast,8,5,8,1,28,50
"Eat Clean, Run Dirty Podcast",0,1,1,2,22,26
SCARED? - A Paranormal Podcast,47,15,9,17,191,279
Basketball Coach Unplugged ( A Basketball Coaching Podcast),0,0,2,3,138,143
The General Hospital After Show Podcast,3,1,0,5,24,33
My Dad Wrote A Porno,18,8,14,8,452,500
The Rugby Pod,0,1,0,1,19,21
A Taylored Adventure To Happiness,4,1,0,0,45,50
BrotoGP - Motorcycle Road Racing,1,1,2,1,45,50
"The Grappling Central Podcast: The biggest names in Brazilian Jiu-Jitsu (BJJ), MMA and Grappling",2,0,1,2,60,65
IGN Unfiltered,1,1,0,1,50,53
Sex Talk With My Mom,2,1,0,2,45,50
The Andrew Klavan Show,6,1,1,0,42,50
Learn 15 Minute Spanish for your Job Podcast,1,1,0,0,9,11
Contra Krugman,8,3,0,2,112,125
The Hockey PDOcast,7,2,7,5,239,260
SunCast,0,0,0,0,40,40
My Seven Chakras With AJ,0,0,1,1,48,50
LifeAfter/The Message,2,1,3,2,42,50
Sales Enablement Podcast with Andy Paul,0,0,0,0,167,167
The Ash Cash Show,0,0,1,0,10,11
Singletracks Mountain Bike Podcast,1,2,0,6,106,115
Mom Struggling Well,0,1,2,0,47,50
Your Virtual Upline Podcast,0,0,1,1,198,200
The Show About Science,7,0,4,4,83,98
The Coffee Podcast,0,2,0,0,19,21
Bandrew Says Podcast,0,0,0,0,19,19
Wrestling Sheet Radio,29,5,6,6,59,105
CHITHEADS from Embodied Philosophy,0,0,1,0,30,31
Fundraising Voices from RNL,0,0,0,0,2,2
ABA Law Student Podcast,0,0,0,0,7,7
Causality,0,0,0,0,13,13
The Liberty Podcast,1,1,4,7,37,50
Beautiful Writers Podcast,0,0,1,2,128,131
"Find Your Dream Job: Insider Tips for Finding Work, Advancing your Career, and Loving Your Job",3,3,4,4,186,200
Unresolved,50,24,37,36,353,500
The Ben Shapiro Show,735,65,40,110,1675,2625
Met Opera Guild Podcast,0,1,2,2,28,33
The Official Red Chip Poker Podcast,12,1,1,0,36,50
Legends: National Wrestling Hall of Fame,0,0,0,0,1,1
Slums of Film History,0,0,0,0,41,41
The Unraveling Podcast,1,0,0,1,47,49
Tour Junkies: PGA Tour Betting & DFS,10,2,2,6,480,500
Better Podcasting,2,0,0,2,18,22
Two Friends Mixes,0,0,1,0,20,21
The History of Literature,5,9,2,8,116,140
Let's Fight a Boss,1,0,1,1,33,36
The Wild Die: A Savage Worlds RPG Podcast,0,0,0,1,9,10
Israel Story,3,0,0,1,247,251
DC on RMD,2,0,0,0,3,5
The Vinyl Guide,2,0,2,2,44,50
SinBin.vegas Podcast,2,0,5,2,45,54
ALIEN THEORISTS THEORIZING,27,6,9,5,453,500
Locked On Celtics - Daily Podcast On The Boston Celtics With Rainin' J's,18,5,4,7,370,404
Get Sex-Smart,0,0,0,0,8,8
TANIS,1,5,4,0,40,50
The Crazy Ex-Girlfriend Podcast,0,0,0,0,1,1
Story Grid Podcast,2,2,6,8,182,200
This Day in Maine,0,0,0,1,2,3
Women Of The Hour,123,6,3,26,342,500
writing class radio,4,0,0,1,76,81
Story Time with Yarn Story Factory | Free Stories for Kids!,5,1,1,0,11,18
The Modern Mann,0,1,0,0,45,46
Over It And On With It,2,0,3,0,45,50
The New Yorker Radio Hour,39,26,13,18,124,220
"Thrive By Design: Business and Marketing Strategy for Fashion, Jewelry and Creative Brands",1,0,0,0,49,50
Acquired,2,0,0,3,156,161
"""They're not dolls!""",3,0,0,0,11,14
Tripod: The Nature Photography Show,0,0,0,0,36,36
BibleProject,0,0,0,0,32,32
Open Floor: SI's NBA Show,74,17,16,7,385,499
College Hoops Today with Jon Rothstein,3,2,4,3,27,39
#GERIonICE - Physical Therapy | Fitness | Geriatrics,0,0,0,0,22,22
The Land of Israel Network,2,0,1,0,26,29
Wholesaling Inc,0,1,0,0,199,200
Jim and Tomic's Musical Theatre Happy Hour,0,0,0,0,9,9
Valley Beit Midrash,0,0,0,0,2,2
Laravel News Podcast,0,0,0,1,11,12
Jaret Goes to the Movies (Movie Reviews),0,0,0,0,40,40
Science Vs,2,1,2,1,2,8
Blood & Mud Rugby Podcast,0,0,0,0,6,6
Throttled Motorcycle Podcast,0,1,1,3,14,19
The Unstoppable Entrepreneur Show,0,0,0,0,50,50
The History of Standup,0,0,0,1,49,50
Retirement Starts Today Radio,0,0,0,4,64,68
Zacks Market Edge,2,1,0,0,9,12
The Intelligent Vocalist with John Henny,0,0,0,0,18,18
The Miami Heat Beat Podcast,8,1,3,1,53,66
Synchronicity with Noah Lampert,2,3,3,4,180,192
The Rubin Report,89,28,19,23,341,500
Background Mode,0,0,0,0,1,1
Pantheon - The Music Podcast Network,6,2,5,3,64,80
Federal Newscast,0,0,1,0,3,4
5-Minute Daf Yomi with Rabbi Shmuel Herzfeld,0,0,0,0,12,12
Loop Matinal,2,0,1,0,28,31
The Cynic | A Celtic FC Podcast,0,0,0,0,5,5
The Bright Sessions,3,3,1,4,39,50
Sri Ramana Maharshi Teachings,0,0,0,0,1,1
Creative Writing Career,0,1,4,1,22,28
Google Cloud Platform Podcast,0,0,1,0,3,4
Economic Update with Richard D. Wolff,3,0,1,2,78,84
Game Theory Podcast,5,2,3,8,150,168
🎧 Uplifting Trance Sessions with DJ Phalanx,1,0,0,0,4,5
We're So Bad At Adventuring,1,0,0,1,22,24
Ending Human Trafficking Locally and Globally,0,0,0,0,1,1
Special Sauce with Ed Levine,2,6,7,5,18,38
The Field Guides,2,0,0,0,112,114
News AF - The Internet's Best News Stories that are Actual Factual News,1,1,0,1,312,315
Forge the Narrative - Warhammer 40k Podcast,0,2,2,1,45,50
The All Things Risk Podcast,1,0,1,0,3,5
Pivot with Jenny Blake,0,1,0,0,49,50
FujiLove - All Things Fujifilm. A Podcast for Fuji X and GFX Users.,6,1,0,0,10,17
Wise About Texas,2,0,1,1,88,92
Go-To Gal with Jaclyn Mellone: Online Marketing + Mindset for Female Entrepreneurs,3,0,1,1,45,50
Growth Marketing Toolbox,0,0,0,1,28,29
Most Notorious! A True Crime History Podcast,8,3,9,13,378,411
UNKNOWN — a UFO podcast,4,0,2,2,11,19
User Defenders – UX Design & Personal Growth,0,0,0,2,79,81
"Surreal Talk - Cults, Conspiracies & the Paranormal",18,12,8,2,10,50
Pantsuit Politics,40,9,7,5,439,500
Roundball Stew,2,2,5,4,23,36
Super Tuesday Recap - Comic Book & TV Show Reviews,0,0,1,1,41,43
Siraj Wahhaj,0,0,1,0,0,1
Art of Procurement,0,0,0,0,11,11
The Akashic Reading Podcast,0,0,1,1,49,51
Odd Lots,6,4,2,10,56,78
Experimental Brewing,3,1,2,2,35,43
The Weather Junkies,0,0,0,1,7,8
GreenBiz 350,0,1,0,1,10,12
Diesel Performance Podcast,2,0,2,4,42,50
Black Girl Nerds,0,1,1,1,61,64
First Draft: A Dialogue on Writing,0,0,0,1,8,9
ArtTactic,0,0,0,1,25,26
Lead Singer Syndrome with Shane Told,3,1,0,6,347,357
Striking Gold: A 49ers Pod,8,3,1,3,36,51
Teaching Jasmin How to Cook Vegan,0,0,1,0,7,8
Inner Hoe Uprising,0,1,0,0,49,50
The NPR Politics Podcast,208,60,68,52,354,742
Real Estate Marketing Dude,0,1,0,0,19,20
Local Knowledge,4,8,5,5,25,47
Live Well Anyway,1,2,0,8,189,200
The Next Picture Show,4,5,3,7,96,115
Choose Your Own Religion,0,0,0,0,11,11
IFR Flight Radio Show – IFR Flight Radio,0,0,0,0,1,1
Selected Talks on Buddhism and Meditation by the Karmapa,0,0,0,0,4,4
The Jason & Scot Show - E-Commerce And Retail News,0,0,0,0,46,46
Chip & Charge,0,0,0,0,2,2
Knightly Pleasures - Erotica for Women,5,2,3,3,59,72
The Press Box,85,35,40,25,314,499
Art Works Podcast,0,0,0,0,4,4
Anna Faris Is Unqualified,6,3,7,6,28,50
Healthy Critters Radio,0,0,0,0,3,3
Girl Camper,5,3,4,2,90,104
The Science of Success,0,1,1,0,48,50
School of House Flipping | Real Estate Investing,1,0,0,0,49,50
The Keto Diet Podcast,2,1,1,0,46,50
Let's Talk Stocks with Sasha Evdakov - Improve Your Trading & Investing in the Stock Market,2,0,1,0,7,10
Reckonings,3,0,1,1,57,62
Computer Science,0,0,1,0,0,1
"Coach Your Brains Out, by Gold Medal Squared",0,0,0,0,4,4
The Mindful Kind,1,0,0,0,49,50
The Countryside Hour,0,0,0,0,1,1
From Ring to Veil a Wedding Planning podcast,0,1,0,1,30,32
Saturday Morning Cartoon Boom,2,2,1,1,44,50
Outside/In,0,5,2,5,259,271
The Italian American Podcast,1,2,2,1,76,82
Drinkin' Bros Podcast,7,1,0,0,42,50
Ways & Means,0,0,0,0,15,15
CoinWeek,1,0,0,1,6,8
Breakup Recovery Podcast,1,0,1,2,13,17
The Property Management Show,0,0,1,0,8,9
Ordinary Vegan Podcast,0,0,2,0,48,50
TrailManners,0,0,0,1,60,61
Sportsmen's Nation - Whitetail Hunting,3,1,5,2,147,158
Hablando a 24 Frames / Hablando PoP,0,0,0,0,15,15
The Harvard EdCast,1,2,0,2,3,8
The Garden Path Podcast,0,0,0,0,5,5
True Crime Garage,19,17,16,20,427,499
Zen for Everyday Life with Matt Valentine: Mindfulness | Guided Meditation - Buddhaimonia,0,1,0,1,12,14
The Sky Sports Football Podcast,10,4,4,2,9,29
"Schoeny Presents AGR  Workout Music | Non-stop 1 hour mixes : Gym Music, High energy mix",0,0,0,0,30,30
A Tale of Two Hygienists Podcast,1,0,2,0,56,59
The WAN Show Podcast,2,0,5,3,39,49
The Wisdom of Compassion: Exploring The Values of Buddhism Through Timeless Meditation Techniques,1,0,0,0,2,3
The Haz Mat Guys podcast,0,0,0,0,50,50
The Health Ranger Report,8,4,4,1,33,50
Bitch Sesh: A Real Housewives Breakdown,10,2,2,4,32,50
Sleep with Silk: ASMR Triggers,14,3,0,5,15,37
When They Was Fab: Electric Arguments About the Beatles,0,0,1,1,7,9
Chameleon Academy Podcast with Bill Strand,0,0,0,0,34,34
Love Life with Matthew Hussey,0,2,3,6,241,252
The Youth Baseball Edge Podcast with Rob Tong: Coaching | Drills | Strategy,0,0,0,2,147,149
Inspirational Living: Life Lessons for Success & Happiness,5,6,2,4,33,50
WhatCulture Wrestling,18,4,5,5,265,297
Care & Discipleship Podcast – IBCD,0,0,0,0,1,1
The Sarah Fraser Show,13,2,8,4,332,359
AFP: American Family Physician Podcast,2,0,1,2,44,49
The Essential Oil Revolution w/ Essential Oils Educator Samantha Lee Wright,2,4,0,2,42,50
Science(ish),0,0,0,0,2,2
The Emotionally Healthy Leader Podcast,0,0,0,0,18,18
LadyGang,86,16,30,16,352,500
The Word on Fire Show - Catholic Faith and Culture,6,3,4,6,481,500
Conservative Review with Daniel Horowitz,13,5,6,2,160,186
Radio Dharma,0,0,0,0,2,2
Meaningful Life Skills: Weekly Global Class,0,0,0,0,1,1
Fangirls Going Rogue: Star Wars Conversation from a Female POV,1,1,0,2,59,63
Smarter Brain Now,0,0,0,0,13,13
40+ Fitness Podcast,2,1,1,2,44,50
Your First Hundred Million - As Read by the 50 Billion Dollar Man,0,0,0,0,9,9
The OCD Stories,2,0,3,2,43,50
Professional Book Nerds,2,3,4,6,52,67
Modern Love,0,0,0,4,18,22
Functional Medicine Research with Dr. Nikolas Hedberg,0,0,0,1,24,25
How To Be A Better Drinker,1,0,0,0,20,21
"Brazilian Portuguese Podcast, by RLP",0,0,1,0,9,10
UpToDate Talk,0,2,1,2,13,18
Rune Soup,6,2,6,4,60,78
The Talent Angle with Scott Engler,0,0,0,1,26,27
The X-Files Podcast,3,1,2,1,40,47
Sleep with Silk: Nature Sounds,5,7,2,13,23,50
Blueshirts Breakaway: A show about the New York Rangers,13,6,3,1,260,283
BLISTER Podcast,0,0,1,1,27,29
The Crafter's Box Podcast,0,0,0,0,2,2
Campground of the Week,0,0,0,0,28,28
Beyond Reality Paranormal Podcast,18,6,4,9,68,105
Awesome Marriage Podcast,0,0,1,2,47,50
"2 Docs Talk: The podcast about healthcare, the science of medicine and everything in between.",4,4,2,3,37,50
Book of Mormon Central,1,0,2,0,19,22
MASTERPIECE Studio,3,2,5,11,58,79
Space,2,0,0,1,8,11
Pro Wrestling Illustrated Presents,0,1,0,0,0,1
The Director's Cut - A DGA Podcast,0,0,4,6,24,34
This Week in Evolution,1,0,1,1,15,18
Ask The Tech Coach,0,0,0,0,1,1
The Camino Podcast,0,0,0,0,5,5
Audio Arguendo,0,0,0,0,2,2
Optimal Living Daily: Personal Development & Minimalism,0,2,3,4,41,50
DNVR Denver Broncos Podcast,15,7,7,8,198,235
Golf Central Podcast,3,1,3,2,5,14
The Robin Sharma Mastery Sessions,0,0,4,8,120,132
Overtime,1,4,1,1,42,49
Getting Curious with Jonathan Van Ness,12,7,14,28,439,500
Educators Lead with Jay Willis,0,0,0,0,50,50
Golf Monthly Clubhouse,0,0,0,0,1,1
The Guilty Feminist,13,2,5,6,474,500
Radio Labyrinth,0,1,1,0,82,84
DNVR Colorado Rockies Podcast,0,2,1,3,31,37
DNVR Colorado Avalanche Podcast,5,5,9,8,130,157
Stuff I Never Knew Trivia Game Show Podcast,2,0,0,1,31,34
Overly Animated Miraculous Ladybug Podcasts,0,1,1,3,33,38
Slow Russian,1,0,1,0,48,50
The Minimalists Podcast,6,3,1,1,39,50
"The 85 South Show with Karlous Miller, DC Young Fly and Chico Bean",0,1,1,2,46,50
Jocko Podcast,10,1,2,5,480,498
OldPreMeds Podcast,0,0,0,0,23,23
The Librarian Is In,4,2,1,6,161,174
"Weight Loss Made Real: How real women lose weight, stop overeating, and find authentic happiness.",0,0,0,1,49,50
Craig Groeschel Leadership Podcast,0,0,0,0,29,29
Hoardganize Podcast,2,0,0,0,12,14
Fantasy Golf Degenerates,4,0,4,3,194,205
"Tiny Leaps, Big Changes",10,5,7,1,27,50
SokukoJi Buddhist Temple Monastery,0,0,0,0,2,2
The Power Company Podcast,1,0,2,8,144,155
Rare & Scratchy Rock 'N Roll Podcast,0,0,0,0,13,13
Ready For Takeoff - Turn Your Aviation Passion Into A Career,0,0,0,0,43,43
Toyota Trucks and Trails Podcast,0,0,0,2,32,34
Quran Weekly,0,0,0,0,2,2
The Deen Show,0,0,0,0,3,3
Submitted For Your Approval - A Twilight Zone Podcast,2,1,1,1,21,26
School of Self-Image,0,0,0,0,50,50
The Cabral Concept,2,0,1,0,47,50
Natural MD Radio,0,0,1,0,49,50
The Scarecast,21,15,10,13,141,200
Talking Beards,0,1,0,0,8,9
Secular Buddhism,2,0,2,3,189,196
Counter Worlds,0,0,0,1,5,6
Retro Movie Geek,0,2,1,0,9,12
Smart Poker Study Podcast,0,0,0,0,40,40
Put A Ring On It: The Wedding Planning Podcast,0,0,0,0,6,6
The Biddy Tarot Podcast: Tarot | Intuition | Empowerment,0,0,0,1,49,50
Unravel A Fashion Podcast,4,2,2,0,13,21
Manchester United Weekly Podcast,0,0,0,1,32,33
Speaking Easy - A Cocktail Podcast,0,0,0,0,15,15
"Beyond Bourbon Street, an Insider's Guide to New Orleans",2,1,1,0,304,308
Bartender at Large,0,0,0,1,15,16
Dreams Unlimited Travel Show - A Weekly Discussion About Travel and Dreams Unlimited Travel,1,0,0,0,14,15
The CyberWire Daily,4,0,2,4,107,117
Real Talk With Jimmy Moore,4,3,3,3,37,50
Play Therapy Community,0,0,1,0,15,16
DK Pittsburgh Sports,3,0,5,6,60,74
Presidential,4,2,5,8,31,50
Aquarium Co-Op Podcast,4,2,1,0,43,50
Simply Charlotte Mason Homeschooling,0,0,0,0,9,9
"Grace & Grit Podcast:  Helping Women Everywhere Live Happier, Healthier and More Fit Lives",0,0,0,0,50,50
OPTAVIA® Habits of Health® Community Time Podcast,0,4,0,1,5,10
The Money Show,0,2,2,1,16,21
Mentors for Military Podcast,0,0,1,0,26,27
Fox Across America w/ Jimmy Failla,5,2,0,2,41,50
Seeking Wisdom,0,0,0,0,50,50
Wise Traditions,3,2,0,0,45,50
Risen Motherhood,0,1,3,2,494,500
The Speaker Lab,1,0,0,3,196,200
The Blogging Millionaire,0,3,8,0,189,200
Motivational Mornings,1,1,1,0,18,21
Pivot,186,111,132,153,597,1179
The Retro Hour (Retro Gaming Podcast),0,2,0,0,29,31
Body Kindness,0,1,1,0,48,50
The Authority Hacker Podcast,0,1,2,3,44,50
50 Years of Maximum Rock n' Roll,0,0,1,1,67,69
Girlfriends (A Podcast for Catholic Women),0,0,0,2,106,108
SinCast - Presented by CinemaSins,10,10,9,11,139,179
IoT This Week,0,0,0,0,1,1
Video Creators,0,0,0,2,24,26
Untangle,3,4,0,3,28,38
Salt Strong Fishing,6,3,1,4,486,500
Bruce Springsteen Sings the Alphabet,0,0,0,2,31,33
What Should I Read Next?,6,2,5,7,180,200
Will You Accept This Rose?,12,1,2,10,440,465
The Jason Manford Show,0,1,2,4,63,70
H.A.M. Radio Podcast,3,3,0,4,66,76
Eye on Security,0,0,1,0,0,1
Cultures of Energy,0,0,0,0,12,12
B2B Growth: Your Daily B2B Marketing Podcast,1,0,0,1,148,150
On The Merits,0,0,1,0,0,1
History of Westeros (Game of Thrones),12,8,13,10,157,200
Insatiable,1,1,0,0,48,50
Walk to Work - A Mobile Hearthstone Podcast,2,1,0,0,46,49
The History of Judaism: The History and Story of the Jews,0,0,0,0,1,1
Exploring Unschooling,1,0,0,0,24,25
The Mind Your Business Podcast,0,0,0,2,98,100
Greater Boston,0,2,0,2,46,50
My Favorite Murder with Karen Kilgariff and Georgia Hardstark,222,94,72,42,568,998
The Xbox Two Podcast,3,1,0,0,7,11
Teach 4 the Heart,1,1,1,1,31,35
The Amazon FBA Private Labeler Show,0,0,0,0,50,50
Dietitian Connection Podcast,0,0,0,0,3,3
Personal Finance with Warren Ingram,0,0,1,0,3,4
Adventure Rider Radio RAW Motorcycle Roundtable Talks,0,0,1,0,24,25
Off The Script w/JDfromNY,13,0,2,3,282,300
"School of Psych | Insightful interviews and stories about psychology, culture, and relationships.",0,0,1,0,23,24
Libros para Emprendedores,0,0,0,1,66,67
Sewing Out Loud,8,11,3,1,27,50
Nursing School Struggles by NURSING.com (NRSNG),0,0,0,0,3,3
"Chrissie, Sam and Browny",7,3,2,4,37,53
RSD Sanga,0,0,0,0,1,1
Dynamic Duel: DC vs Marvel,0,0,0,2,131,133
The Billions Podcast,3,6,7,2,12,30
Art Made Easy,1,0,0,0,49,50
Who? Weekly,0,1,1,1,47,50
Thrivetime Show | Business School without the BS,14,6,3,3,174,200
Golf Guide Podcast,0,0,0,1,10,11
The Tom Ferry Podcast Experience,4,2,1,2,117,126
Becoming A Data Scientist Podcast,0,0,0,1,5,6
Plein Air Art Podcast,1,2,3,1,17,24
The Beginner Photography Podcast,0,0,0,0,89,89
The Love Food Podcast,0,0,0,1,49,50
The Call The Midwife Podcast,1,0,1,0,6,8
Manage This - The Project Management Podcast,0,0,0,1,7,8
Global Recon,0,0,1,7,42,50
Why We Fly,0,0,0,0,8,8
FiveThirtyEight Politics,236,69,64,23,108,500
Mortgage Marketing Radio,0,0,0,0,50,50
Victoria's Lift,4,1,3,1,41,50
MedConversations,0,0,1,0,2,3
GrowCast,1,0,3,2,44,50
Dopey: On the Dark Comedy of Drug Addiction,1,0,1,1,47,50
Widow Cast:  Widows Empowering Widows - How to Self Coach Through Grief,0,0,0,1,53,54
1001 Classic Short Stories & Tales,3,3,1,3,40,50
Unexplained,12,12,21,23,432,500
Living Unconventionally,0,0,0,0,59,59
Drywater,0,0,0,1,4,5
The Lesbian Romantic,3,0,0,2,45,50
The Greatest Generation,5,0,0,0,45,50
Wedding Planning Podcast,0,0,4,2,44,50
Rolling Stone Music Now,5,5,2,14,24,50
Picture This: Photography Podcast,3,3,1,1,75,83
Legends of Surgery,0,0,0,2,29,31
Urban Forestry Radio,0,0,0,0,2,2
The Crossover NBA Show with Chris Mannix and Howard Beck,14,3,11,11,78,117
"Weird Darkness: Stories of the Paranormal, Supernatural, Legends, Lore, Mysterious, Macabre, Unsolve...",26,13,10,18,433,500
The No Film School Podcast,4,2,4,3,41,54
The Working Songwriter,0,0,0,0,50,50
Building your T-Shirt Empire,0,0,0,0,10,10
Macro Voices,5,3,5,3,184,200
Slave Stealer,0,0,0,0,26,26
Silhouette Zero: Star Wars Edge of the Empire Actual Play Podcast,0,0,0,1,49,50
Afford Anything,6,2,6,4,182,200
Padres Hot Tub,4,1,0,2,14,21
Real Estate News: Real Estate Investing Podcast,0,0,0,0,11,11
Micheaux Mission,0,1,0,2,54,57
"Space Nuts | Astronomy, Space and Science News",0,0,0,1,18,19
BEHIND THE CURTAIN: BROADWAY'S LIVING LEGENDS » Podcast,0,0,0,1,49,50
The Hamilcast: A Hamilton Podcast,6,4,7,7,176,200
The Deconstructionists,9,11,10,11,133,174
CIIS Public Programs,0,0,0,0,6,6
Ten Tenths Podcast,0,1,1,0,47,49
Build Your House Yourself University,2,0,0,2,114,118
The Tennis Files Podcast,0,0,0,0,31,31
Extreme Productivity with Kevin Kruse,0,1,1,12,181,195
The Intuitive Hour: Awaken Your Inner Voice,1,3,2,1,29,36
Recode Media,4,1,2,4,39,50
Triathlon Coaching with TOWER 26- Be Race Ready Podcast,0,1,1,0,33,35
Madhouse Chicago Hockey Podcast,11,2,5,6,62,86
Won Buddhism Dharma Talks,1,0,1,0,5,7
The Hook Up,2,1,2,2,38,45
Locked On Dynasty Football,8,4,11,9,190,222
Sounds Good with Branden Harvey,0,0,3,3,44,50
Spirits,3,5,1,2,39,50
The Anxiety Guy Podcast,0,1,0,1,48,50
"SpaceTime with Stuart Gary | Astronomy, Space & Science News",7,2,2,2,30,43
6 Minute Grammar,0,0,1,1,6,8
The Complete HP Lovecraft Podcast,0,0,0,0,7,7
Your Daily Revolution,0,0,0,1,67,68
Is This Going To Cause An Argument,1,0,0,2,47,50
The Vanished Podcast,30,36,52,18,150,286
Foot Traffic Podcast,1,0,0,1,48,50
Real Crime Profile,102,59,69,52,218,500
Morrisonic: A Podcast About the Portland Timbers (Mostly),0,0,0,2,31,33
Joe on Joe - A G.I. Joe Podcast,0,0,0,1,22,23
Misery Loves Company,15,2,1,0,32,50
The Folktale Project,1,0,0,1,22,24
Columbia Energy Exchange,0,1,0,2,18,21
Blueshirt Banter: for New York Rangers fans,13,9,3,2,58,85
Vox Conversations,50,19,31,27,373,500
Bernie and Sid,5,2,3,6,34,50
No Joke Podcast,0,0,1,0,49,50
Jesus Calling: Stories of Faith,4,2,0,3,37,46
Commentary Magazine Podcast,5,1,3,3,38,50
FBI Retired Case File Review,4,7,9,11,178,209
The Prancing Pony Podcast,3,0,0,2,195,200
The Ask Mike Reinold Show,0,1,1,4,44,50
Talking Chop: for Atlanta Braves fans,8,5,4,5,83,105
alinajim,1,0,1,1,18,21
Dr Justin Coulson's Happy Families,0,0,1,0,73,74
The Secret Room | True Stories,17,6,9,11,170,213
"Accessible Astrology Podcast with Eugenia Krok, MA - Astrologer Trained in Psychotherapy",22,1,3,3,129,158
On the Other Hand: Ten Minutes of Torah,1,1,1,1,35,39
The Dynasty Dude | Dynasty Fantasy Football | Fantasy Football,3,0,3,3,380,389
Mexico Unexplained,4,1,4,3,12,24
Manga Mavericks,0,1,0,0,4,5
Crime in Sports,2,0,0,0,48,50
"Andy Zodin's KickServeRadio.com, featuring Mats Wilander and Jonny Levine",0,0,0,0,2,2
So Fly Fishing,0,0,0,0,6,6
Against the Odds,0,2,1,0,21,24
Wrench Nation,3,0,0,0,9,12
Earth Speak with Natalie Ross and Friends,0,1,1,0,76,78
Foreplay Radio -- Couples and Sex Therapy,0,0,1,1,48,50
Running Commentary,0,0,0,0,1,1
Relatos & Leyendas Urbanas,0,0,0,1,7,8
Rental Property Owner & Real Estate Investor Podcast,2,0,1,0,47,50
I-KID-A-POD,0,0,0,0,8,8
Literature and History,1,2,1,2,194,200
The Trail Went Cold,48,41,27,51,330,497
Dateable: Your insider's look into modern dating,5,5,4,5,128,147
Mindful Recovery,0,0,0,0,23,23
The F*ck It Diet with Caroline Dooner,2,3,3,5,37,50
The Curious Cases of Rutherford & Fry,0,0,3,0,61,64
The OneFootball Podcast,0,0,1,1,68,70
Vinnie Paz Presents The Broad Street Breakdown,0,0,0,0,110,110
Door Bumper Clear - Dirty Mo Media,10,4,6,9,471,500
Someone Who Isn't Me,0,0,0,0,23,23
Marveling at Marvel's Marvels,7,3,2,6,76,94
Pregnancy Confidential,8,12,6,4,20,50
The RV Entrepreneur,2,1,0,2,195,200
The Dean Graziosi Show,2,1,0,2,126,131
Slow German,1,0,0,0,14,15
Conscious Chatter with Kestrel Jenkins,0,0,0,0,33,33
Best of Barstool Radio,20,3,4,2,21,50
Cincinnati Soccer Talk,0,0,0,1,45,46
Lost Origins,10,4,6,2,49,71
The Crush,0,0,1,0,18,19
Mufti Ismail Menk,0,0,0,0,4,4
Return Home,1,3,8,2,36,50
MrCreepyPasta's Storytime,7,5,9,9,170,200
The Behavioral Observations Podcast with Matt Cicoria,1,3,1,5,112,122
The BIRTHFIT Podcast,1,0,3,0,35,39
When Calls the Heart Reviews and After Show - AfterBuzz TV,0,1,0,1,18,20
The Way I Heard It with Mike Rowe,18,8,12,12,226,276
Ten Percent Happier with Dan Harris,24,15,30,30,330,429
The Resident Evil Podcast,1,1,0,0,11,13
Kung Fu Drive-In Podcast,0,0,0,1,39,40
The Eating Disorder Recovery Podcast,0,0,0,0,50,50
The 10 Minute Jazz Lesson Podcast,0,0,0,0,31,31
Trial Lawyer Talk Podcast,0,0,0,1,35,36
Better Health While Aging Podcast,0,0,0,0,27,27
Around The Rim,0,0,0,2,29,31
Fat Mascara,21,11,17,11,140,200
40 Weeks Pregnancy Podcast,1,2,1,0,46,50
Khalid Al Jalil,0,0,0,1,1,2
Raad Mohammad al Kurdi,0,0,1,0,7,8
Earn Your Happy,2,0,0,0,48,50
Insijam Podcast with Dalal Al-Janaie,0,1,3,1,37,42
Ocean Science Radio,0,0,0,0,7,7
Judaism Unbound,1,0,0,2,58,61
False Neutral,0,0,0,0,9,9
Obsessed Show,0,0,0,0,28,28
Born In June Raised In April: What Adoption Can Teach the World,0,0,0,0,12,12
Nonprofits Are Messy: Lessons in Leadership | Fundraising | Board Development | Communications,0,1,1,1,47,50
Real Talk School of Nursing,0,0,0,0,15,15
Analytics on Fire,0,0,0,3,18,21
#PTonICE Daily Show,0,0,2,1,9,12
The Mad Mamluks,5,2,2,4,57,70
POS,3,0,0,1,29,33
Justin Bieber Podcast,2,1,2,1,3,9
Art Ed Radio,0,0,2,1,22,25
Behavior Analysis,0,0,0,0,8,8
Alice Isn't Dead,5,8,4,4,29,50
Pardon My Take,89,20,15,8,368,500
The Brian Buffini Show,2,0,2,0,196,200
Front End Happy Hour,1,0,1,2,27,31
After Sectionals,0,0,0,1,34,35
Someone Knows Something,29,13,19,36,403,500
RealzTenisFanz Podcast,1,1,0,0,10,12
Naptime Is Sacred,0,0,0,0,11,11
There Goes the Neighborhood,2,1,1,2,56,62
The Hospital Finance Podcast,0,0,0,0,2,2
Everything Hertz,0,0,1,0,10,11
A Good Football Show,9,7,11,11,296,334
#Hip-Hop #Reggae #Electronic Dance Music,2,0,0,1,7,10
The Official SaaStr Podcast: SaaS | Founders | Investors,1,0,0,0,19,20
Made For Living Well,0,0,1,1,48,50
Dev Game Club,0,0,0,1,49,50
Beautiful Stories From Anonymous People,15,7,4,4,470,500
The Star Wars Collector Podcast,0,0,0,0,10,10
Bite,3,3,4,0,29,39
Learn True Health with Ashley James,1,1,0,1,47,50
The Resus Room,0,0,0,0,2,2
Outside Podcast,14,6,17,23,128,188
The John Campea Show Podcast,14,3,4,24,435,480
The Penumbra Podcast,3,3,5,7,182,200
The Self Publishing Show,0,0,0,0,9,9
"The Motivation Movement | Inspirational Quotes, Daily Advice, Lifestyle Design, Personal Development",2,0,1,2,24,29
Secret Transmission Podcast,11,2,1,3,69,86
Sports Radio Detroit,2,0,0,0,7,9
School Psyched!,0,0,4,2,11,17
Rock Your Retirement Show,1,0,1,1,31,34
Optimal Finance Daily,10,6,9,9,166,200
The Uncertain Hour,0,3,2,2,43,50
The Love U Podcast with Evan Marc Katz,0,0,1,4,78,83
Athletico Mince,11,0,5,12,327,355
Soft Skills Engineering,0,1,0,1,35,37
The Movie Show,0,0,2,0,11,13
Locked On Auburn -  Daily Podcast On Auburn Tigers Football & Basketball,7,6,3,1,110,127
STEM-Talk,0,0,0,2,48,50
ABA Inside Track,1,0,1,1,96,99
Perfect Organism: The Alien Saga Podcast,1,2,2,1,11,17
Embedded,46,36,8,10,194,294
JAMA Pediatrics Editors' Summary,0,0,0,0,1,1
Paychecks & Balances,2,1,1,1,45,50
THIRD EYE DROPS,2,0,4,2,218,226
Far From Home,0,0,1,3,45,49
Mile High Endurance Podcast,0,0,0,0,3,3
Distraction with Dr. Ned Hallowell,1,0,0,2,47,50
MEDIA INDIGENA : Indigenous current affairs,0,0,0,0,17,17
Policing Matters,0,1,1,1,4,7
Giants Talk: A San Francisco Giants Podcast,5,0,1,2,28,36
The Koy Pond with Jo Koy,4,5,1,5,35,50
Las Culturistas with Matt Rogers and Bowen Yang,2,1,1,0,46,50
Downloadable Content,0,0,0,0,14,14
Parenting Beyond Discipline,5,4,1,3,30,43
The Shameless Mom Academy,0,1,0,0,49,50
Sunday School Dropouts,12,1,1,1,160,175
Business Made Simple with Donald Miller,14,13,9,9,155,200
Sleep Whispers,6,1,4,4,35,50
Jim Robbie and the Wanderers,1,1,1,3,14,20
Anime Arcade,0,0,0,0,6,6
Uncanny County,2,0,2,0,46,50
The Skinny Confidential Him & Her Podcast,19,2,2,4,23,50
"Behind the Porn Scenes with Lelu Love - Sex, Dating and My Real Life",1,0,0,1,16,18
Unsafe Space,2,0,3,0,16,21
Wild Heart Meditation Center,1,0,0,1,10,12
Music Makers and Soul Shakers with Steve Dawson,0,0,0,2,52,54
Trumpcast,9,2,3,2,34,50
The Car and Driver Podcast,3,0,0,2,12,17
Barstool Rundown,23,2,7,4,118,154
The West Wing Weekly,9,7,6,9,469,500
Free Hypnosis | Hypnotherapy | Self help | Life coaching with Kim Little,0,0,0,0,8,8
The Drive Podcast,2,1,2,0,10,15
The New Yorker: The Writer's Voice - New Fiction from The New Yorker,5,5,6,10,74,100
ASCD  Learn  Teach  Lead Radio,0,0,0,1,2,3
Short & Curly,2,1,0,4,43,50
Coffee + Crumbs Podcast,6,3,1,0,40,50
Mark And Sarah Talk About Songs,3,0,0,2,45,50
The Original Cast,0,2,1,1,44,48
Scuderia F1: a Formula 1 podcast,0,0,1,0,4,5
The Hardcore Self Help Podcast with Duff the Psych,4,0,1,1,44,50
Are We There Yet?,0,2,0,1,19,22
Talking Out Your Glass podcast,0,0,0,0,17,17
Starcalled,0,1,1,2,17,21
Monsters Among Us Podcast,17,2,8,6,467,500
New Slang,0,0,0,0,16,16
Learn Jazz Standards Podcast,1,0,1,0,48,50
The Clubhouse with Shane Bacon,4,0,0,4,376,384
Hammer Factor,3,1,0,2,21,27
Becoming Wise,0,0,0,2,26,28
The Magnus Archives,1,0,1,1,197,200
Bark n Wag 15 Minute Vet Talk,0,0,0,0,40,40
Flite Test Community Podcast,0,0,0,0,10,10
EM Clerkship,0,0,0,0,50,50
Fairway Rollin',65,21,12,15,322,435
The Privacy Advisor Podcast,0,1,2,1,4,8
Spiritual Awakening - Dr. Erin Podcast,0,0,0,0,62,62
The Christian History Podcast,2,1,0,2,62,67
The Incredible Dr. Polcast,0,0,0,0,17,17
Not By Accident,2,0,1,13,192,208
The Sneak Diss Sneaker Podcast,2,0,1,0,48,51
Harry Potter and the Sacred Text,30,15,9,10,436,500
Yoga | Birth | Babies,0,1,0,0,49,50
Ctrl Alt Delete,4,6,6,5,106,127
Parts Per Billion,0,1,1,1,2,5
Drink Champs,31,19,30,33,386,499
JEL,0,0,0,0,11,11
Talk of the TOUR Golf Podcast,0,0,0,2,4,6
Golf Talk America,1,1,0,0,2,4
On the Mark Golf Podcast,0,1,3,1,36,41
The Vikings After Show Podcast,0,0,1,0,5,6
The Presentation Podcast,0,0,0,0,14,14
2 Dope Queens,3,1,0,1,45,50
The Easy Allies Podcast,2,1,2,1,44,50
Not Your Mother's Menopause with Dr. Fiona Lovely,1,1,0,1,22,25
Don't Give Up The Ship Podcast,0,0,0,0,6,6
WeMartians Podcast,0,0,0,1,20,21
Chapo Trap House,6,1,7,4,32,50
Lifetime Cash Flow Through Real Estate Investing,9,4,10,6,171,200
Tales Of The Black Badge - A Wynonna Earp Fan Podcast,1,0,1,1,41,44
How to Succeed Podcast,1,0,0,1,26,28
The Dance Podcast,0,0,1,1,10,12
Square Roots - THE Classic RPG Podcast,0,0,2,4,113,119
The Paid Search Podcast | A Weekly Podcast About Google Ads and Online Marketing,0,1,0,0,49,50
The Real Weird Sisters: A Harry Potter Podcast,3,1,7,5,184,200
"The Fifth Column - Analysis, Commentary, Sedition",9,3,2,4,32,50
Thinner Peace in Menopause,2,1,0,2,45,50
Pints With Aquinas,6,5,3,8,478,500
The Sivana Podcast,3,1,3,22,247,276
"Master Mind, Body and Spirit",1,0,0,1,187,189
The Steam Rollers Adventure Podcast,0,0,0,0,18,18
Archive 81,2,1,1,2,44,50
The Homeschool Highschool Podcast,0,0,0,0,14,14
Firehouse Problems Kitchen Table Solutions Podcast,0,0,0,0,3,3
The Tony Robbins Podcast,1,0,0,1,2,4
Digital Health Today 360 with Dan Kendall,0,0,0,0,25,25
"ClutterBug Podcast - Organize, Clean and Transform your Home",3,0,0,3,44,50
HerMoney with Jean Chatzky,3,2,0,5,155,165
The Hardcore Closer Podcast,0,0,0,0,100,100
Agency Intelligence,0,0,0,0,9,9
Sasquatch Syndicate,2,2,2,2,19,27
Crochet Circle Podcast,0,0,0,0,3,3
Macro Musings with David Beckworth,0,0,0,1,49,50
The Fallen State (Audio),2,0,0,1,15,18
Magical Mystery Radio: Conspiracy & Paranormal Review,17,4,6,4,44,75
Based on a True Story,3,0,3,3,70,79
5 Minute Marketing with Brian Moran,0,0,0,2,48,50
The Saltwater Aquarium Radio Podcast,0,0,0,0,50,50
"The Other Stories | Sci-Fi, Horror, Thriller, WTF Stories",2,2,3,5,38,50
Skyrim Book Club,0,0,0,2,24,26
Sleep with Silk: Binaural Beats,2,0,2,1,10,15
Nordeast Podcast,1,0,0,0,60,61
"Lab Values Podcast (Nursing Podcast, normal lab values for nurses for NCLEX®) by NURSING.com (NRSNG)",0,0,0,0,4,4
Black N' Gold Hockey Podcast,0,0,2,2,52,56
Talk Easy with Sam Fragoso,0,1,1,1,81,84
The History of Ancient Greece,7,3,4,3,33,50
Live Kabbalah – Weekly Zohar Study,0,0,1,0,2,3
I'll Have Another with Lindsey Hein Podcast,1,2,7,7,483,500
Heroine,0,0,2,1,197,200
Following On in India Cricket Podcast,1,0,0,1,1,3
Negotiate Anything,1,1,0,0,48,50
Coffee House Shots,19,5,12,26,252,314
AUAUniversity,0,0,0,0,2,2
Parenting Great Kids with Dr. Meg Meeker,14,5,2,6,23,50
"Research in Action | A podcast for faculty & higher education professionals on research design, meth...",0,0,0,1,8,9
The Trial Lawyers College Podcast,3,0,2,0,9,14
Cop Life,0,0,0,0,87,87
Wire Talk with Karen Stubbs,0,0,0,0,50,50
PSG Talking,0,0,0,0,11,11
Pure Natural Pregnancy,0,0,0,0,3,3
TILT Parenting: Raising Differently Wired Kids,0,1,0,0,49,50
The NBA Podcast,4,0,1,4,14,23
"Moshe, Midrash, and Mashiach",2,0,0,0,2,4
Jojo's World,0,0,1,0,32,33
Puck Soup,42,20,15,14,373,464
The Party Room,16,8,3,3,118,148
Nonprofit Leadership Podcast,0,0,1,1,25,27
Schlaulicht,0,0,0,1,0,1
The Guitar Hour Podcast,0,0,0,0,8,8
Thaddeus Ellenburg's Casual Friday,0,0,0,1,5,6
Small Town Horror,23,34,28,28,87,200
Viking Age Podcast,1,0,0,2,47,50
A Balancing Act,0,0,0,0,40,40
But Why: A Podcast for Curious Kids,4,0,1,5,40,50
Buck Reising on 104-5 The Zone,1,3,4,0,6,14
The Fantasy Football Smackdown,1,2,1,1,84,89
REALITY OF REALITY,4,0,0,0,70,74
Dynasty Happy Hour | Fantasy Football | Dynasty | NFL | NFL Draft,9,3,4,6,100,122
Nerdette Recaps With Peter Sagal,29,21,15,7,182,254
Love Smarter: Relationship Advice for Women Who Like Personal Development,1,1,0,1,23,26
The ThinkOrphan Podcast,0,0,0,0,25,25
Why Service Design Thinking,0,0,0,0,12,12
Pageant Planet,0,0,0,0,9,9
Whiskey Politics,1,0,0,1,28,30
FDNY Pro,0,0,0,0,5,5
The Fitness And Lifestyle Podcast,0,0,0,0,11,11
The Guitar Knobs,0,0,0,0,26,26
"The How of Business - How to start, run & grow a small business.",0,0,0,0,42,42
ScareZone - Halloween Horror Nights Podcast,1,1,0,0,32,34
Sylvester Stallone Fan Podcast Network,0,0,0,2,21,23
The Zen Mountain Monastery Podcast,0,0,1,0,4,5
Main Engine Cut Off,0,0,1,0,27,28
Massenomics Podcast,0,0,0,0,50,50
A Quest for Magic and Steele - DnD,1,0,0,3,46,50
The Bill Barnwell Show,19,7,2,10,73,111
That Couple Next Door,4,0,0,1,39,44
How to Be Awesome at Your Job,6,5,3,2,155,171
Over The Monster: for Boston Red Sox fans,2,2,4,5,13,26
Learn to Code With Me,1,1,4,8,127,141
Clever,2,5,3,2,66,78
Bionic Planet: Reversing Climate Change by Restoring Nature,0,0,0,0,13,13
Mountain & Prairie with Ed Roberson,0,0,1,2,158,161
Copy That Pops: Writing Tips and Psychology Hacks for Business,0,0,1,0,49,50
The Jump,31,11,14,9,41,106
Mastering Nutrition,0,0,1,1,48,50
To Be Continuous,0,0,0,0,3,3
The Hosel Jockeys Golf Podcast,0,0,0,0,49,49
Be Remarkable.,0,1,0,0,7,8
The Lavendaire Lifestyle,2,0,0,2,46,50
The Disruptive Voice,0,0,0,0,5,5
Critically Acclaimed Network,0,1,2,0,61,64
The Jam with Marmalead,4,1,4,4,6,19
These Football Times,1,1,3,1,4,10
WBEZ's Reset,0,0,2,1,38,41
The Lando Cal Experience,0,0,0,0,5,5
Best In Galaxy,0,0,0,0,1,1
Servant Leadership Institute Podcast,0,0,0,2,0,2
The Focus Group,0,0,1,0,33,34
Circulation on the Run,0,0,0,0,5,5
Tripawd Talk Radio,0,0,0,0,1,1
Docs Outside The Box - Ordinary Doctors Doing Extraordinary Things,0,1,0,1,124,126
Freya's Singing Tips: Train Your Voice | Professional Singers | Singing Technique | Mindset,0,1,0,0,9,10
Bear Download — A Chicago Bears podcast,12,7,7,7,24,57
Royal Blue: The Everton FC Podcast,0,1,1,2,10,14
Blood Red: The Liverpool FC Podcast,0,0,5,1,29,35
Mikeadelic,1,0,1,2,114,118
Anansi Storytime,1,0,0,1,2,4
Off the Cuffs: a kink and BDSM podcast,2,1,0,0,47,50
The Ringer NBA Show,111,53,45,65,226,500
The Ringer NFL Show,144,64,78,51,163,500
exocast,1,0,0,1,2,4
OPB Politics Now,1,0,5,2,19,27
@ Sea with Justin McRoberts,0,0,0,0,22,22
Millionaire Mindcast,0,2,0,1,197,200
Blues Hockey Podcast,2,1,0,1,18,22
AP: Australian Politics,7,1,4,6,77,95
Cubs Related: A Chicago Cubs Podcast,5,1,0,1,80,87
PoetryNow,0,0,0,0,2,2
The LEO Family Fitness Podcast,1,0,0,0,49,50
Islam for Life with Shaykh Walead Mosaad,0,0,0,0,1,1
The Below Deck After Show Podcast,5,2,2,2,2,13
Drew and Mike Show,9,2,2,1,36,50
POLITICO's Nerdcast,11,7,8,7,17,50
The Watch,66,22,35,29,224,376
Unstoppable Recording Machine Podcast,1,0,1,4,179,185
Elseworlds Exchange,4,0,2,0,26,32
Carioca Connection: Brazilian Portuguese Conversation.,0,1,1,1,34,37
Latinos Who Lunch,0,0,1,2,324,327
"Don't Salt My Game | With Laura Thomas, PhD",1,0,2,3,38,44
Nursing Mnemonics Show by NURSING.com (NRSNG) (Memory Tricks for Nursing School),0,0,1,0,4,5
STEM Everyday,0,0,0,0,3,3
The PodCask: a Podcast About Whiskey,2,0,2,0,96,100
The Lazy Genius Podcast,1,0,2,0,47,50
Crimelines True Crime,64,40,31,21,344,500
Code Switch,80,18,28,28,562,716
The Sean Hannity Show,158,14,16,16,296,500
Hyperallergic,1,2,0,0,13,16
Inside The Big Ring: The Podcast for Endurance Athletes,0,0,0,1,12,13
Off the Pulpit with Rabbi David Wolpe,1,0,0,0,8,9
Spittin Chiclets,30,6,9,14,441,500
Harford County Living with Rich Bennett,0,0,0,0,2,2
The Tesla Tidbits Show,0,0,1,2,13,16
Fantasy Football Counselor - Fantasy Football Podcast,103,8,6,1,382,500
Spidell's California Minute,0,0,0,0,2,2
"Story Story Podcast: Stories and fairy tales for families, parents, kids and beautiful nerds.",5,0,5,3,37,50
Dr. Joe Tatta | The Healing Pain Podcast,0,0,0,0,50,50
Let’s Teach History:  Tips and Ideas for Teaching American History to High School Students,0,0,0,1,8,9
Circling the Bases,2,0,1,4,28,35
ChangeUnderground,0,0,0,0,3,3
The Chief Customer Officer Human Duct Tape Show,0,0,1,0,14,15
The Feast,0,0,0,1,22,23
The Full Nerd,0,1,0,1,16,18
On Brand with Nick Westergaard,0,1,0,3,34,38
You Had Me at Black,26,0,1,3,75,105
Cum Town,4,0,1,2,43,50
Expected Buffalo | The Podcast,0,1,1,3,7,12
Little Known Facts with Ilana Levine,2,0,0,0,48,50
PA Power Wrestling Podcast,0,0,0,1,5,6
The Matt & Blonde Show,2,0,0,1,47,50
Psychedelics Today,2,0,2,3,46,53
Early Break – 93.7 The Ticket KNTK,1,0,0,0,7,8
PokerNews Podcast,6,2,0,2,40,50
RC Roundtable,0,0,0,1,5,6
The Mad Scientist Podcast,9,1,2,3,69,84
The Instigator Podcast,2,0,0,1,6,9
Investing in Real Estate with Clayton Morris | Investing for Beginners,26,0,5,4,65,100
3D Muscle Journey,1,1,1,1,46,50
The Homeschool Solutions Show,2,3,3,1,41,50
All About Fitness,2,0,0,2,44,48
Great Moments In Science,0,0,0,0,4,4
Dungeon Delve – An Official Dungeons & Dragons Podcast,3,2,1,0,44,50
Java with Juli,2,0,1,3,111,117
Augustine,2,1,1,3,11,18
Living Free in Tennessee - Nicole Sauce,1,1,1,0,30,33
The TWIML AI Podcast (formerly This Week in Machine Learning & Artificial Intelligence),1,0,1,4,63,69
Anesthesia and Critical Care Reviews and Commentary (ACCRAC) Podcast,1,0,0,0,49,50
That Classical Podcast,1,1,0,4,119,125
Tree Hill Talk - One Tree Hill Podcast,1,0,1,0,63,65
Mrs. Trimble's Tuck In - Bedtime Stories,1,0,3,5,41,50
Baalgatha : Bedtime Stories for Children,1,0,1,0,18,20
Cultivating Place,1,2,1,0,34,38
The Von Haessler Doctrine,4,4,2,2,50,62
Weather: Storm Front Freaks Podcast,0,0,1,2,12,15
Lakers Talk with Allen Sliwa,4,0,0,0,18,22
Who Knew's Quick and Dirty Household Tips and Lifehacks,0,1,4,0,12,17
Rope Drop Radio: A Disney Travel Planning Podcast,0,0,0,0,155,155
Vibrant Happy Women,0,0,0,0,50,50
Radiolab Presents: More Perfect,1,0,4,4,41,50
CyclingTips Podcast,16,5,7,3,102,133
The Matty Johns Podcast,6,2,5,11,75,99
Marijuana Today Daily,12,0,4,4,80,100
Cinephile with Adnan Virk,4,2,4,14,411,435
Presentable,0,0,0,0,7,7
The Chris Hogan Show,23,12,6,13,146,200
AWS TechChat,0,0,1,0,0,1
Black Girl In Om,0,0,1,1,48,50
Cinema Shock,0,0,0,0,13,13
Reading Women,0,0,0,1,52,53
Business Is Boring,0,1,0,0,9,10
The BBQ Beat Podcast,0,0,0,1,13,14
Dorking Out,1,1,0,3,29,34
Hair of the Dogcast,0,0,0,0,13,13
The Duke Basketball Podcast,0,0,1,0,42,43
The Homeschool Sisters Podcast,0,1,2,0,47,50
Motley Fool Money,5,3,5,7,62,82
Red FM Bauaa,1,0,0,2,15,18
A Music In Time,0,0,0,0,21,21
Betrayal Trauma Recovery,0,1,1,1,47,50
Battles of the First World War Podcast,1,0,2,2,45,50
Let's Know Things,1,1,2,1,45,50
Revisionist History,180,80,88,80,1244,1672
Team Never Quit,1,0,1,1,47,50
2000 Books for Ambitious Entrepreneurs - Author Interviews and Book Summaries,0,0,0,1,5,6
Near Perfect Pitch,0,0,0,0,2,2
The Animanicast- An Animaniacs Podcast,0,0,1,0,39,40
Precious Little Sleep Parenting Podcast,4,0,0,1,29,34
The Great Discontent,0,0,0,0,11,11
Be Here For A While,16,1,0,0,33,50
Peds in a Pod: A Pediatric Board Review,0,0,1,0,6,7
American Ninja Warrior RHAPup | Reality TV RHAPups,0,1,0,1,47,49
The Kibbe and Friends Show,2,1,0,1,46,50
Being Well with Dr. Rick Hanson,0,0,0,0,50,50
Rich On Tech,0,0,0,3,38,41
Counselor Toolbox Podcast,1,0,1,2,24,28
Windows Central Podcast,2,1,2,0,5,10
Go Time,2,0,0,0,7,9
Just Fly Performance Podcast,0,0,0,1,49,50
Writing for Children,1,2,0,8,92,103
The Nine Club With Chris Roberts,7,0,2,2,183,194
Within the Wires,2,0,2,9,37,50
Sinica Podcast,9,3,3,2,67,84
The Life Stylist,10,5,3,0,32,50
The Hangardeck Podcast,0,0,1,0,10,11
"Casual Preppers Podcast - Prepping, Survival, Entertainment.",2,5,3,3,144,157
Afternoonified,14,0,1,1,16,32
Transfert,0,0,0,2,22,24
Magic Hour,0,0,1,1,20,22
Hear Cincinnati,0,0,0,0,6,6
Blamo! | Exploring Fashion with the People Who Shape It,0,0,0,1,64,65
Young House Love Has A Podcast,8,3,5,5,179,200
Once Upon A Crime | True Crime,38,31,30,31,370,500
Classic BYU Speeches,0,0,3,0,15,18
The Art Of Living with Kathy Smith,1,0,0,1,48,50
AWS Podcast,1,1,1,1,1,5
Unsolved Murders: True Crime Stories,148,56,112,40,244,600
April Eight Songs & Stories,0,0,0,0,19,19
Northwest Jeepcast,1,0,1,0,48,50
Rose Pricks: A Bachelor Roast,47,12,10,12,266,347
Adoptees On,0,0,1,0,37,38
The Art History Babes,16,9,10,6,159,200
Invest Like a Boss,2,0,0,2,96,100
"Dear Prudence | Advice on relationships, sex, work, family, and life",7,13,3,3,24,50
Home Inspector Podcast,0,1,0,1,3,5
Generation Xbox - Your Home for Xbox Series X News and Opinions!,3,1,1,2,26,33
Unchained,7,7,7,7,94,122
UFC Unfiltered with Jim Norton and Matt Serra,49,27,33,29,362,500
Kill By Kill,0,0,1,0,65,66
The Roundtable,2,1,0,0,4,7
She Explores,0,3,4,6,156,169
The Sexually Liberated Woman,1,1,0,0,48,50
Office Hours with Spencer Rascoff,0,0,0,0,17,17
The Hunting Public,2,0,3,3,86,94
The Leadership Podcast,0,0,0,0,35,35
The Media Project,1,0,1,0,0,2
Eleanor Amplified,2,0,1,5,42,50
Politically Re-Active with W. Kamau Bell & Hari Kondabolu,9,7,8,5,471,500
Meditation x Attachment with George Haas,0,0,0,0,3,3
Encyclopedia Botanica,0,1,1,4,63,69
Mom & Mind for Pregnancy and Postpartum Mental Health,0,0,0,0,35,35
What You Will Learn,3,0,3,0,24,30
Elite Full Restore,0,0,0,0,4,4
The Community Cats Podcast,0,0,0,0,45,45
Guided Meditations,0,0,1,1,10,12
Side Hustle Pro,0,0,0,2,198,200
The Nature of Causation,0,0,0,0,2,2
"Terrible, Thanks For Asking",33,27,23,21,396,500
Bill O’Reilly’s No Spin News and Analysis,142,22,19,22,295,500
Locked On Bulls - Daily Podcast On The Chicago Bulls,11,3,5,7,109,135
Reggae Lover,0,0,0,0,12,12
This Week I Learned,2,2,0,2,32,38
Brute Force,0,0,1,2,47,50
"Sex Addiction, Pornography, and Sexual Purity -- Castimonia.org",0,0,0,0,8,8
Truth From The Stand Deer Hunting Podcast,3,2,1,2,54,62
The Fine Homebuilding Podcast,3,1,1,4,175,184
The Chase Jarvis LIVE Show,0,0,0,0,50,50
SharkFarmer Podcast/ agriculture farm,0,1,1,1,22,25
BirdCallsRadio,0,0,0,0,6,6
Conversations on Dance,1,0,0,0,35,36
The Crazy One,0,0,2,2,150,154
Sooo Many White Guys,19,1,0,1,29,50
Daily Tech Headlines,2,0,2,2,17,23
Christina The Channel,1,1,0,1,47,50
Glorious in the Mundane Podcast with Christy Nockels,0,0,2,4,245,251
Locked On Pelicans - Daily Podcast On The New Orleans Pelicans,4,3,2,2,88,99
#Killstream,10,0,1,4,35,50
The Meb Faber Show,1,1,1,4,193,200
Airways Podcast,1,1,1,10,35,48
Locked On Knicks - Daily Podcast On The New York Knicks,21,7,9,9,71,117
Locked On Thunder - Daily Podcast On The Oklahoma City Thunder,10,5,1,4,64,84
In The Circle,0,1,1,0,7,9
En La Jugada RCN,3,0,1,0,1,5
VeryPink Knits - Knitting Q and A,1,0,4,1,44,50
Low FODMAP Diet and IBS Podcast,0,0,0,0,4,4
MarsCorp,1,0,1,2,46,50
Commercial Drones FM,0,0,0,0,38,38
"Teach Me, Teacher",0,0,1,0,49,50
The Mastin Kipp Podcast ,1,1,1,2,43,48
Keepin It 100 with Konnan,18,7,10,10,241,286
Everyday Green Home,0,0,0,0,5,5
The Sneaker Podcast,2,0,0,2,9,13
The Bridge,1,5,5,5,34,50
The Brian Craig Show,13,0,0,0,16,29
Successful Nonprofits Podcast,0,0,1,2,27,30
The Stubborn Heroes: A D&D Podcast,0,0,1,0,10,11
Alright Mary: All Things RuPaul's Drag Race,7,12,12,6,212,249
Women In-Depth:  Conversations about the Inner Lives of Women,0,0,1,0,49,50
Saregama Carvaan Classic Retro Music,0,1,1,5,17,24
Ham Radio 2.0,2,0,0,1,1,4
Pitcher List Fantasy Baseball,5,1,6,6,204,222
Get Up in the Cool,0,0,0,0,40,40
breakup BOOST Relationship Advice,0,1,0,3,338,342
The Fried Egg Golf Podcast,6,0,4,4,106,120
APM Reports Documentaries,0,0,0,0,5,5
Locked On Spurs - Daily Podcast On The San Antonio Spurs,5,6,3,2,9,25
2-Bit Encryption - A Mr Robot Podcast,9,2,0,2,93,106
How To Go Vegan Podcast : A Comprehensive Resource for Those Interested in Becoming Vegan,0,0,0,0,1,1
eCommerce Uncensored - Email Marketing | Facebook Ads | Social Media Marketing,1,1,0,0,24,26
The Big Beard Theory,0,0,0,1,29,30
Brave Little State,1,0,1,0,26,28
Locked On Clippers - Daily Podcast On The LA Clippers,6,1,2,4,160,173
The Martin Garrix Show,1,0,0,0,20,21
America Adapts the Climate Change Podcast,1,1,4,0,29,35
Jim Cornette Experience,68,16,14,12,300,410
Eastern Lariat,1,0,1,0,6,8
Locked On Blazers – Daily Podcast On The Portland Trail Blazers,4,1,1,3,41,50
Sleep and Relax ASMR,10,2,3,6,41,62
Saturday Night Live (SNL) Afterparty,5,2,2,4,21,34
TrapDraw Podcast – No Laying Up,3,0,3,2,94,102
The Aware Show,0,0,0,0,3,3
Liberty Ballers: for Philadelphia 76ers fans,6,1,5,1,73,86
Health Via Modern Nutrition,1,0,0,3,45,49
Medical Medium Podcast,5,2,1,3,39,50
Teen Creeps,3,3,3,3,188,200
Marty & Sarah Love Wrestling,3,4,2,0,225,234
Next Question with Katie Couric,35,11,15,24,415,500
Bright Side of the Sun: for Phoenix Suns fans,2,0,1,0,11,14
The Test of Time,0,0,0,0,7,7
Pokemon Go Radio,2,0,1,0,47,50
Satsang with Mooji,0,0,0,0,20,20
A Scottish Podcast the Audio Drama Series,0,0,2,2,46,50
Happiness at Work,0,0,0,0,11,11
Bruce Lee Podcast,4,6,4,6,255,275
Mr Robot,1,4,0,4,40,49
A Rosary Companion,0,5,4,4,67,80
Learn English Through Listening,0,0,0,0,6,6
Locked On Nuggets - Daily Podcast On The Denver Nuggets,5,2,2,5,164,178
Locked On Bucks – Daily Podcast On The Milwaukee Bucks,1,2,2,9,116,130
Locked On Hawks - Daily Podcast On The Atlanta Hawks,2,0,2,3,70,77
Kame House Party - A Dragon Ball Comedy Podcast,1,0,0,0,27,28
The Cannabis Business Minds Show,3,0,0,0,26,29
The Tim Dillon Show,20,1,3,6,468,498
Ordinary Marathoner,0,0,0,0,8,8
More Cheese Less Whiskers,0,0,0,0,23,23
"InsideTheBoards for the USMLE, COMLEX & Medical School",0,0,0,0,50,50
Juicy Scoop with Heather McDonald,5,0,0,0,45,50
Locked On Rockets - Daily Podcast On The Houston Rockets,3,3,2,4,76,88
In Legal Terms,0,0,0,0,2,2
Everyday Tech,0,0,1,0,1,2
The Gestalt Gardener,0,0,0,0,3,3
Headshots: Psychology + Gaming,0,0,1,1,7,9
Clouded,1,0,1,1,26,29
Rex Rivetter: Private Eye,0,0,0,0,35,35
Bowjunky archery podcast,4,1,1,3,12,21
Locked On Cavs - Daily Podcast On The Cleveland Cavaliers,17,7,6,5,51,86
Optimal Health Daily,6,3,4,1,36,50
Everything I Learned From Movies,0,0,0,0,10,10
One Objective Bass Fishing,4,0,0,1,10,15
Tom Curran’s Patriots Talk Podcast,8,4,2,12,115,141
Nirankari Baba Ji Discourses,1,0,0,0,0,1
Voice Divine: The Internet Radio,0,0,0,0,3,3
Team Building Podcast,0,0,0,0,50,50
Locked On Dolphins - Daily Podcast On The Miami Dolphins,9,3,9,5,455,481
You've Got This | Tips & Strategies for Meaningful Productivity and Alignment in Work and Life,0,0,0,0,12,12
'Paul Or Nothing' Podcast,1,1,1,1,13,17
That Early Childhood Nerd,0,0,1,1,5,7
Adventure a Dungeons and Dragons Podcast,0,1,1,3,45,50
Ek Kahani Aisi Bhi,0,1,0,0,12,13
SuperMegaCast,0,1,1,2,46,50
Future of Agriculture,0,0,1,0,72,73
Beat Your Genes Podcast,3,4,0,2,45,54
Acquisitions Incorporated: The Series,0,0,0,0,15,15
Fish Stripes: for Miami Marlins fans,2,1,0,0,21,24
An Acquired Taste Podcast,12,6,7,6,469,500
The Christy Wright Show,4,5,6,6,197,218
Magic Lessons with Elizabeth Gilbert,3,1,1,1,141,147
Synth Zone,0,0,0,0,7,7
The Married At First Sight After Show Podcast,11,6,5,2,10,34
Art Biz Podcast,0,0,0,2,32,34
The Low Carb Hustle Podcast,0,0,0,0,50,50
"Marietta Stories | Crazy cool stories from the community builders of Marietta, Georgia",0,0,0,0,42,42
Fare of the Free Child,0,0,1,1,23,25
Marketing School - Digital Marketing and Online Marketing Tips,0,0,0,0,16,16
FantasyPros - Fantasy Football Podcast,11,5,9,22,453,500
AP Top 25 College Football Podcast,4,0,0,1,21,26
Go Trek Yourself,1,0,0,0,4,5
Trivia With Budds,1,1,0,0,48,50
Locked On Pistons - Daily Podcast On The Detroit Pistons,7,3,1,4,20,35
Business Security Weekly (Video),0,0,0,0,1,1
Something to Wrestle with Bruce Prichard,47,17,13,13,410,500
Tunnels,8,6,7,9,20,50
The Alien Adventures of Finn Caspian: Science Fiction for Kids,3,1,2,5,39,50
Locked On Raiders - Daily Podcast On The Las Vegas Raiders,10,6,1,5,73,95
Locked On Bucs – Daily Podcast On The Tampa Bay Buccaneers Fans,4,1,5,3,39,52
The Morbid Curiosity Podcast,2,3,3,0,42,50
Conversations on Health Care,1,0,0,0,1,2
Sales Influence - Why People Buy!,0,0,1,0,60,61
Locked On Eagles - Daily Podcast On The Philadelphia Eagles,4,1,3,3,78,89
Locked On NFL – Daily Podcast On The National Football League,11,4,7,12,145,179
"Piano Parent Podcast: helping teachers, parents, and students get the most of their piano lessons.",0,1,0,0,25,26
The Heart of Hospice,0,0,0,1,7,8
Amazing World of Radio,0,0,0,0,1,1
Dani Daniels Show,1,1,0,0,12,14
Buckeye Talk: Ohio State podcast by cleveland.com,34,13,14,24,407,492
Blade Licking Thieves,0,0,1,1,16,18
Your Last Meal with Rachel Belle,0,0,1,9,133,143
The MCAT Podcast,1,1,0,3,34,39
Soundtracking with Edith Bowman,0,2,1,3,63,69
Locked On Patriots - Daily Podcast On The New England Patriots,3,3,0,3,69,78
Locked On Lions - Daily Podcast On The Detroit Lions,23,6,7,5,91,132
Locked On Steelers – Daily Podcast On The Pittsburgh Steelers,6,3,3,1,161,174
Up and Vanished,136,116,124,88,256,720
Jack Slack Podcast,0,0,0,1,57,58
Poverty Research & Policy,0,0,0,0,1,1
Pleasing Terrors,4,0,2,3,315,324
Locked On Chiefs - Daily Podcast On The Kansas City Chiefs,5,11,11,21,214,262
The Lucky Letcord Podcast,0,0,0,0,3,3
The Creative Classroom with John Spencer,1,0,0,1,48,50
...These Are Their Stories: The Law & Order Podcast,30,14,15,13,137,209
The Fall of Rome Podcast,1,1,1,3,44,50
Locked On Bears - Daily Podcast On The Chicago Bears,17,6,3,5,60,91
Kilowatt: A Podcast about Tesla,1,1,0,1,6,9
TOTAL EM - Tools Of the Trade and Academic Learning in Emergency Medicine,0,0,1,0,13,14
Overeaters Anonymous of San Francisco,1,1,0,0,4,6
Redefining Strength Fitness Hacks,0,0,0,1,20,21
Career Talk: Learn - Grow - Thrive,2,1,0,1,55,59
The Panpsycast Philosophy Podcast,1,1,0,2,29,33
Fantasy Baseball Prospects at Razzball,2,1,0,0,26,29
MZANSI DEEP- Soulful & Deep House Sessions,0,0,0,0,6,6
"Goop Tales — An Engaging, Entertaining, and Educational Storytelling Podcast for Kids",4,0,1,2,43,50
THE SITH LIST,0,0,0,1,68,69
Dinosaur George Podcast - A Podcast Devoted to Paleontology and Natural Science,0,0,1,0,4,5
Varmints!,0,1,1,2,46,50
The Serial Killer Podcast,59,30,31,20,216,356
"Fastest 5 Minutes, The Podcast Government Contractors Can't Do Without",0,0,0,0,2,2
Just for Variety with Marc Malkin,12,1,3,2,6,24
Cincy Jungle: for Cincinnati Bengals fans,4,2,1,0,6,13
German Podcast,4,0,2,0,4,10
Cases and Controversies,1,0,0,0,3,4
The Greg Hill Show,107,4,5,1,18,135
ALL MARINE RADIO,0,0,1,0,9,10
ArtCurious Podcast,3,6,7,10,137,163
Perspective Podcast | Fuel for Your Mind & Creative Grind,0,0,0,1,144,145
Lama Yeshe Wisdom Archive,0,0,0,0,1,1
Dialed In - Some Obsession Required,3,2,0,0,34,39
Cape Up with Jonathan Capehart,0,0,0,0,50,50
Locked On 49ers - Daily Podcast On The San Francisco 49ers,2,2,3,7,151,165
Living Open | Modern Magick and Spirituality for Mystics and Seekers,1,0,0,0,51,52
WIRED Tech in Two,4,3,3,4,4,18
"WIRED Business: Startups, Cryptocurrency, Tech Culture, and More",0,1,0,0,1,2
Cool Kids Table,1,0,0,2,24,27
Dissect,0,0,0,0,50,50
Embodied Astrology with Renee Sills,7,1,2,0,74,84
Putting Racism on the Table Podcast Series,0,0,0,0,2,2
Shared Practices | Your Dental Roadmap to Practice Ownership | Custom Made for the New Dentist,0,0,0,0,50,50
Court Junkie,15,23,17,22,423,500
Locked On Fantasy Football – Daily NFL Fantasy Football Podcast,3,3,4,2,19,31
Locked On Vikings - Daily Podcast On The Minnesota Vikings,5,1,3,7,49,65
Locked On Washington Football Team,8,1,4,2,17,32
"Malcolm Gladwell, Revisionist History: Special Event",11,4,3,10,282,310
The Maximum Lawyer Podcast,0,0,0,0,50,50
Locked On Packers - Daily Podcast On The Green Bay Packers,23,9,7,7,281,327
Gartner ThinkCast,0,1,1,1,13,16
VoicerFM,0,0,0,0,8,8
Locked On Giants - Daily Podcast On The New York Giants,10,8,8,9,55,90
Shat the Movies: 80's & 90's Best Film Review,23,9,12,11,255,310
Snapped: Women Who Murder,7,2,2,8,18,37
Wisdom Inspired Life,0,0,0,0,1,1
Creator Lab - interviews with entrepreneurs and startup founders,0,0,0,0,70,70
"Mysterious Radio: Paranormal, UFO & Lore Interviews",87,27,21,14,351,500
Rebank: Banking the Future,0,0,0,0,19,19
Locked On Bills - Daily Podcast On The Buffalo Bills,3,3,3,5,181,195
The Final Straw Radio,2,0,0,0,9,11
Heinemann Podcast,1,2,0,0,18,21
Dynasty Leadership Podcast,0,0,0,1,0,1
Accused,38,49,44,47,322,500
The Absolute Strength Podcast,0,0,1,1,48,50
Swinger Diaries,2,0,0,2,46,50
Imagined Landscapes Podcast,0,0,0,0,17,17
The Howie Games,5,4,1,13,112,135
Hillbilly Horror Stories,15,9,8,6,462,500
Locked On Broncos - Daily Podcast On The Denver Broncos,2,2,4,0,131,139
Naruhodo,0,0,0,0,24,24
Superhero Ethics,1,0,0,2,26,29
The Overlook Hour Podcast,0,0,0,0,6,6
Canary Cry News Talk,1,0,1,0,152,154
Therapist Uncensored Podcast,1,1,2,5,106,115
Opening Arguments,13,10,4,10,377,414
The Sustainability Agenda,0,0,1,0,1,2
About Buildings + Cities,2,0,1,1,41,45
Locked On Falcons - Daily Podcast On The Atlanta Falcons,5,6,1,4,81,97
Wharton Business Daily,3,0,0,1,3,7
IGN Game Reviews,2,2,1,0,6,11
IGN Movie Reviews,0,0,0,0,1,1
Podcast en Spanish (PES) - Learn Spanish as a Second Language,1,0,1,1,24,27
Sirenicide,3,6,3,5,33,50
Set For Life,0,0,0,0,2,2
Warriors Plus Minus: A show about the Golden State Warriors,3,1,2,3,42,51
The BEMA Podcast,2,0,0,1,100,103
In the Dark,60,22,44,12,520,658
Almost 30,72,12,10,11,395,500
RuPaul's Drag Race Season 13 Rucaps,16,7,5,2,36,66
French Blabla,0,0,0,0,13,13
Bat Flips And Nerds,0,0,0,0,3,3
The Ryback Show,32,10,9,8,357,416
"Your Parenting Mojo - Respectful, research-based parenting ideas to help kids thrive",1,1,2,1,45,50
The Tony Kornheiser Show,72,26,36,21,345,500
American Banker Podcast,2,0,0,0,3,5
"Secrets, Crimes & Audiotape",3,4,0,2,41,50
The Bourbon Show,1,2,2,2,70,77
Locked On Rams - Daily Podcast On The Los Angeles Rams,2,1,1,2,86,92
Popcorn with Peter Travers,0,0,0,0,9,9
Locked On Jets - Daily Podcast On The New York Jets,6,5,3,8,88,110
Children and Adults with ADHD (CHADD),1,1,1,0,3,6
The Career Change Maker Podcast,0,0,0,0,9,9
Locked On Jaguars - Daily Podcast On The Jacksonville Jaguars,7,3,1,2,33,46
On The Trail With Kevin and Scott,0,0,0,0,39,39
Grow Your Video Business,0,0,1,0,49,50
CockTales: Dirty Discussions,1,2,3,4,40,50
Chicken Dinner,0,0,0,0,38,38
The Retro Cinema Podcast,0,0,0,0,24,24
The Nourished Child,0,0,1,0,20,21
Locked On Browns - Daily Podcast On The Cleveland Browns,6,3,4,4,33,50
Paul's Security Weekly (Podcast-Only),0,0,0,0,1,1
Skip and Shannon: Undisputed,138,40,50,42,230,500
Something You Should Know,3,1,0,0,46,50
Behind the Mic with Greg Wrubell,0,0,0,0,12,12
The Wilderness Podcast: An OldSchool RuneScape Show,1,0,0,1,20,22
The Editors,10,2,2,4,32,50
Buffering the Vampire Slayer | A Buffy the Vampire Slayer Podcast,12,9,15,14,340,390
How I Built This with Guy Raz,105,21,84,84,1456,1750
Baseball Dads Podcast,0,0,0,0,52,52
JayhawkSlant,0,0,0,1,7,8
Heavyweight,14,5,7,8,466,500
Modern Audio Drama,0,0,0,0,9,9
Simply Convivial: Pep Talks for Homemakers & Homeschoolers,0,1,0,3,42,46
The Communication Guys Podcast: Communication Excellence | Professional and Personal Success,0,1,0,1,40,42
The Peter King Podcast,16,11,7,8,69,111
The Albert Breer Show,9,10,4,7,44,74
L'heure bleue,0,0,1,0,2,3
The Ob/Gyn Podcast,0,0,1,0,6,7
Locked On Titans - Daily Podcast On The Tennessee Titans,2,3,3,1,76,85
"Locked On NFL Draft - Daily Podcast On The NFL Draft, College Football & The NFL",39,9,16,14,236,314
Still Processing,21,14,10,18,437,500
Locked On Cowboys - Daily Podcast On The Dallas Cowboys,4,3,5,1,65,78
Why Not Now? with Amy Jo Martin,1,0,0,16,155,172
Locked On Chargers - Daily Podcast On The Los Angeles Chargers,7,3,4,1,20,35
Career Warrior Podcast,0,1,0,0,14,15
Locked On Seahawks - Daily Podcast On The Seattle Seahawks,10,3,1,3,62,79
ReWilding for Women,0,3,2,0,26,31
The Jewish History Podcast - With Rabbi Yaakov Wolbe,4,0,1,2,41,48
Wrongful Conviction Podcasts,34,7,16,14,429,500
ATS.io Sports Betting & Handicapping Podcast,4,4,2,3,18,31
Small Farm Nation,0,0,0,4,73,77
Zero Blog Thirty,7,1,0,0,42,50
Disability After Dark,1,0,1,0,48,50
Philosophy For Our Times,1,2,0,1,9,13
Washington Football Talk,15,4,13,21,447,500
Husker247 Podcast,1,0,2,1,31,35
"My Creative Corner3- quilting, crafts and creativity",0,0,0,2,12,14
Darkness Prevails Podcast | TRUE Horror Stories,13,3,6,16,398,436
The Queen Sugar Podcast,0,0,0,0,4,4
JoshCast,0,0,0,0,2,2
Secrets & Spies: The Dry CleanerCast,0,0,1,0,5,6
I'm Too Effing High,0,1,1,0,19,21
Where Cures Begin - Salk Institute,0,0,0,0,5,5
The Powell Movement Action Sports Podcast,0,1,2,2,91,96
numberFire Daily Fantasy Podcasts,2,0,1,2,138,143
FUTURE FOSSILS,0,0,0,1,60,61
The Thoughtful Counselor,0,0,1,2,12,15
Fulhamish,0,0,0,0,28,28
Locked On Wolves - Daily Podcast On The Minnesota Timberwolves,13,4,3,0,13,33
1st Talk Compliance,0,0,0,0,3,3
Doing It At Home,0,1,0,0,49,50
The Fertility Warriors,0,0,0,0,30,30
Crazy Sh*t In Real Estate with Leigh Brown,0,0,0,0,32,32
The Actor CEO Podcast: Acting Business | Interviews | Motivation,0,0,2,0,28,30
Locked On Ravens - Daily Podcast On The Baltimore Ravens,5,2,2,2,16,27
49ers Talk with Matt Maiocco and Laura Britt,3,2,7,4,59,75
Energy Matters,1,0,0,2,45,48
EmPowered Couples with The Freemans,0,0,0,1,101,102
Unexceptional Moms,0,0,0,2,18,20
Kinda Dating,3,6,8,1,101,119
Under Center Podcast,33,7,8,4,59,111
The Next Pats Podcast - A Patriots Podcast,0,1,1,4,118,124
Locked On Mavericks - Daily Podcast On The Dallas Mavs,6,2,2,4,249,263
Danger Dan's Talk Shop,0,1,0,0,15,16
The Studleys,13,10,5,10,311,349
Saints Talk presented by NewOrleans.Football,0,0,2,1,42,45
The Sales Development Podcast,0,0,0,0,9,9
Locked On Warriors – Daily Podcast On The Golden State Warriors,14,10,9,7,56,96
OCCULTURE,0,0,0,0,30,30
Invest Like the Best,3,1,1,1,181,187
"Connecting with Walt - A look into the history of the man behind Mickey Mouse, Disneyland and Walt D...",5,5,4,5,88,107
Pokemon World Tour: United,0,1,0,3,46,50
She Creates Business,0,0,1,1,64,66
Private Parts Unknown (FKA Reality Bytes),1,0,1,0,48,50
Directing Magic Podcast,0,0,0,1,5,6
Law School Insider,0,0,1,0,2,3
Reality Life with Kate Casey,43,9,16,8,424,500
All About Agatha (Christie),5,6,6,17,121,155
Dead Pilots Society,7,3,8,12,68,98
The United States of Anxiety,17,4,1,13,130,165
Rush Limbaugh Morning Update,13,0,0,0,37,50
Locked On Kings - Daily Podcast On The Sacramento Kings,10,5,3,4,67,89
Bedtime History,0,0,0,6,44,50
The Unofficial NCLEX® Prep Podcast by NURSING.com (NRSNG),1,0,0,1,5,7
The Reason Roundtable,7,5,5,5,28,50
Photog Adventures Podcast: A Landscape Photography and Astrophotography Podcast,1,0,3,1,41,46
Exoplanetary,0,0,0,1,14,15
SonexFlight,0,0,0,0,5,5
They Walk Among Us - UK True Crime,25,37,38,41,359,500
Mongabay Newscast,0,0,0,1,5,6
The Orphans,1,1,0,4,34,40
Hit The Streets with Valerie Jardin,0,0,0,0,4,4
Dobber Prospects Radio,0,0,0,0,8,8
Todd White (Lifestyle Christianity Church),7,2,4,0,96,109
Hangar Talk - An Aviation Podcast,2,1,0,0,6,9
Healing Broken Trust In Your Marriage After Infidelity,2,2,2,3,41,50
The Miracle Morning for Network Marketers Podcast,0,0,0,0,4,4
Timesuck with Dan Cummins,0,2,1,0,47,50
Disrupt Yourself Podcast with Whitney Johnson,0,0,2,5,78,85
Emergency Medicine Board Review,1,1,0,0,13,15
Keep Calm and Homeschool On,0,0,1,0,44,45
The Chuck ToddCast: Meet the Press,61,32,50,43,162,348
Cold Call,0,0,0,3,6,9
Hysteria 51,22,8,8,9,302,349
The Pemberley Podcast,0,0,0,0,12,12
The Propaganda Report,6,0,2,2,40,50
The Dildorks,0,1,1,3,35,40
This Is Us After Show Podcast,3,3,7,6,6,25
One Year No Beer | Hack your healthy Lifestyle,1,0,1,0,21,23
The X-Cast - An X-Files Podcast,0,0,0,1,15,16
Parent Footprint with Dr. Dan,1,0,0,0,9,10
The Overlanding Podcast,0,0,0,0,4,4
Mark and Me Podcast,1,0,0,0,4,5
ABN-Nava Jeevana Vedam,0,0,0,0,3,3
The Grape Nation,7,1,7,3,8,26
Mighty Blue On The Appalachian Trail: The Ultimate Mid-Life Crisis,0,0,0,1,151,152
Stars on Suspense (Old Time Radio),1,0,0,0,22,23
CBS This Morning,1,4,4,6,35,50
True Geordie Podcast,13,6,6,13,461,499
Wildland Fire Lessons Learned Center,0,0,0,0,8,8
AdExchanger,0,0,1,0,6,7
Qur'an Tafsir: Understanding the Word of Allah with Shaykh Faid Mohammed Said,0,0,0,0,1,1
The Unexplainable Disappearance of Mars Patel,3,0,2,8,36,49
Investigating Breast Cancer,0,0,1,0,7,8
The Art of Living Big | Subconscious | NLP | Manifestation | Mindset,0,0,1,1,50,52
Las Raras,0,0,0,0,17,17
SPINES Podcast,3,2,1,6,77,89
The Podfathers,6,2,1,2,39,50
The Orbiting Human Circus,3,5,0,1,41,50
Medic Mindset,0,0,0,0,50,50
Christopher Kimball’s Milk Street Radio,8,5,12,15,89,129
microTalk,0,0,0,0,3,3
Locked On 76ers - Daily Podcast On The Philadelphia Sixers,40,4,4,5,14,67
Catholic School Matters,0,0,0,0,13,13
The Successful Bookkeeper Podcast,0,0,0,0,19,19
The Leader's Panel,1,0,0,4,25,30
Raising Daughters,0,0,0,1,12,13
Waypoint Radio,10,1,3,1,35,50
Brady Heywood Podcast,0,0,1,0,15,16
Save Your Marriage Podcast - Nicola Beer,1,0,0,1,43,45
Locked On Nets - Daily Podcast On The Brooklyn Nets,7,1,1,0,33,42
Minimalist Moms Podcast,2,0,4,1,43,50
8 Bit Book Club,1,0,0,1,188,190
"Dating Tips, Relationships & Dating Advice For Single Women Podcast | Magnetize Your Man",0,0,0,0,5,5
Noisy Neighbors Podcast,0,0,0,0,51,51
Locked On Bengals - Daily Podcast On The Cincinnati Bengals,7,5,7,2,91,112
SUCCESS Talks,1,0,1,3,26,31
Sheologians,55,17,21,14,380,487
Always Open,1,2,1,3,43,50
Start Me Up with Kimberley A. Johnson,1,1,2,0,49,53
Destiny Community Podcast,9,8,6,3,24,50
Mabel,1,0,3,3,22,29
Locked On Pacers - Daily Podcast On The Indiana Pacers,4,0,2,8,25,39
Healing Hormones,0,0,0,0,29,29
The Explorers Podcast,1,1,0,2,46,50
Venture Maidens | A Dungeons and Dragons Podcast,0,0,2,0,48,50
Genius Network,0,0,0,0,39,39
Science Adventure Stories For Kids,1,0,5,5,22,33
Female Strength Academy,0,0,0,2,13,15
The Money Nerds,0,0,0,0,32,32
BROKE GIRL THERAPY,0,0,0,0,32,32
Apes Among Us,1,0,1,3,18,23
The Lonely Hour,0,0,1,3,41,45
Point Mystic,0,0,0,3,47,50
The Classical Homeschool,0,1,1,1,11,14
Vinyl-O-Matic,0,0,0,0,1,1
Unpopular Culture,2,2,2,2,101,109
OFFSHORE,2,3,0,6,67,78
Southern Gardening Podcast,0,0,0,0,3,3
The Final Four Is Not On The Schedule - A Michigan State Basketball Podcast.,0,0,0,1,24,25
Tap into The Power of Your Mind using Law of Attraction and Hypnosis Techniques,0,1,0,1,16,18
Foundering,11,3,4,10,127,155
"Girl Get Visible Podcast: SEO Traffic, Marketing, and Business",0,0,0,0,32,32
Bulls Talk Podcast,10,4,5,6,25,50
White Sox Talk Podcast,4,2,2,2,31,41
The Passionate Few,0,0,0,0,50,50
Making Gay History | LGBTQ Oral Histories from the Archive,1,0,1,1,47,50
Chemistry in its element,0,0,0,2,13,15
Chemistry World Podcast,0,0,0,0,1,1
Cubs Talk Podcast,12,8,9,6,17,52
EW’s BINGE,6,2,9,7,43,67
The Quote of the Day Show | Daily Motivational Talks,1,1,0,1,47,50
Your Family Dog Podcast,0,0,0,0,2,2
Undermine,2,4,6,10,419,441
"Building the Future: Freedom, Prosperity, and Foreign Policy with Dan Runde",0,0,2,0,1,3
Unshakable Self-Confidence,0,0,0,1,32,33
Where Accountants Go - The Accounting Careers Podcast,0,0,0,0,9,9
Muses,5,3,0,1,20,29
Days of Future Cast,0,0,0,0,46,46
Historical Blindness,13,3,2,0,32,50
Destiny Down Under Podcast,1,1,0,0,10,12
Podcast Italiano,0,0,0,0,50,50
FUT Weekly Podcast,1,1,1,0,21,24
"213Hoops: The Lob, The Jam, The Podcast",2,0,1,1,7,11
Spooky Boo's Scary Story Time,12,1,6,3,28,50
Darkest Night,5,13,3,9,20,50
"Spirit, Purpose & Energy",5,4,3,3,129,144
RNZ: Black Sheep,1,0,1,0,71,73
The Joy of Procrastination,0,0,0,0,6,6
The Parsha Podcast - With Rabbi Yaakov Wolbe,0,0,0,0,13,13
TORAH 101 - With Rabbi Yaakov Wolbe,0,0,0,0,8,8
Read It On Reddit,1,1,0,0,29,31
Rockin' the Suburbs,0,0,0,1,49,50
Locked On Suns - Daily Podcast On The Phoenix Suns,5,2,5,5,32,49
Chilling Tales for Dark Nights: A Horror Anthology and Scary Stories Series Podcast,0,6,4,3,37,50
GeriPal,0,0,0,2,5,7
What If World - Stories for Kids,1,1,0,2,46,50
The Past and The Curious: A History Podcast for Kids and Families,1,0,1,2,46,50
The Grade Cricketer,1,0,1,0,4,6
Vet School Unleashed: Dissecting the DVM - Talking About All Things Veterinary School,0,0,0,0,15,15
Insecuritea: The Insecure Aftershow,2,3,9,9,235,258
Lost in America,2,0,1,0,43,46
The Pastors Round Table,0,0,0,1,0,1
Speak L.A.,0,0,0,0,37,37
Data Crunch,0,0,0,0,11,11
Broad Street Hockey: for Philadelphia Flyers fans,9,6,7,8,131,161
Our Vantage Point - Retro Wrestling Podcast,4,0,0,2,104,110
If That Ain't Country,2,0,0,1,9,12
Capitol Crude: The US Oil Policy Podcast,1,1,0,2,3,7
Crash The Pond: An Anaheim Ducks Podcast,0,1,1,2,78,82
HUB History - Our Favorite Stories from Boston History,0,1,2,0,19,22
"The Privacy, Security, & OSINT Show",0,0,1,1,65,67
Quran for our times - Bengali,0,0,0,0,1,1
National Trust Podcast,0,0,0,0,2,2
The SelfWork Podcast,0,0,1,0,49,50
Cannabis Health Radio Podcast,0,0,0,0,19,19
Sex With Dr. Jess,0,0,0,2,16,18
Missing & Murdered: Finding Cleo,25,21,38,26,390,500
Live Inspired Podcast with John O'Leary,0,0,0,0,118,118
Rapidly Rotating Records,0,0,0,0,1,1
Mickstape,25,5,5,5,460,500
The Casey Crew,1,3,1,5,40,50
The Peer Pleasure Podcast,0,1,1,0,62,64
The Redrum Theatre,0,0,0,0,19,19
Geaux247 Podcast,0,1,0,1,20,22
Blackhawks Talk Podcast,0,1,2,1,33,37
The Scouted Football Podcast,0,0,0,0,3,3
Michigan's Big Show,1,0,0,0,0,1
Live from Here Highlights,7,2,2,1,4,16
The Jewish Story,0,1,0,0,8,9
NostalgiaCast,1,0,0,0,8,9
The Tailored Life Podcast,0,0,0,1,49,50
Nature Guys,0,0,1,0,51,52
Dream Big Podcast,6,0,5,3,36,50
Dark Tome,24,4,5,2,15,50
Two Minute Stories,0,0,0,0,1,1
Broadway Backstory,0,0,0,1,97,98
Four Orbs - A D&D Podcast,0,0,0,0,50,50
Sales Success Stories,0,0,0,0,41,41
College Admissions with Mark and Anna,0,0,0,0,3,3
Fan Service,0,0,0,1,19,20
Unnamed Automotive Podcast,2,0,1,1,9,13
Real Peace. Real People.,0,0,0,0,4,4
Wine Enthusiast Podcast,1,1,1,7,5,15
TMV Podcast,0,0,0,0,7,7
How to Decorate,10,14,11,16,126,177
Finding Genius Podcast,0,0,0,0,50,50
The Balanced Blonde // Soul On Fire,0,0,0,1,49,50
Gators Breakdown,2,0,1,5,87,95
FT Tech Tonic,1,1,1,0,2,5
The Film Scene with Illeana Douglas,0,2,2,0,19,23
Deep Color,0,0,0,0,5,5
Let Me Tell You About...,0,1,1,1,29,32
Blogging the Boys: for Dallas Cowboys fans,5,1,1,6,36,49
The Keto Savage Podcast,2,2,1,1,44,50
What Fresh Hell: Laughing in the Face of Motherhood,0,0,0,0,50,50
Social Media and Politics,0,0,0,0,14,14
Shaping Fire,0,0,0,1,29,30
Indications,0,0,0,0,3,3
Chasing Excellence,5,0,0,2,43,50
The Healthy Gut,0,0,0,1,19,20
Kuldrin's Krypt A BDSM 101 Podcast,0,0,0,0,8,8
The Strength Running Podcast,5,2,3,8,198,216
Homecoming,24,23,38,49,366,500
Crimetown,49,15,16,13,407,500
The Lovecraft Tapes | Actual-Play Call Of Cthulhu Podcast,1,0,1,1,24,27
The Kyle Thiermann Show,1,1,1,0,89,92
TakeTen4Torah Daily Torah Podcast,0,0,0,0,3,3
Nintendo Nostalgia,0,0,0,0,16,16
Feeling Good Podcast | TEAM-CBT - The New Mood Therapy,1,1,3,2,43,50
Making,6,5,8,9,369,397
Homeschool Unrefined,2,2,0,0,46,50
Twenty Thousand Hertz,1,2,0,3,44,50
Borne the Battle,1,0,0,0,49,50
NFL: Good Morning Football,5,4,4,3,20,36
The SwitchCast - A Nintendo Switch Podcast,8,0,2,3,163,176
Landscape Business Course,3,0,0,2,23,28
RecTech: the Recruiting Technology Podcast,0,0,1,0,3,4
Smart Mouth,1,1,3,1,39,45
Physics Frontiers,1,1,1,0,7,10
Specialty Stories,0,0,0,0,19,19
Quid Pro Quo,0,0,1,0,14,15
Fantasy NBA Today Fantasy Basketball,2,4,3,8,252,269
Prepping Academy,4,5,2,0,5,16
"Going Beyond the Food: Diet Culture, Intuitive Eating, Body Acceptance, Mindset and Anti-Diet Podcas...",0,0,1,0,49,50
Exponential View with Azeem Azhar,0,1,1,1,77,80
Inside Strategic Coach: Connecting Entrepreneurs With What Really Matters,0,0,0,0,16,16
The Welsh Rugby Podcast,0,0,0,1,2,3
Sustainable Winegrowing with Vineyard Team,0,0,0,0,6,6
DEMENTES,0,0,1,0,7,8
Bay Curious,1,1,3,3,128,136
The President's Inbox,4,2,1,6,37,50
PUT IT IN THE AIR PODCAST,1,0,0,0,2,3
CrowdScience,0,1,0,2,20,23
Biscuits: A Hockey Podcast,1,0,1,0,135,137
Preheated Baking Podcast,0,0,0,0,2,2
Prospect One,2,0,1,2,43,48
Crit Academy: A Dungeons and Dragons Podcast,0,1,3,4,36,44
The Party in My Plants Podcast,1,4,1,0,44,50
About Progress,1,1,0,1,47,50
"Calm Pills - Soothing Space Ambient and Piano Music for Relaxing, Peaceful Sleep, Reading or Mindful...",1,1,0,0,14,16
Air Buds,0,1,0,0,121,122
The Undifferentiated Medical Student,2,0,0,2,46,50
Charmed Life with Tricia Carr,1,0,0,1,14,16
Super Woman Wellness by Dr. Taz,0,2,1,7,40,50
The Baking Podcast,4,3,4,2,20,33
Wheel Bearings,2,1,1,2,41,47
Silent Sales Machine Radio,5,0,1,3,191,200
Fightful | Pro Wrestling & MMA Podcast,8,2,0,2,61,73
"B2B Revenue Leadership - CEO, CRO, CMO, VC, Sales and Marketing Startup SaaS",1,0,1,1,42,45
Destroy The Hairdresser,0,0,0,0,13,13
Not Another Anxiety Show,3,1,0,3,43,50
Terms,3,1,1,2,43,50
"Marriage, Kids and Money",0,0,1,1,98,100
Inside Mental Health: A Psych Central Podcast,3,1,3,1,39,47
The Dungeoncast,0,1,1,1,47,50
Videogame Dads Podcast,1,0,1,4,66,72
"Menopause Guide Podcast, with RhondaNP",0,1,0,4,14,19
Crushing Iron Triathlon Podcast,2,1,2,0,45,50
Bigfoot Eyewitness Radio,8,5,6,5,39,63
GamesBeat Decides,0,0,0,0,4,4
"Uncanny Japan - Japanese Folklore, Folktales, Myths and Language",0,0,0,0,50,50
Rachel Watches Star Trek,0,0,1,1,54,56
Grandpa's Memory Box: Remembering the Armed Forces in the World Wars,0,0,0,0,1,1
This Week in Virology,1,0,0,1,4,6
Matt and Shane's Secret Podcast,0,0,0,0,50,50
Trackwrestling Podcast,0,0,0,0,3,3
Harry Potter Book Club,3,2,0,2,22,29
The Parrothead Podcast: All Things Jimmy Buffett,3,0,0,1,20,24
Portuguese Lab Podcast | Learn European Portuguese,0,0,0,0,9,9
The Clever Girls Know Podcast,0,1,4,6,64,75
Data Science Storytime,0,1,0,0,2,3
The Angie Lee Show - Ready is A Lie,3,0,1,0,196,200
The Brain Warrior's Way Podcast,3,4,4,1,38,50
Stress Free Naturally Guided Meditations,2,1,0,1,46,50
Mama Bear Apologetics,2,0,0,0,29,31
Griefcast,3,8,6,14,278,309
The Rough House Podcast 3.0,0,0,0,0,10,10
The Goal Digger Podcast,30,5,6,0,159,200
The Orpheus Protocol,0,0,0,0,50,50
Morning LineUp,5,5,4,2,31,47
Pure Dog Talk,0,0,0,0,50,50
Iron Lords Podcast,0,0,0,0,14,14
Small Biz 101 Podcast,0,0,0,0,5,5
Cyber Security Interviews,0,1,1,0,24,26
Buzz Beat: A Charlotte Hornets Pod,0,0,0,1,50,51
True Crime All The Time,55,27,14,13,391,500
Stray Casts Outdoor Cartoon Television Bass Fishing Talk Show,1,3,2,1,30,37
Gilmore Girls: A Year In The Life Reviews and After Show - AfterBuzz TV,1,0,1,0,0,2
Optimal StartUp Daily,1,0,1,1,47,50
The Gun For Hire Radio Broadcast,0,0,1,0,73,74
The Bechdel Cast,28,28,28,25,334,443
Israel Show,1,0,0,0,1,2
How Friends Roll | a Dungeons and Dragons 5th edition actual play DnD 5e podcast,2,0,0,0,48,50
The Sportsman Drag Racing Podcast w/ Luke & Jed,0,0,0,2,23,25
Fit Friends Happy Hour,0,0,0,0,16,16
Nordic Nation,1,2,0,0,3,6
Revive Our Hearts,0,0,0,1,43,44
NCIA Cannabis Industry Voice,0,1,0,0,4,5
THE ED MYLETT SHOW,4,1,1,5,189,200
Hypnotize Me with Dr. Elizabeth Bonet,0,0,0,1,39,40
Dumb Gay Politics,5,4,8,8,475,500
Make Me Smart with Kai and Molly,61,27,23,24,365,500
The Hilarious World of Depression,1,0,0,3,46,50
Tiger Basketball Podcast,0,0,1,2,2,5
Veterinary Viewfinder Podcast,0,0,0,1,19,20
Microsoft Mechanics Podcast,0,0,1,0,0,1
Commission: Impossible,0,0,0,0,29,29
Worst Foot Forward,0,0,0,0,12,12
Satsang with Shambhavi,1,0,0,1,24,26
LGBTQ Stories,2,0,1,0,24,27
Parkflyer Podcast,0,0,0,0,5,5
The Smoking Hot Confessions BBQ Podcast,0,0,0,0,1,1
Shell Fischer's Podcast,0,0,0,0,9,9
The Black Dahlia Serial Killers,32,36,51,35,211,365
Dubs Talk: A Golden State Warriors Podcast,2,5,1,3,9,20
Ostium Podcast,5,13,4,7,21,50
UK True Crime Podcast,29,16,14,15,148,222
Monster Of The Week: A Supernatural Podcast,1,0,0,1,64,66
Reality Steve Podcast,95,19,30,21,335,500
Fanachu! Podcast,0,0,0,0,3,3
Psych Rewind,3,1,0,3,8,15
Wild Ideas Worth Living,4,3,3,3,260,273
Baseball by the Book,2,2,2,5,259,270
Show Your Work,7,5,8,5,17,42
Nutrition Facts with Dr. Greger,2,2,1,3,42,50
LadyBrains,17,2,1,2,145,167
Fashion No Filter,0,0,3,2,10,15
Doorway To Mexico | Learn Spanish with Intermediate and Advanced Conversations,0,0,0,1,18,19
The Jordan B. Peterson Podcast,336,70,77,154,2702,3339
Alias Rewind,0,1,0,1,3,5
Black Girl Podcast,13,3,4,10,114,144
Social Media Secrets with Rachel Pedersen - The Queen of Social Media,0,0,0,1,49,50
The Science of Christmas: How Santa Delivers Presents,0,0,0,0,1,1
American Gods,6,1,2,3,35,47
Westside Fairytales: Horror and Dark Fiction Stories,1,0,2,0,47,50
Brain over Binge Podcast,2,6,2,1,38,49
State Secrets,0,0,0,0,3,3
Perpetual Chess Podcast,0,0,0,1,49,50
Darkness Radio,3,2,1,0,44,50
Bravo TV's The Daily Dish,49,19,23,16,119,226
Tarot Bytes,0,0,1,2,157,160
Judo Chop Suey Podcast,1,0,0,0,10,11
Famous at Home,1,0,1,1,47,50
The Bourbon Daily,4,3,3,0,64,74
LOVE SOMEONE with Delilah,0,0,2,2,26,30
"Studio 78: Branding, Productivity, & Business Tips for Female Creative Entrepreneurs",0,0,0,0,40,40
Russian Made Easy: Learn Russian Quickly and Easily,0,0,1,1,15,17
The Official Podcast,2,1,0,2,44,49
H3 Podcast,140,40,62,26,732,1000
Board Game Design Lab,0,0,0,2,32,34
The Mason Jar,0,0,0,2,18,20
The Hollywood in Toto Podcast,0,0,1,2,21,24
The AI Podcast,0,0,0,4,21,25
Gov Actually,0,0,0,0,6,6
American Birding Podcast,0,4,1,1,52,58
The Strategy Hour Podcast: Online Business | Blogging | Productivity - with Think Creative Collectiv...,0,0,0,0,24,24
Overland Bound,0,0,1,0,9,10
Laker Film Room - Dedicated to the Study of Lakers Basketball,7,2,3,2,176,190
Dumb People Town,7,6,3,5,29,50
nowyouknow's podcast,1,2,1,1,27,32
JoJo's Bizarre Podcast,0,1,1,0,31,33
Salon Owners Collective,0,0,0,0,8,8
Sailing Stories,2,1,2,1,67,73
"Easy Paleo, Gluten & Dairy Free Cooking",0,0,0,0,15,15
FieldCraft Survival,6,3,2,2,351,364
Deck the Halls (with Matrimony!),0,1,1,0,37,39
Blessed + Bossed Up,0,0,4,4,192,200
ChooseFI,17,10,13,8,152,200
FOAMfrat Podcast,1,0,0,0,32,33
"The Millennial Homemakers™: Interior Decorating, Hostessing, Homemaking, & Lifestyle Tips",2,0,1,2,14,19
Level Up - From Agent to Entrepreneur,0,0,0,1,33,34
Accounting Today Podcast,1,1,1,0,2,5
MadPx: A Brief History of Power,0,0,0,0,21,21
Side Hustle School,15,5,3,5,172,200
Radical Candor,2,2,5,7,161,177
This Week In The Garden with Peter Seabrook,0,1,0,0,2,3
1A,76,39,46,64,275,500
Debrief,0,1,0,1,1,3
Out There With the Birds,0,0,0,0,5,5
I Don't Get It,100,32,36,34,298,500
AFTV | All Gunz Blazing Podcast,5,1,0,0,8,14
The Paul McGuire Report,1,0,1,1,3,6
This Week in the BIG EAST - Weekly Overview of NCAA College Basketball's Top Conference,0,0,0,0,11,11
Late Night Linux,2,1,0,0,16,19
Eat Sleep Work Repeat,2,0,0,0,10,12
Fatima Barkatulla,0,0,0,0,3,3
The Adam Schefter Podcast,16,4,4,8,44,76
College Sports Now,0,0,0,1,9,10
Hi-Phi Nation,3,1,1,0,89,94
Financial Advisor Success,1,0,1,1,71,74
Wrong Station,3,1,1,2,39,46
Story Matters,0,0,0,0,50,50
Football Social Daily,0,0,1,1,32,34
The Seen and the Unseen - hosted by Amit Varma,7,0,2,3,27,39
The Purpose Show,0,1,0,1,48,50
Let's Parent on Purpose with Jay Holland,0,0,0,0,44,44
Summit Salon Minute,0,0,0,0,1,1
This Past Weekend,22,3,8,4,461,498
Awesome Etiquette,9,8,5,7,77,106
DMXS Radio,2,0,0,0,9,11
Hollywood & Levine,1,0,1,1,104,107
The Strange and Unusual Podcast,1,0,4,3,42,50
The Copywriter Club Podcast,0,0,0,0,50,50
"THE CEO PSYCHE PODCAST | BRAIN-BASED ONLINE BUSINESS, SALES PSYCHOLOGY",0,0,0,0,50,50
Keys To The Shop : Equipping Coffee Retail Professionals,0,0,0,0,43,43
The Minds of Madness - True Crime Stories,41,34,55,42,328,500
Running Rogue,5,1,3,3,39,51
Dumbgeons & Dragons,0,1,0,1,47,49
The ONE Thing with Geoff Woods,1,3,3,2,191,200
The Beginner's Garden with Jill McSheehy,2,1,3,1,43,50
kPod - The Kidd Kraddick Morning Show,14,3,3,5,25,50
The Letters Page,0,0,0,2,39,41
Energy Policy Now,0,0,0,0,16,16
PS I Hate This Movie,11,1,3,7,476,498
Impact Theory with Tom Bilyeu,0,0,1,1,20,22
Don't Keep Your Day Job,0,0,1,1,198,200
The Lapped Traffic Podcast- Nascar,0,0,0,0,49,49
The Firn Line,0,0,1,0,102,103
Close Reads,4,4,2,3,107,120
The Survivor Specialists: Phil and Alexa,7,2,4,4,43,60
Fasting Talk,14,8,5,6,17,50
Addicted Fishing Podcast,3,1,0,3,39,46
Two Judgey Girls,110,36,49,28,277,500
Rosecast | 'Bachelor' Recaps with Rim and AB,2,1,3,2,492,500
Petals and Pricks: The Bachelor and Bachelorette Podcast,1,0,0,2,34,37
Pod Save America,112,24,30,32,202,400
Introduction to Computer Science and Programming in Python,0,0,0,1,1,2
Living Myth,0,0,0,0,56,56
True Crime Guys,28,12,7,11,439,497
I'm Working On It With Matthew P Brown,0,0,0,0,5,5
"The Element Podcast | Hunting, Public Land, Tactics, Whitetail Deer, Wildlife, Travel, Conservation,...",1,0,0,0,247,248
Eat. Play. Sex.,2,1,0,0,25,28
Knowledge Fight,1,0,0,2,47,50
The Plaidcast,1,0,1,1,22,25
This Organized Life,3,1,3,1,42,50
Obstacle Running Adventures,0,0,1,2,34,37
Data Engineering Podcast,0,0,0,1,7,8
The 12 Steps and Buddhism - from Judith Ragir and others,0,0,0,0,2,2
Make Moments Matter:  A Music Education Podcast,0,0,0,0,48,48
Courage & Clarity,1,2,1,1,45,50
Hineni (Here I Am),0,0,0,0,10,10
Crime Stories with Nancy Grace,104,22,22,8,120,276
Another Bachelor Podcast,18,2,1,5,474,500
Kevin's Cryptids,1,2,0,1,46,50
Sixers Talk: A Philadelphia 76ers Podcast,0,0,1,1,13,15
Hakai Magazine Audio Edition,0,0,0,0,4,4
Leading Voices in Real Estate,0,3,0,0,31,34
Sexology,0,0,0,0,50,50
Bedtime Stories,2,1,0,0,118,121
The Inside Line Podcast - Vital MTB,1,0,0,4,22,27
The Strange Case of Starship Iris,3,2,1,4,166,176
Poker Stories,0,0,1,1,48,50
The FreshRN Podcast with Kati Kleber,2,0,4,5,36,47
The Slow Melt: A podcast about chocolate,0,0,0,0,25,25
Talking GolfGetaways: Your Golf Getaways Podcast,0,0,0,0,4,4
"Switch, Pivot or Quit",2,1,0,3,70,76
Psych Essentials,0,0,0,1,6,7
The Mustards,1,0,0,1,66,68
The RV Show USA Podcast,2,2,2,0,5,11
The Analyst Inside Cricket,0,0,0,1,9,10
Judaism From Within,0,0,0,1,1,2
Intre showuri podcast,0,0,0,0,2,2
Frankly Speaking About Family Medicine,3,0,0,3,8,14
Harmony UU Podcast,0,0,0,0,1,1
Small Town Murder,8,5,1,1,482,497
Dr. Greenthumb Podcast,0,0,0,0,21,21
Hazard Ground,1,0,1,0,48,50
The Losers' Club: A Stephen King Podcast,5,4,2,5,34,50
Smashing Security,4,1,0,1,64,70
Speaking Broadly,1,0,0,1,12,14
The Chromebook Classroom Podcast,0,0,0,0,11,11
Intercepted with Jeremy Scahill,15,5,3,4,23,50
The B. Scott Show,21,16,13,17,177,244
Trotadores,0,0,0,1,15,16
Other Life,4,0,0,2,13,19
The Scottish Rugby Podcast,0,0,0,0,1,1
Dames and Dragons,0,0,0,0,50,50
Team VTAC with Kyle Lamb,0,0,0,1,138,139
Interdimensional RSS: The Unofficial Rick and Morty Podcast,0,1,1,0,74,76
True Crime All The Time Unsolved,34,12,24,17,338,425
Peace Out,4,1,1,3,41,50
Civics 101,12,8,2,3,25,50
Aquarium Myths and Secrets Revealed,0,0,0,0,11,11
Ready Set Blow Podcast with Randy Valerio and Chase Abel,7,0,0,1,12,20
The GamesIndustry.biz Podcast,0,0,1,0,2,3
Road Trippin’,25,3,8,9,366,411
Burn it Nutrition Podcast,5,4,5,4,32,50
Ever Forward Radio with Chase Chewning,0,0,0,1,49,50
Game Misconduct with Don La Greca,3,0,0,1,25,29
The Doctor Who Audio Dramas,0,0,0,0,3,3
A to B Podcast: Simplicity | Organization | Fun,0,0,0,1,49,50
Riveting Stories 18+,2,0,0,0,1,3
The Melissa Ambrosini Show,0,0,0,0,50,50
Tape Op Podcast,3,1,2,1,17,24
Airplane Intel Podcast - Aviation Podcast,1,0,0,0,34,35
Lookout Landing: for Seattle Mariners fans,1,0,5,3,7,16
Life In The Stocks,0,0,0,0,13,13
Brian Moore's Full Contact Rugby,0,0,0,0,4,4
White Coat Investor Podcast,3,2,4,1,146,156
The Confessionals,60,19,18,14,389,500
Google Teacher Podcast,1,1,1,0,47,50
Rugby Union Weekly,35,26,35,38,231,365
"7 Minute Job Interview Podcast - Job Interview Tips, Resume Tips, and Career Advice",1,2,1,2,103,109
Professor Messer's Network+ Study Group,0,0,0,0,5,5
Professor Messer's A+ Study Group,0,0,0,0,5,5
Professor Messer's Security+ Study Group,0,0,0,0,2,2
Skytalkers,4,3,2,1,141,151
And The Writer Is...with Ross Golan,2,1,2,5,134,144
RX'D RADIO,0,0,0,0,50,50
SEN Breakfast,1,4,5,5,15,30
The First Serve,0,0,0,0,1,1
Can He Do That?,16,6,3,5,20,50
The Magicians,1,1,0,4,73,79
LA Theatre Works,0,2,3,0,24,29
After the Fact,0,0,0,0,21,21
Fantasy Hockey Podcast,4,0,0,0,54,58
The Curbsiders Internal Medicine Podcast,1,2,4,2,41,50
Threshold,0,0,0,0,58,58
The Midnight Myth Podcast,0,0,1,1,28,30
She Means Business Show,0,0,0,4,117,121
Regenerative Skills,0,0,1,0,13,14
MindShift Podcast,1,0,0,0,13,14
Weight Loss for Busy Physicians,0,0,3,1,46,50
eCommerce Evolution,0,0,1,0,14,15
The Hustle And Flowchart Podcast,0,0,0,0,50,50
Sandy's Spiel,0,0,0,0,2,2
Decorating Tips and Tricks,1,0,1,2,46,50
Sexy Unique Podcast,34,12,12,16,362,436
Barbell Medicine Podcast,1,1,0,1,47,50
What Happened When,26,15,20,14,424,499
The Patrick Coffin Show | Interviews with influencers | Commentary about culture | Tools for transfo...,11,2,3,3,128,147
Bronzeville,0,0,0,1,49,50
The Marie Forleo Podcast,3,0,0,3,44,50
Skillset Live,1,1,0,0,48,50
Pod Save the World,12,2,3,3,30,50
Education Research Reading Room,0,0,0,0,6,6
Lakers Nation Podcast,6,2,3,4,112,127
Fiber Talk,0,0,1,0,7,8
Fore Play,114,32,23,20,311,500
"The Awakened Man: A Repository For Holistic Health, Red Pill Alpha Masculinity, & Ultimate Freedom",4,1,3,4,232,244
The Daily,994,238,266,210,1687,3395
Simply Joyful Podcast with Kristi Clover | Encouragement for your Faith and Family,0,5,2,3,40,50
The Third Wave,0,1,1,3,45,50
Fall of the House of Sunshine,0,0,1,1,48,50
Run to the Top Extra Kick Podcast | Answers to Your Running Questions,0,0,2,6,42,50
Bilingual Podcast,2,0,0,0,10,12
The Fr. Mike Schmitz Catholic Podcast,1,1,0,3,181,186
Boundless Way Temple Dharmacast,0,0,0,0,1,1
"Hashtag Authentic - for small businesses, bloggers and online creatives",1,0,0,2,47,50
Turn Me On,3,2,3,1,27,36
Talk About Gay Sex TAGSPODCAST,3,1,5,3,15,27
The Money Cafe with Kirby and Kohler,8,2,3,10,55,78
Breaking Math Podcast,3,2,4,0,21,30
My Camino - the podcast,0,0,1,0,12,13
The Melrose Place Podcast,0,0,0,0,54,54
Bhagavad Gita Telugu,0,0,0,0,1,1
Coffee Break Chinese,0,0,0,0,9,9
10 Minute Teacher Podcast,2,0,0,1,47,50
The Jeff Cavins Show (Your Catholic Bible Study Podcast),0,0,1,1,128,130
The CEDIA Podcast,0,0,0,0,1,1
The National Security Law Podcast,0,1,2,3,44,50
RealTrending,0,0,0,0,2,2
Art Marketing Podcast,0,0,1,0,25,26
The FsRideAlong Podcast,1,0,0,0,0,1
Same Old Arsenal Podcast,0,0,0,1,3,4
Manifest It Now a Law of Attraction Show,4,1,2,2,56,65
History of the 90s,1,2,3,3,41,50
The Property Management Mastermind Show,0,0,0,0,15,15
Congratulations with Chris D'Elia,7,0,0,0,43,50
Ongoing History of New Music,0,1,0,2,29,32
Fore Golfers Network Podcast,0,0,0,0,25,25
The Ghost Story Guys,10,5,5,2,162,184
Film Threat,0,0,0,0,11,11
Global Translations,4,4,1,3,44,56
Challenged: A Podcast About MTV's The Challenge,29,15,7,17,206,274
WSJ Minute Briefing,6,0,6,7,12,31
Holistic Plastic Surgery Show,1,0,0,0,49,50
Simple Families,0,1,1,2,46,50
Downtime - The Mountain Bike Podcast,0,0,1,1,26,28
Keep Calm and Carry Yarn: A Knitting and Crochet Podcast,0,1,0,0,10,11
Strange Familiars,7,5,6,2,131,151
NBA Front Office w/ Keith Smith & Trevor Lane,0,0,0,0,25,25
In Other Words,0,0,0,0,9,9
Be Calm on Ahway Island Bedtime Stories,4,1,2,6,37,50
The Hot Dish,0,0,0,0,2,2
Good One: A Podcast About Jokes,2,0,3,2,43,50
The Current,2,0,1,6,46,55
Mac & Gu Movie Club,0,2,1,1,183,187
The 3028: Disney History & Disney Listory,1,0,0,1,48,50
World’s Toughest Podcast,0,0,2,2,135,139
The Honest Designers Show,1,0,2,5,159,167
"The Bad Girls Bible - Sex, Relationships, Dating, Love & Marriage Advice",10,2,6,6,26,50
The Official Disney on Broadway Podcast,0,0,0,1,5,6
wellRED podcast,1,0,2,0,47,50
WHERE BRAINS MEET BEAUTY,0,1,0,0,14,15
Challenge Mania,33,29,54,41,323,480
Strange Animals Podcast,1,0,0,1,31,33
CITIUS MAG Podcast with Chris Chavez,3,1,7,0,211,222
Iditapod,0,1,0,1,23,25
Machine Learning Guide,2,1,1,1,86,91
Ali on the Run Show,4,2,2,3,489,500
And That's Why We Drink,8,3,7,3,476,497
American Wannabes Podcast,1,0,0,0,49,50
The Last 10 Pounds Podcast,4,1,0,0,45,50
Inkwyrm,0,0,0,7,17,24
Keep It Weird,1,0,0,0,49,50
Freshly Grounded,0,0,0,0,10,10
Pure Cinema Podcast,1,0,1,5,106,113
The FPV Show,1,0,0,0,49,50
High Resolution,0,0,0,2,47,49
Epic Outdoors Podcast,4,2,0,1,47,54
Serial Killers,174,126,150,150,816,1416
"Drinking From the Toilet: Real dogs, Real training",0,0,0,1,49,50
NeoScum,0,0,1,1,48,50
Cinemaholics – Movie Reviews,3,2,0,1,17,23
Creepy,6,6,2,4,32,50
Hidden Forces,7,5,2,1,185,200
Nintendo Power Cast - Nintendo Podcast,5,1,2,4,116,128
Just The Discs Podcast,2,0,1,1,19,23
Draft Dudes – Daily Podcast On The NFL Draft And College Football,13,0,4,7,148,172
AT Parenting Survival Podcast: Parenting | Child Anxiety | Child OCD | Kids & Family,0,0,0,0,50,50
Discography Discussion,4,0,1,1,34,40
This Is Success,5,4,2,1,31,43
The Jennifer Allwood Show,0,0,1,1,98,100
Capitals Talk,23,16,12,2,142,195
Indie Hackers,1,0,0,1,133,135
The Best of Coast to Coast AM,48,11,17,11,42,129
Body Science Podcast,1,0,0,0,2,3
You Meet In a Tavern - A 5E D&D Actual Play Podcast,1,1,2,1,45,50
Abiding Together,0,1,3,0,294,298
Orange Mud Adventure Channel,0,0,0,0,3,3
The Weekly Bible Study Podcast with Tim Hegg,2,0,0,0,5,7
Telemetry: The sound of science in Yellowstone,0,0,0,1,9,10
Wine & Crime,2,1,0,1,46,50
The Passion People Podcast,0,0,1,1,9,11
Perfectly Imperfect with Christine and Regina,0,0,0,1,36,37
What It Means,0,0,0,2,4,6
Hamza Yusuf,1,0,0,2,7,10
Talking Mom2Mom,0,0,0,0,2,2
Grant’s Current Yield Podcast,4,3,4,3,55,69
The Intellectual Agrarian: Philosophy From The Farm,0,0,1,1,17,19
The Common Descent Podcast,1,1,0,4,50,56
The Rugby League Digest,0,0,0,0,1,1
Speaking Your Brand: A Public Speaking Podcast,0,0,0,1,49,50
Abundant Practice Podcast,1,1,0,0,36,38
Everyday Buddhism: A Jodo Shinshu Buddhism Podcast,0,0,0,0,1,1
Barca Talk,0,1,2,2,34,39
Inside Psycho,7,16,10,9,167,209
The WWE Podcast,15,5,2,2,39,63
Lake Clarity,5,5,6,14,20,50
Kwik Brain with Jim Kwik,0,2,0,2,30,34
Pilot to Pilot - Aviation Podcast,0,0,0,0,50,50
Luthier on Luthier with Michael Bashkin,0,0,1,0,26,27
The Buck Sexton Show,16,4,5,7,468,500
Goalie by Garman - How to Become a Great Goalie,0,0,0,0,5,5
Jim Cornette’s Drive-Thru,29,1,8,4,164,206
Private Parts,10,11,14,21,272,328
Forth And Ten,0,0,0,3,47,50
Mother Earth News and Friends,1,0,1,1,11,14
RD Real Talk - Registered Dietitians Keeping it Real,0,0,1,1,48,50
"The Betrayed, The Addicted, The Expert",0,0,0,4,46,50
The Raven Effect,7,5,4,2,315,333
The Zen Studies Podcast,1,0,1,0,19,21
Savor,24,30,24,20,102,200
Gud Vibrations Radio,0,1,0,0,30,31
The Futur with Chris Do,0,0,0,0,5,5
Kar Dishin' It : All Things Kardashian,10,2,5,4,191,212
Take a Break from Drinking,0,1,0,2,47,50
PolliNation,0,0,0,2,26,28
Chat of the Wild,0,0,0,4,16,20
RABBITS,3,2,7,11,27,50
JS Party: JavaScript & Web Dev,0,0,1,0,6,7
Bullet Cast,0,0,0,0,2,2
Understanding Today's Narcissist,1,1,0,2,43,47
Quran Garden - The Holy Quran Explained in Clear English (English Tafsir),0,0,0,0,2,2
WILD + FREE,0,1,1,4,44,50
Swing-Trading the Stock Market,3,0,1,2,65,71
That Triathlon Show,1,0,0,2,129,132
Ash Tales | Stories of the Apocalypse,1,0,0,0,7,8
Ultimate Guide to Partnering™,0,0,0,0,27,27
The Musafir Stories - India Travel Podcast,0,0,0,3,24,27
Red Line Radio,4,7,2,6,479,498
Team Flower,2,1,1,1,26,31
Below the Belt,112,20,19,17,299,467
NutritionFacts.org Video Podcast,0,0,3,2,15,20
"Real Vision: Finance, Business & The Global Economy",67,9,4,3,106,189
The Blacksmith's Pub Podcast,0,0,0,0,37,37
Benched with Bubba,0,0,0,0,69,69
"Nir And Far: Business, Behaviour and the Brain",2,0,0,1,16,19
The Investing for Beginners Podcast - Your Path to Financial Freedom,24,22,10,16,116,188
Monday Morning Critic Podcast,0,0,0,0,16,16
I Think You're Interesting,1,1,2,4,15,23
Emergency Medical Minute,1,2,1,0,13,17
"Sing Better Fast! | Vocal tips, singing lessons, voice exercises, etc.",0,0,0,5,29,34
Black Widow Podcast,1,3,4,7,185,200
Straight A Nursing,0,0,0,1,49,50
Bang On,1,0,0,1,92,94
Live Long and Master Aging,0,0,1,0,15,16
On The Ledge,0,1,1,0,48,50
Sequelcast 2 and Friends,0,0,0,0,4,4
School of Motion Podcast,0,0,0,0,114,114
Mars,0,0,0,0,2,2
SpawnCast,1,4,3,2,11,21
"Addicted to the Mouse: Disney Podcast | Disney World, Universal, & Cruise Vacation Planning",0,0,1,0,87,88
Podcasts We Listen To,1,2,0,1,52,56
The Puppy Podcast,0,0,0,2,13,15
"WIRED Security: News, Advice, and More",1,0,1,0,3,5
Paint All The Minis Paint Ramble,0,0,0,1,11,12
Very Random Encounters: Chaotic Improv Actual Play,0,0,0,1,49,50
Beauty Is Your Business,0,0,0,0,5,5
Bassmaster Radio,0,0,1,0,3,4
Yaqeen Podcast,0,0,0,1,7,8
The Ouija Broads: Tales from the Pacific Northweird,2,0,2,0,53,57
Texas Oil and Gas Podcast,1,1,3,2,132,139
Trailblazers with Walter Isaacson,1,0,0,2,71,74
Under The Skin with Russell Brand,30,5,18,20,427,500
The Jason Smith Show,1,1,0,1,16,19
Outkick the Coverage with Clay Travis,24,1,2,5,468,500
The Odd Couple with Chris Broussard & Rob Parker,9,6,4,4,106,129
Straight Outta Vegas with RJ Bell,9,4,2,5,45,65
Equity Mates Investing Podcast,3,1,4,4,81,93
Music Production Podcast,0,0,2,2,30,34
Queens Podcast,7,1,3,3,36,50
Advanced Spanish,1,1,0,1,2,5
Advanced French,0,0,0,0,3,3
The Push - A Traditional Archery Podcast,0,1,0,1,107,109
Game of Thrones: On the Throne Podcast,25,20,8,9,298,360
The Modern Maker Podcast,3,1,3,2,191,200
The Five,82,18,25,31,159,315
The One Day At A Time Podcast,0,4,2,1,24,31
French Conversations for Beginners – Real Life Language,6,7,2,2,13,30
S-Town,24,17,13,15,430,499
Parenting ADHD Podcast,1,1,0,2,27,31
The Oz Network - TV & Film Recaps,0,0,0,1,0,1
The Workplace Therapist Show,0,0,0,0,18,18
The Mike Calta Show Featured Cut of the Day,2,0,1,0,1,4
Believe You Me with Michael Bisping,8,7,4,7,474,500
EAA's The Green Dot - An Aviation Podcast,1,0,1,0,40,42
Ideas to Invoices,0,0,0,0,6,6
Kahani Suno,0,2,3,4,35,44
Chopper's Politics,9,2,3,3,33,50
Canes Corner Podcast,0,0,0,0,18,18
Everybody's National Parks,0,0,1,1,22,24
"hey, girl.",0,0,5,3,176,184
Cosmic Vertigo,0,0,0,0,10,10
Latitude Photography Podcast,1,1,0,0,11,13
The BHooked Podcast for Crochet & Knitting Enthusiasts,0,0,0,1,44,45
Jason Dick AF,3,3,2,2,17,27
"El Bueno, la Mala y el Feo",15,1,4,4,13,37
Embrace The Void,0,0,1,0,23,24
The Dive - A League of Legends Esports Podcast,2,0,1,0,49,52
GSAPP Conversations,0,0,0,0,1,1
Phillies Talk: A Philadelphia Phillies Podcast,1,0,0,2,23,26
The Covenant Cast,0,0,1,0,31,32
Breaking Beauty Podcast,5,4,3,8,180,200
Lean Life Radio,0,0,0,0,23,23
Corpus Animus Podcast,0,0,0,0,10,10
Python for Everybody (Video/PY4E),1,0,0,0,6,7
gone cold podcast - texas true crime,33,28,16,8,137,222
Mastering Intensive Care,0,0,0,0,5,5
"By Kids, For Kids Story Time",5,1,3,6,35,50
The Mindful Dietitian,0,0,0,0,7,7
Living the RV Dream,0,0,0,1,14,15
Brokedown Podcast,0,0,0,0,39,39
Vedic Worldview,0,0,0,0,23,23
Matters of Policy & Politics,3,5,0,1,32,41
Full Coverage,1,0,0,0,65,66
On The Bench: An FSU football podcast,12,6,10,6,205,239
Sticky Notes: The Classical Music Podcast,0,0,0,2,161,163
The Bible For Normal People,17,6,13,13,286,335
Single Smart Female,9,6,4,3,39,61
Equity,8,4,9,5,21,47
The Stories Behind Wine,0,0,0,0,5,5
Beyond The Box Set,0,0,0,0,42,42
Tisarana Buddhist Monastery,0,0,0,0,1,1
The Chris Harder Show,0,0,0,0,50,50
AvTalk - Aviation Podcast,0,0,0,1,49,50
PsychEd: educational psychiatry podcast,0,0,0,0,7,7
Dirty Erotica,0,1,0,1,11,13
ParentingAces - The Junior Tennis and College Tennis Podcast,0,0,0,0,33,33
Slayerfest98 (A Buffy the Vampire Slayer Podcast),2,0,0,2,20,24
Baseball Things,2,0,0,0,12,14
Learn English with the British Council and Premier League,1,1,1,0,3,6
Lovett or Leave It,55,17,22,17,389,500
Manifest Zone: Exploring the World of Eberron,0,0,0,1,21,22
Hebrew In Israel,0,0,0,0,5,5
Speak English Now Podcast: Learn English | Speak English without grammar.,0,1,1,0,14,16
Scandalous Beauty - A Makeup and Beauty Podcast by Erin Baynham,0,0,0,0,12,12
5 Minute Italian,0,0,0,1,13,14
The Podcast Discovery Show,0,0,1,1,23,25
The Conversation Factory,0,0,0,0,13,13
The Fiona Potts Interview,1,0,0,1,5,7
The Everyday Astrology Podcast,3,0,0,0,1,4
The String,0,0,0,0,3,3
Family Ghosts,8,11,9,13,459,500
Australian True Crime,122,30,40,24,442,658
Disney Travel Secrets - How to do Disney,17,10,3,2,111,143
The Black Goat,0,1,0,0,11,12
MAPS Podcast,0,0,1,1,17,19
The Dan Dakich Show Podcast,117,1,1,2,25,146
Evil Thoughts,1,0,0,2,41,44
The Equal Rights Institute Podcast,0,0,0,0,3,3
Revolutionary Left Radio,5,0,0,0,45,50
A Teacher's History of the United States,5,0,0,1,44,50
The ZDoggMD Show,2,0,1,0,47,50
"AI: The ""C"" Team",0,1,0,2,20,23
The Traffic and Funnels Show,1,0,0,0,39,40
Rock Talk With Mitch Lafon,4,1,2,3,19,29
Podcasts from F3 Nation,0,0,1,0,16,17
Windows Insider Podcast,0,0,0,1,4,5
"Apsara Skin Care: Tips, Remedies & Info for Flawless Skin & Beautiful Hair",0,0,1,9,90,100
The Maker Minded,1,0,0,0,30,31
Stories Fables Ghostly Tales Podcast,0,1,0,1,48,50
2Bobs - with David C. Baker and Blair Enns,0,0,0,2,29,31
New Home Buyers Guide Podcast,0,0,0,0,1,1
The Wild Pitch,0,0,0,1,31,32
Poker On The Mind Podcast,0,0,0,1,4,5
Ask a House Cleaner,0,0,0,1,117,118
Adjuster Talk's Podcast,0,0,0,0,23,23
Bobbycast,5,0,7,11,288,311
Getting Into Nursing School Podcast by NURSING.com (NRSNG),0,0,1,0,1,2
Walking The Dog with Emily Dean,8,6,17,23,413,467
The Bobby Bones Show,2,3,2,5,38,50
Daily Detroit,1,0,1,0,12,14
Raising Arrows - Big Family Homeschool,1,0,0,0,18,19
"RC Afterhours - RC Planes, Multirotors & Technology",0,0,0,1,30,31
Judd’s Hockey Show - a Minnesota Wild podcast,0,0,0,0,4,4
Fortunately... with Fi and Jane,8,6,10,8,182,214
Sound the Foghorn Podcast on the SF Giants,0,0,0,0,2,2
Fully Booked by Kirkus Reviews,0,1,3,0,3,7
Tutor Ted Talks College Admissions,0,0,0,0,8,8
Epic Gardening: Daily Growing Tips and Advice,0,2,0,1,47,50
Everyone Hates Marketers,0,0,0,0,27,27
The Interchange,0,1,0,1,59,61
Nancy,4,5,3,10,417,439
Up First,130,40,40,32,478,720
Natch Beaut,3,0,2,1,193,199
Capital Allocators,0,0,3,1,116,120
This American President,0,1,1,2,46,50
My Neighbors Are Dead,1,0,0,0,47,48
Battle Of The Atom: An X-Men Podcast,0,0,1,1,39,41
Ajahn Anan Podcast,0,0,0,0,1,1
Way of Champions Podcast,0,0,0,1,30,31
The Calm Kids Podcast,4,1,2,4,39,50
Sluts and Scholars,1,0,1,4,44,50
Aviation News Talk podcast,0,0,1,0,49,50
Dog Soldier Brand: Hunting and Shooting,0,3,2,0,45,50
The Plane Faith Podcast,0,0,0,0,12,12
Sounding Off with Rick Beato,0,0,0,1,8,9
The Sunday Stoic,0,0,0,0,19,19
Don't Blame Me!,8,0,1,3,38,50
How Leaders Lead with David Novak,0,0,0,0,50,50
Inbox Besties w/ Kate Doster | Email Marketing Podcast,0,0,0,1,49,50
Welcome Home: A Disney Parks & DVC Podcast,2,2,7,5,90,106
OverSaturated: The Podcast,1,1,0,1,42,45
The Second Studio Design and Architecture Show,3,3,1,0,40,47
LSE IQ podcast,0,0,0,0,1,1
Bariatric Surgery Success,0,0,0,0,6,6
Golf DMV,0,0,0,0,2,2
Gayish Podcast,5,3,1,2,39,50
Code 3 - The Firefighters' Podcast,0,0,0,0,6,6
The GSD Show,0,0,0,0,38,38
The Tennis Abstract Podcast,0,0,0,0,6,6
WHOREible decisions,12,1,1,5,31,50
The Oasis Podcast,0,0,0,0,24,24
WEIGHING IN,2,1,2,0,40,45
Fairytales of India,0,0,1,0,16,17
NBA DFS Today,2,1,2,4,43,52
The Late-Round Podcast,5,5,4,7,478,499
F-Stop Collaborate and Listen,0,0,1,2,72,75
Friend Code,1,0,1,0,8,10
The Chip Chipperson Podacast,3,0,1,2,44,50
Recorded Future - Inside Security Intelligence,1,0,1,0,4,6
The Business of Fashion Podcast,4,4,4,2,22,36
The Well-Storied Podcast,0,0,0,0,25,25
The Modern Craftsman Podcast,3,0,0,3,44,50
The Running for Real Podcast,9,1,1,11,401,423
Every Little Thing,2,1,3,1,43,50
Voices of Deconversion,0,0,0,0,9,9
B2B Sales Questions Show - Brutally Honest Answers - Sales Hackers Ideas,0,1,0,1,42,44
Teaching While White Podcast,4,1,0,0,25,30
Forgotten TV,1,0,0,0,18,19
State of Combat with Brian Campbell,23,9,5,4,237,278
The UGASports LIVE Podcast,0,2,2,1,60,65
The Energy Blueprint Podcast,5,2,2,2,39,50
Detroit Lions Breakdown Podcast,1,0,1,1,197,200
LUCYD,0,0,1,4,16,21
Proof to Product,0,0,0,1,72,73
the bioinformatics chat,0,0,0,0,1,1
Dharma Talks at Columbus KTC,0,0,0,0,3,3
The Earful Tower: Paris,3,0,1,2,100,106
REI Mastermind Network | Real Estate Investing Strategies & Mindset,0,0,0,0,31,31
1001 Stories For The Road,2,1,0,3,44,50
Marketing Tips for Photographers | The Tog Republic Podcast,0,0,0,0,47,47
Tifo Football Podcast,0,0,2,2,52,56
Land Line Now,0,0,0,0,1,1
Somewhere in the Skies,6,4,4,2,116,132
The Highwire with Del Bigtree,3,0,0,0,47,50
AppStories,2,0,2,2,17,23
terrestrial,1,0,0,0,20,21
Masters of Scale with Reid Hoffman,0,0,2,10,140,152
Optimal Relationships Daily,3,2,7,5,41,58
Known Pleasures,0,0,0,0,5,5
Industrial IoT Spotlight,0,0,0,1,10,11
The Sherman Show,0,1,3,2,18,24
Lions247 Penn State Podcast,4,3,1,3,223,234
Brave New Weed,0,0,0,0,14,14
She's Got Drive: Black Women talk about Success and how they achieved it.,0,0,0,0,35,35
At Home With...,1,0,0,2,95,98
Acres U.S.A.: Tractor Time,0,0,0,2,1,3
The Intermittent Fasting Podcast,13,8,5,3,21,50
Heather du Plessis-Allan Drive,1,0,0,0,2,3
Entiende Tu Mente,0,1,0,0,21,22
Undiscovered,6,2,4,3,153,168
Story Break,0,1,6,9,255,271
WoT Spoilers Podcast,4,1,3,5,70,83
Brothers of the Serpent,0,1,1,0,71,73
Queer Sex Ed Podcast,0,0,1,0,66,67
The Influencer Podcast,10,4,3,3,180,200
UnF*ck Your Brain,115,20,40,35,975,1185
Secret Leaders,0,0,1,0,2,3
The Best Today™ Podcast,0,0,0,0,19,19
20 Sided Stories,1,0,1,0,29,31
The Mike Hosking Breakfast,8,1,0,0,6,15
"Spin Control Podcast: a knitting, spinning, and fiber craft podcast.",0,0,0,0,4,4
Food Safety Matters,1,0,0,0,2,3
Nonprofit Optimist,0,0,0,0,21,21
Other: Mixed Race in America,0,2,1,2,41,46
Stories We Tell,0,0,0,0,7,7
Documentary of the Week,0,0,0,0,1,1
"Murder, Myth & Mystery",16,6,5,8,158,193
Thirty Love: Conversations About Tennis,0,0,0,0,4,4
Podcasting On A Plane,0,0,0,0,29,29
Liz's Healthy Table,0,0,0,1,22,23
Let's Argue About Plants,3,4,2,1,38,48
Six States One Podcast - A Show About The New England Revolution,0,0,0,0,26,26
The Doug Gottlieb Show,20,4,0,2,30,56
The Calcioland Podcast,2,1,2,4,196,205
Pod Save the People,8,0,3,2,37,50
The Addiction Podcast - Point of No Return,7,4,1,0,18,30
"FactFruit | Daily News, Information, Current Events",0,0,0,0,7,7
The Liz Earle Wellbeing Show,1,0,2,1,93,97
NOCTURNAL TRANSMISSIONS : short horror story podcast,0,0,1,3,46,50
El Show de Raul Brindis,4,1,0,0,14,19
Sight Unseen,14,4,8,7,55,88
HACKERHAMIN,6,0,0,1,50,57
Whitetail Instinct Podcast,0,0,0,0,1,1
Cloud Engineering – Software Engineering Daily,1,0,0,0,0,1
Your New Puppy: Dog Training and Dog Behavior Lessons to Help You Turn Your New Puppy into a Well-Be...,1,0,1,1,47,50
Attention HellMart Shoppers!,1,1,3,2,43,50
How To Talk To Kids About Anything,0,0,0,0,50,50
NAR’s Center for REALTOR® Development,0,0,0,0,9,9
The Successful Fashion Designer,0,0,0,4,85,89
"Fletch, Vaughan & Megan on ZM",1,1,0,2,43,47
Pint O' Comics,1,0,0,0,40,41
Sober Cast: An (unofficial) Alcoholics Anonymous Podcast AA,0,0,2,1,44,47
Classic Wrestling Memories,0,0,0,0,3,3
Strawberry Letter,1,0,2,4,23,30
The Steve Harvey Morning Show,3,2,3,8,34,50
Run That Prank,1,2,1,3,20,27
Intermediate French Podcast,0,0,0,0,50,50
Really Famous with Kara Mayer Robinson,4,1,0,2,20,27
"Bribe, Swindle or Steal",0,0,0,1,32,33
The D2D Podcast,0,0,0,2,36,38
"Los Angeles County, CA: Board of Supervisors Archives Video Podcast",0,0,0,0,1,1
The First Cut Golf,5,6,7,4,149,171
True Crime Obsessed,64,24,10,8,180,286
So You Wanna Be A Witch,0,0,0,1,51,52
Mysterious Circumstances,4,2,0,1,43,50
Let's Talk About Sets!,0,0,0,0,40,40
Relationships Uncomplicated,0,0,0,1,26,27
The On-Premise IT Roundtable,0,0,0,0,7,7
Suiting Up with Paul Rabil,1,1,2,3,353,360
The Breakfast Club,132,58,84,104,356,734
TRIVIALITY - A Trivia Game Show Podcast,1,0,0,2,47,50
The Infinite Inning,1,0,1,0,54,56
Illumina Genomics Podcast,0,0,0,0,2,2
Blunt Business,1,0,0,0,4,5
OTHERVERSE,0,0,0,0,9,9
The Dear White People Podcast,0,0,0,0,3,3
Joette Calabrese Podcast,0,0,0,0,14,14
Radio Wonderland,3,1,0,1,45,50
Audrey Helps Actors Podcast,1,0,1,1,197,200
GrippingGolf,0,0,0,0,15,15
Dawson's Speak: A Podcast About Dawson's Creek,1,0,1,3,61,66
My Child & ADDICTION,1,0,0,0,11,12
Wow in the World,22,10,16,34,498,580
Planner Girl Chatter,2,0,3,0,12,17
THOR: The Lightning and the Storm,0,0,0,1,24,25
Medita Podcast,0,0,0,0,13,13
Selling the Sandler Way Podcast,0,0,0,0,1,1
Post2Post Hockey Podcast,0,0,0,0,10,10
Newscast,8,6,3,2,30,49
Deer University,0,0,0,1,52,53
WSJ’s The Future of Everything,9,2,5,2,45,63
IsraelCast,0,0,0,0,40,40
"Plantrama - plants, landscapes, & bringing nature indoors",0,0,0,2,43,45
DEER HUNTER,5,2,5,2,134,148
The Art of Bombing,0,0,0,0,17,17
Golf Betting System Podcast,0,1,0,2,54,57
"Self Publishing School : How To Write A Book That Grows Your Impact, Income, And Business",0,1,2,21,176,200
Psychedelic Salon,0,0,0,1,25,26
IVFML,2,0,1,1,69,73
Heritage Explains,6,0,0,0,48,54
Dish Nation,0,0,0,0,7,7
JAAPA Podcast,0,0,0,1,2,3
"Casually Baked, the potcast: Discover hemp and cannabis 420 style",1,0,0,2,29,32
Grant Writing & Funding,0,0,0,0,29,29
Oliver Heldens presents Heldeep Radio,0,0,0,0,25,25
Comedy Fight Club,4,0,1,1,19,25
Love & Light Live Crystal Healing Podcast,3,0,0,0,93,96
On Margins,0,0,0,0,15,15
Zigbits Network Design Podcast,0,0,0,0,3,3
Ry Rant Radio,0,0,0,0,6,6
Black Lightning Podcast,0,0,0,1,6,7
Talking with TK,0,0,0,0,1,1
"Wine, Women and Words",0,0,0,0,3,3
Dumb-Dumbs & Dragons: A Dungeons & Dragons Podcast,0,0,0,0,14,14
Vermont Dog Trainer Show,0,0,0,1,29,30
BACK TALK- The Podcast,0,0,0,0,4,4
The Brohio Podcast,36,6,4,10,444,500
VIEWS with David Dobrik and Jason Nash,138,64,56,64,678,1000
PFF Fantasy Football Podcast with Ian Hartitz,13,8,16,16,447,500
Happier in Hollywood,3,4,1,2,190,200
Play Like A Jet: New York Jets,9,3,4,2,32,50
Y Combinator,0,2,0,0,10,12
THE FROTHCAST,0,0,0,0,4,4
Ebro in the Morning Podcast,14,2,10,12,132,170
This Paranormal Life,1,0,0,1,48,50
Why We Do What We Do,1,0,1,1,8,11
"The Affiliate Guy with Matt McWilliams: Marketing Tips, Affiliate Management, & More",1,0,0,1,48,50
Keeping It Real Podcast • Secrets Of Top 1% REALTORS ® • Interviews With Real Estate Brokers & Agent...,0,0,1,1,10,12
JavaScript Jabber,2,0,2,1,2,7
74 Seconds,8,5,4,8,175,200
The Clip Out,3,5,2,4,36,50
History Unplugged Podcast,34,31,26,35,240,366
Where Should We Begin? with Esther Perel,18,3,3,9,423,456
Trust the Bachelor Process,0,1,0,0,29,30
A+ Anime Podcast,0,0,0,0,15,15
LOMAH Disability Podcast,0,0,0,0,39,39
The Ben and Ashley I Almost Famous Podcast,187,50,53,36,174,500
Femlore Podcast (formally Feminist Folklore),5,5,0,3,53,66
Love and Sex Today,1,0,0,1,42,44
Epic Success with Dr Shannon Irvine,0,0,0,0,50,50
Authentic Jewish Living with Yiscah,0,0,0,0,5,5
"Sincerely, X",49,29,20,16,128,242
PerformHappy with Rebecca Smith,0,0,0,0,3,3
Join the Party,0,1,1,1,47,50
SOFLETE,0,0,0,1,21,22
Conversion To Orthodox Judaism,0,0,0,0,1,1
Exploring Judaism with Rabbi Michael Skobac,0,0,0,0,1,1
The King In The Field with Rabbi Manis Friedman,0,0,0,0,1,1
"Audioface: Music News, Reviews, & Culture",0,0,0,0,4,4
The World Of Buddy Pegs Children's Podcast,0,0,0,1,14,15
Trace Evidence,24,11,31,26,408,500
Paisa Vaisa,0,0,0,3,10,13
Appalachian Mysteria,2,3,5,23,183,216
The Shark Tank | A Sale Sharks Podcast,1,0,0,0,0,1
What's Good Games: A Video Game Podcast,2,0,0,1,47,50
The Element of Inclusion,0,0,0,0,14,14
School's In,0,0,0,0,1,1
Discovery Mountain,0,0,0,1,49,50
Best Case Worst Case,143,38,30,41,234,486
Deconstructing Yourself,0,1,0,0,85,86
Dr. James Dobson's Family Talk,1,0,0,1,11,13
Off The Vine with Kaitlyn Bristowe,119,28,32,27,294,500
Law360's Pro Say - News & Analysis on Law and the Legal Industry,4,0,1,0,45,50
"""There I was..."" An Aviation Podcast",0,0,1,1,12,14
Margaritaville Podcast,0,0,0,1,11,12
Stansberry Investor Hour,15,6,0,3,59,83
Ear Hustle,4,0,6,3,487,500
Master Your Mix Podcast,0,0,0,0,5,5
Start a Local Small Business | Advice to Help You Take Your Business Idea from Concept to Open for B...,0,0,0,1,8,9
SFF Yeah!,1,2,0,3,24,30
The Spark Creativity Teacher Podcast | Education,0,0,0,0,47,47
Commander Cookout Podcast,1,0,0,0,49,50
Deconstructor of Fun,0,1,1,1,10,13
Berlin Briefing,0,0,0,1,3,4
The Far Meridian,2,2,1,1,44,50
Cold Case Files,118,97,124,41,120,500
Buddhist Boot Camp Podcast,0,0,0,1,22,23
Southern Fried True Crime,45,23,31,17,384,500
The Barcelona Podcast,2,1,1,1,32,37
Australian Birth Stories,0,0,1,3,121,125
Seahawks Man 2 Man: A show about the Seattle Seahawks,1,1,1,1,20,24
Shameless Sex,2,3,4,1,40,50
What Trump Can Teach Us About Con Law,9,2,3,1,35,50
Escape This Podcast,1,0,0,0,46,47
"Tales from the pits, a Texas BBQ podcast featuring trendsetters, leaders, and icons from the barbecu...",0,0,0,1,33,34
The Purple Rocket Podcast,1,0,2,0,47,50
John and Ken on Demand,22,2,7,6,39,76
Jesus Christ Show,0,1,0,0,2,3
The Mo'Kelly Show,1,0,0,1,5,7
The Plant Path,0,0,2,0,25,27
Binge Mode: Marvel,66,33,34,21,346,500
The Breaking Muscle Podcast,0,0,1,1,6,8
Johnjay & Rich On Demand,15,5,5,7,18,50
The Broadway Cast,1,1,0,1,23,26
Mike Tyson: Bite the Mic with Peter Rosenberg,8,6,4,7,125,150
The Future of Health,0,0,0,2,6,8
The No-Rank Zendo Podcast,0,0,0,0,2,2
The Korn Ferry Channel,0,0,0,0,1,1
Lynching In America Podcast,0,0,0,0,7,7
Journeywomen,1,1,3,4,491,500
A Date With Dateline,30,6,3,7,454,500
Queer as Fact,0,2,0,3,45,50
The Cinema Clash,0,0,0,0,2,2
Imagineer Podcast,0,0,0,1,49,50
Inside the Disney Vault,2,3,3,5,90,103
Highest Self Podcast,1,2,2,6,489,500
LeVar Burton Reads,4,2,3,6,485,500
30 For 30 Podcasts,95,25,30,30,319,499
Neurocritical Care Society Podcast,0,0,0,0,5,5
POLITICO's EU Confidential,2,1,0,0,6,9
"The Smart Nutrition, Made Simple Show with Ben Brown",0,0,0,1,23,24
Fortune's Wheelhouse,0,0,2,0,60,62
The Fall Line,27,32,20,20,387,486
Confessions of a Train Wreck,0,0,0,1,4,5
The joe gardener Show - Organic Gardening - Vegetable Gardening - Expert Garden Advice From Joe Lamp...,0,0,1,0,49,50
News & Views with Joel Heitkamp,0,0,0,0,1,1
EMBody Radio,2,0,0,1,47,50
Player Development Project Podcast - Learning Tools for Soccer Coaching,0,0,0,1,0,1
Mat Chat with David Mirikitani,0,0,0,0,1,1
The Rachel Hollis Podcast,93,10,12,4,81,200
APTA Podcasts,0,3,0,0,0,3
Prime Time with Sean Mooney,7,2,5,10,227,251
The Throwback Podcast,2,0,1,0,47,50
The Nutrition Show,0,1,0,1,20,22
In Defense of Plants Podcast,1,0,3,5,112,121
Authentic Sex with Juliet Allen,1,3,1,1,44,50
Reading Glasses,4,3,5,3,185,200
Advanced Talmud Study (Audio),0,0,0,0,2,2
Complete The List,0,0,1,1,20,22
"Now, What’s Next?",1,0,0,0,8,9
Circle Round,2,1,0,1,46,50
The mindbodygreen Podcast,4,4,5,3,34,50
Beyond the Studio - A Podcast for Artists,0,0,0,1,47,48
Epigenetics Podcast,0,0,0,0,6,6
Mogul,2,1,0,1,46,50
Poorly Educated,2,0,0,1,32,35
Cleared Hot,3,1,5,4,487,500
Eat For The Planet with Nil Zacharias,1,0,1,2,53,57
Cooking the Books with Frances Cook,3,0,0,1,16,20
Kinda Funny Games Daily,20,3,4,4,19,50
Speak N' Destroy - Interviews About METALLICA,0,0,0,0,50,50
Fun Kids Science Weekly,0,0,2,3,45,50
Move Forward Radio,0,0,1,0,1,2
Feel Good Effect,0,0,0,1,49,50
Herpetological Highlights,0,0,0,0,5,5
Talking Tax,1,1,1,0,2,5
Vedanta Talks,0,0,0,0,10,10
Life With Herpes,0,0,0,1,3,4
Spike's Car Radio,20,6,3,4,17,50
Light On Conspiracies,2,0,0,0,9,11
Extraordinary Stories Podcast,1,0,1,1,143,146
Saffron and Peri,0,0,0,1,6,7
36 Questions – The Podcast Musical,3,1,1,1,44,50
The Daily EDGE,0,0,0,0,26,26
Open Goal - Football Show,1,1,0,0,0,2
Neil Sperry's GARDENS,0,2,0,0,2,4
Worldly,38,48,32,36,202,356
The Long Game,2,1,1,0,18,22
VS,2,1,1,0,49,53
Rocky Mountain National Podcast,0,0,0,0,15,15
The Michigan Insider,6,6,12,2,111,137
The HoopsHype Podcast with Michael Scotto,2,2,2,0,44,50
Trace,5,4,7,5,102,123
Human Hope with Carlos Whittaker,0,0,0,0,274,274
Let's Not Meet: A True Horror Podcast,29,17,23,30,401,500
Tape Notes,0,0,0,0,11,11
Low-Budget Rebels: An Indie Filmmaking Conversation with Josh Stifter,0,0,0,0,4,4
The Modern Bar Cart Podcast,0,0,0,0,17,17
It's Been a Minute with Sam Sanders,10,5,4,5,476,500
Heels Down Happy Hour,1,1,0,0,26,28
RedHanded,68,22,28,23,359,500
Horror City Radio,0,0,0,0,5,5
Five Hole Fantasy Hockey,0,0,0,1,17,18
KSR,7,3,0,6,220,236
Truu Stowray,1,0,0,1,21,23
Self-Helpless,4,1,1,1,43,50
Desert Oracle Radio,1,0,1,2,59,63
Petros And Money,2,1,1,2,82,88
Keto For Women Show,13,5,1,2,29,50
Project Management Happy Hour,0,0,0,1,31,32
The Two Shot Podcast,0,0,0,0,8,8
Analog Talk,3,0,1,3,29,36
Tandem Legends: a Legend of Zelda Podcast,0,0,0,1,74,75
Coin Mastery - Building Your Cryptocurrency Empire,1,0,0,0,31,32
The Atlanta Foodcast: A Food Podcast,0,0,0,1,15,16
The Architecture Firm Marketing Podcast,0,0,0,0,1,1
IANDS Presents NDE Radio,9,2,3,1,13,28
Made for Profit,0,0,0,0,50,50
Bespoken Bones  Podcast,0,0,0,0,25,25
Malicious Life,2,0,2,1,267,272
The Mind4Survival Podcast,2,0,0,1,38,41
Meet the Creatives,0,0,0,0,8,8
The OddsBreakers,3,0,2,1,34,40
Brooke and Jeffrey: Second Date Update,13,2,6,5,24,50
The Infinite Bad,0,1,0,0,39,40
Women Inspiring Women,0,1,0,0,199,200
The Wellness Business Podcast,0,0,0,1,99,100
Octavia E. Butler Studies: Convergence of an Expanding Field,0,0,0,0,1,1
Zen Nova Scotia,0,0,0,0,4,4
Know Your Gear Podcast,0,0,0,1,15,16
The Landscape Photography Podcast,0,0,0,0,12,12
The Power Trip,5,1,1,0,50,57
Stream Key Podcast: Twitch Streaming Tips,0,0,2,0,17,19
Randy Lemmon's GardenLine,0,0,0,0,1,1
The Michael Berry Show,2,1,2,2,66,73
House of Carbs,13,8,7,6,166,200
The Weird Tales Podcast,1,0,1,0,11,13
Syntax - Tasty Web Development Treats,1,1,3,5,136,146
The Egg Whisperer Show,1,0,0,0,13,14
Got it Memorized? A Final Fantasy X Recap Podcast,1,0,0,2,48,51
Soccer City presented by LouCity,0,0,0,0,1,1
Nomads at the Intersections,2,3,0,3,95,103
Your Daily Prayer,8,4,3,2,76,93
Kiss 95-7's War of the Roses,10,3,4,4,8,29
Elliot In The Morning,3,2,0,3,14,22
War Of The Roses,11,2,4,7,13,37
Mojo In The Morning,13,3,4,3,27,50
Flowerland Garden Show,0,0,0,1,0,1
Tarot for the Wild Soul with Lindsay Mack,2,0,1,0,47,50
Empire Show,0,0,1,0,88,89
Unhappy Hour with Matt Bellassai,4,2,3,2,39,50
Physical Attraction,0,0,0,0,27,27
Constitutional,3,3,3,2,39,50
Typology,2,2,5,7,34,50
/Film Daily,20,13,15,10,158,216
Popcorn Finance,1,0,0,1,45,47
Secret Feminist Agenda,0,0,0,0,76,76
Away Message,0,0,0,0,37,37
What Does This All Mean?,0,0,0,0,34,34
Video Games Weekly,1,0,1,0,16,18
The Game w/ Alex Hormozi,1,1,0,0,69,71
The Stepmom Club,0,0,0,0,14,14
The Transfer Window,11,3,1,1,29,45
The Low Carb Cardiologist Podcast,0,0,0,0,23,23
Barbell Logic,5,4,1,0,40,50
The Art of Decluttering,0,0,0,0,36,36
Capture The Magic - Disney World Podcast | Disney World Travel Podcast | Disney World News & Rumors ...,10,6,7,3,115,141
Blake and Spencer Get Jumped! An Anime Podcast,1,0,0,1,36,38
Left Behind Game Club: A Video Game Podcast,0,0,0,0,7,7
Murder and Such,26,15,9,4,203,257
True Crime Couple,18,16,18,16,311,379
Treks and the City,6,4,9,6,126,151
Lords of Limited,0,1,1,1,47,50
Legendary Creature - Podcast,0,0,1,0,26,27
GI Pearls Podcast,0,0,0,0,50,50
The Best & Worst of Walt Disney World - A Weekly Podcast About the best and worst of all things Walt...,2,4,4,4,59,73
NerdWallet's Smart Money Podcast,2,2,1,1,17,23
Issa Rae Presents...FRUIT,0,1,4,5,109,119
The Medium Matters,1,1,1,0,32,35
Snowfall Reviews and After Show - AfterBuzz TV,3,2,1,0,0,6
House of Strauss: An NBA Podcast,3,3,1,2,58,67
A Piece of Work,4,6,4,11,175,200
Down in Alabama with Ike Morgan,2,0,1,0,23,26
Inside of You with Michael Rosenbaum,0,0,0,1,49,50
Ahead Of The Curve with Jonathan Gelnar,0,1,0,0,27,28
Constructed Criticism,0,1,0,0,6,7
Journey To Launch,0,0,1,2,197,200
Tides of History,3,4,3,1,39,50
Reid This Reid That,2,1,4,9,34,50
Hackable?,4,3,3,8,65,83
The Daily 202's Big Idea,16,4,12,4,14,50
Isle Seat Podcast,1,1,1,1,95,99
The Rambling Runner Podcast,0,0,2,1,83,86
Mr. Bedtime Stories,4,3,4,5,34,50
Fearless Presentations,2,0,1,0,15,18
The Pool Guy Podcast Show,0,1,0,0,18,19
155,2,1,0,1,31,35
Best BBQ Show,5,0,1,0,23,29
Cover 3 College Football,83,8,6,8,395,500
Swallow Your Pride Podcast,1,2,3,1,43,50
Espirational with Diana Espir,1,0,1,1,106,109
Behind The Glass,1,0,0,1,20,22
The Taproot,0,0,0,1,5,6
The Vegan Fitness Podcast,0,0,0,1,49,50
The Knicks Wall Podcast,3,2,1,1,43,50
Cannabis Cultivation and Science Podcast,1,0,0,0,116,117
For The Love With Jen Hatmaker Podcast,22,8,16,16,438,500
Taringa Podcast,0,0,0,1,20,21
Karl Morris - The Brainbooster,0,0,0,0,7,7
The Ticket: Politics from The Atlantic,13,5,6,6,20,50
The American History Podcast,9,2,1,2,36,50
BLACK HANDS - A family mass murder,3,5,2,6,54,70
The MxU Podcast,0,0,0,1,34,35
Hip Hop Current,0,0,1,1,8,10
Private Practice Workshop,1,0,0,2,34,37
AIN's Tales from the Flight Deck,0,1,0,0,0,1
You're Missing Out,0,0,0,0,4,4
RealTuners Radio,1,0,1,1,6,9
Armstrong & Getty On Demand,7,5,5,2,106,125
Steal the Stars,7,9,6,10,18,50
Bloomberg Business of Sports,4,4,3,2,11,24
BHA Podcast & Blast with Hal Herring,2,1,3,3,79,88
"Less Stressed Life : Upleveling Life, Health & Happiness",0,0,0,0,50,50
Golf's Next Wave,0,0,0,0,5,5
Conversation & Pronunciation: Learn English with The Rachel's English Podcast,1,0,0,1,43,45
Cosmic Crit: A Starfinder Actual Play Podcast,1,0,1,1,47,50
TLDCast Podcast,1,0,0,0,1,2
Stay Wealthy Retirement Show,1,0,0,1,56,58
An American Workplace | A 'The Office' Podcast,1,1,3,2,115,122
Podcast | ice age farmer,1,0,0,0,11,12
The Alisa Childers Podcast,14,3,0,3,233,253
The Chlorine King Pool Service Show,0,0,0,0,6,6
Buffalo Rumblings: for Buffalo Bills fans,3,1,3,3,226,236
Holly Randall Unfiltered,1,2,1,1,45,50
Shut Up & Sit Down,0,0,1,0,49,50
The Drug Classroom,0,0,0,0,15,15
Filmmaking Conversations Podcast with Damien Swaby,0,0,0,1,2,3
HerbRally | Herbalism | Plant Medicine | Botany | Wildcrafting,0,0,0,0,10,10
Life and Crimes with Andrew Rule,11,2,5,7,69,94
Dropping Bombs,2,2,0,0,196,200
Teen Mom Trash Talk,33,14,11,9,433,500
The Right Reality Podcast | MTV's The Challenge,12,2,2,1,96,113
Literaticast,0,0,0,2,37,39
The Bad Crypto Podcast,14,7,5,3,171,200
Golflandia,3,1,0,1,96,101
Stitchery Stories,0,0,1,0,10,11
Gone,5,1,3,6,82,97
KFBK Outdoor Show,0,0,0,0,1,1
Kids Bible Stories,5,0,3,8,217,233
Station to Station,1,2,2,1,12,18
DHARMA FIELD,0,0,0,0,1,1
Curiosity Daily,3,0,4,4,39,50
Silicon Slopes,0,0,0,0,5,5
What's Next! with Tiffani Bova,0,0,0,0,41,41
My Favorite Theorem,1,0,0,1,5,7
Not Your Mom's Romance Book Club,0,0,0,0,30,30
CRYPTO 101,7,2,3,5,99,116
The Music Box,1,0,0,0,8,9
Houston We Have a Podcast,2,3,3,5,72,85
No Simple Road,0,0,1,0,108,109
Planetary Union Network: The Orville Official Podcast,3,2,0,1,26,32
Botanical Brouhaha Podcast,0,0,0,0,21,21
On The Bench,0,1,0,0,13,14
Hollywood Crime Scene,8,2,2,2,36,50
Never Binge Again,1,1,0,1,13,16
Another Lousy Millennium: A Futurama Fan Podcast,0,0,0,1,13,14
CanesCast,1,0,0,2,103,106
"Birds, Booze, and Buds Podcast",4,1,0,4,96,105
Pick Six NFL,40,12,13,9,426,500
Free Man Beyond the Wall,4,1,1,1,85,92
"Keto Lifestyle with Jessica Tye, NTP",5,2,1,2,35,45
Station 71: A Walt Disney World Podcast,2,0,2,1,28,33
Canes Country: for Carolina Hurricanes fans,0,1,0,0,10,11
Method Podcast from Google Design,0,0,0,0,5,5
The Dirty Duner Show,0,0,0,1,43,44
Leaders in Supply Chain and Logistics,0,0,1,1,4,6
Run Eat Repeat,4,1,1,0,22,28
HR Leaders,0,0,0,1,16,17
Rework,0,0,2,2,29,33
The Theatre of Tomorrow,0,0,0,0,20,20
Fanatical Fics and Where to Find Them: A Harry Potter Fanfiction Podcast,0,1,0,0,49,50
Criminology,44,20,26,32,378,500
Cracked Interviews,0,0,0,0,23,23
"Let's Talk About Myths, Baby! A Greek & Roman Mythology Podcast",13,6,8,6,167,200
RV Miles Podcast,1,4,2,1,142,150
Manchester Is Red,1,0,4,2,2,9
The Courtney Sanders Podcast,1,0,3,2,91,97
The Curious Girl Diaries,0,0,1,0,26,27
Oprah’s SuperSoul Conversations,348,132,222,282,1986,2970
The After On Podcast,1,2,3,3,379,388
The Routes Aviation Podcast,0,0,0,0,1,1
Arrowhead Pride: for Kansas City Chiefs fans,10,3,4,6,252,275
Indie Film Grit Podcast,0,0,0,0,3,3
Problem Solvers,0,0,0,0,11,11
"Like Mind, Like Body",3,1,0,4,42,50
Struggle Session,11,2,2,1,37,53
Starting 9,28,5,13,13,286,345
The Training For Ultra Podcast,5,4,3,1,67,80
Make It Happen Mondays - B2B Sales Talk with John Barrows,0,2,1,0,16,19
Gardening With Angelo,0,0,0,0,2,2
Swish and Flick: An All Potter Podcast,17,11,13,12,147,200
Stay Tuned with Preet,33,13,20,27,407,500
BiOptimizers - Awesome Health Podcast,0,0,0,0,11,11
The P.T. Entrepreneur Podcast,0,0,0,0,4,4
Sounds Fake But Okay,0,1,1,0,29,31
It's a Hard Knicks Life,2,1,0,1,69,73
Always Pressing PGA DFS POD,0,0,0,1,5,6
Miss Information: A Trivia Podcast,1,0,0,1,48,50
The Hair Game,0,1,0,2,197,200
Open Space Radio: Parks and Recreation Trends,0,0,0,0,3,3
Lorehammer - A Warhammer 40k Podcast,12,0,2,1,35,50
The Michael Knowles Show,40,12,6,4,220,282
E3 Camping Association,0,0,0,0,2,2
Design Better Podcast,0,3,0,2,39,44
Sequel Rights,0,0,0,0,8,8
RomaPress Podcast,0,1,1,0,33,35
Hacking Your Leadership Podcast,0,0,0,2,39,41
Torah Thinking,0,0,0,0,1,1
Swift by Sundell,0,0,0,0,16,16
The Kevin David Experience (Ninja PodCast),1,0,0,0,38,39
Marsfall,5,6,2,5,32,50
Blaze and Melfunsky Wrestling Podcast,0,0,0,0,2,2
Moderate Rebels,8,0,2,1,34,45
Band Room Podcast,0,0,0,0,2,2
Charge or Die,0,0,0,0,1,1
Fantasy Football Weekly,10,5,3,5,195,218
The Totally Football Show with James Richardson,25,10,16,10,78,139
G.A.S.P.™ GraphicAudio Story Podcast,0,0,0,1,17,18
All Angels Podcast,0,0,0,0,20,20
Rough Translation,10,2,7,5,476,500
My Anime Podcast,0,0,0,0,37,37
Heart Doc VIP with Dr. Joel Kahn,0,0,0,0,23,23
Stronger U Radio with Mike Doehla,0,0,0,0,27,27
Badass Breastfeeding Podcast,0,2,2,0,46,50
The Money Case & The Money Growth,0,0,0,0,4,4
The Faith & Mental Wellness Podcast with Brittney Moses,0,0,0,0,12,12
Elements of Ayurveda,0,1,1,0,42,44
Rev Real Estate School | Real Estate Agent Podcast,0,0,0,0,4,4
Nursing Uncensored,0,0,1,5,11,17
The Rewatchables,61,29,47,58,305,500
The Addicted Mind Podcast,1,2,1,2,44,50
The Buckeye Weekly Podcast,4,1,2,1,61,69
The Consciousness Podcast,0,1,0,0,7,8
Everyday Art Room,0,0,1,2,12,15
The Next Right Thing with Emily P. Freeman,6,4,6,6,478,500
Killer Queens: A True Crime Podcast,45,25,20,23,387,500
Earful of Dirt - The Major League Rugby Podcast,0,1,2,0,7,10
101 Part Time Jobs hosted by Giles Bidder,0,0,0,0,1,1
The Allstarcharts Podcast on Technical Analysis Radio: Current Market Analysis For Traders,0,0,2,0,6,8
Baseball Beyond Batting Average,0,0,0,1,15,16
The Stories We'd Tell in Bars Podcast,4,3,2,2,21,32
Unfocused Podcast,0,0,0,0,1,1
Girl Tales,1,1,3,2,43,50
Fantasy Footballers DFS - Fantasy Football Podcast,15,7,10,17,451,500
The Rag Company Podcast,0,0,0,0,32,32
The Kill Shot podcast by Johnny Battle,2,0,0,0,0,2
Charlotte Mason Poetry,0,0,1,0,18,19
The Thoughtful Travel Podcast,0,0,0,0,12,12
Get It Right with Undercover Architect,0,0,0,0,9,9
Wrestlenomics Radio,0,0,0,0,2,2
Preferred Altitude Podcast:  Unique and Timeless Aviation Podcast,0,0,0,0,1,1
Smart Social Podcast: Keeping students safe so they can Shine Online,0,0,0,2,48,50
Learn Japanese w/ Manga Sensei,2,0,0,2,31,35
The Hoop Ball Los Angeles Clippers Podcast,0,0,0,0,16,16
Fashion Revolution Podcast,0,0,0,0,7,7
Fake Teams,0,0,0,0,10,10
Red Moon Roleplaying,0,1,1,2,9,13
Your Favorite Thing with Wells & Brandi,55,11,21,11,402,500
Hashivenu,0,0,0,0,3,3
Pray the Word with David Platt,0,0,2,2,75,79
Jew Oughta Know,0,0,0,1,5,6
The Sleeping At Last Podcast,1,0,1,1,254,257
CMDR Central,1,0,1,2,19,23
Grassfed Life,0,0,0,0,22,22
Dr. Matt and Dr. Mike's Medical Podcast,1,0,0,1,22,24
Growin' Up Rock,1,0,0,0,25,26
Alpinist,1,2,1,1,10,15
Gun Funny,3,1,0,4,246,254
MoreThanCultr: The PodCast,0,0,0,0,5,5
Shoulder of Orion: The Blade Runner Podcast,2,0,0,0,16,18
Fictional,1,0,1,3,195,200
Charting Pediatrics,0,0,0,1,22,23
Love and Luck,0,0,0,0,26,26
The Playbook,1,1,0,0,198,200
Exploring My Strange Bible,1,0,0,2,496,499
Love to Sew Podcast,6,0,1,2,41,50
The Strange Sessions,7,8,6,5,52,78
Main Street Magic - A Walt Disney World Podcast,0,2,2,7,86,97
bomBARDed - A Musical Dungeons & Dragons Adventure,0,0,0,0,50,50
The Max Maxwell Podcast,0,0,0,0,200,200
Two Girls One Ghost,5,1,1,3,40,50
Small Town Dicks Podcast,64,30,21,12,373,500
Farm Small Farm Smart,0,0,0,1,35,36
Social Media Lab,0,0,0,0,23,23
The Loudini Rock and Roll Circus,0,0,0,0,5,5
FYI - For Your Innovation,0,0,0,2,16,18
The Betchelor,210,49,36,18,187,500
WARDROBE CRISIS with Clare Press,1,0,1,1,26,29
The Extramilest Podcast,0,0,1,2,104,107
Motherfocloir,0,0,1,4,22,27
The Higher Practice Podcast for Optimal Mental Health,0,0,0,1,12,13
HyperChange,0,0,1,0,10,11
Fantasy Fast Track,2,1,4,2,67,76
Honey! I'm Homeschooling The Kids,0,0,1,0,23,24
All Things Catholic with Dr. Edward Sri,0,0,0,1,58,59
NYYST - Yankees Podcast,4,3,1,1,81,90
Greg & The Morning Buzz,0,1,0,0,9,10
Boom: A Serial Drama,6,4,1,8,31,50
Hurry Slowly,1,0,1,0,48,50
Granger Smith Podcast,2,0,0,0,48,50
Dirty John,0,0,0,1,22,23
Inside The Exorcist,21,20,8,19,193,261
Growing Up Punk,0,0,0,1,4,5
"Let's Talk Fish -  Weekly show talking all things fishing anchored by Bryan Thrift, Matt Arey, and J...",1,1,2,2,22,28
Zach Sang: Just The Interviews Podcast,0,0,1,1,24,26
Ag Future: Innovation in Agri-Food,0,0,0,0,2,2
"HIST 119: The Civil War and Reconstruction Era, 1845-1877",1,0,0,0,16,17
Nourishing Women Podcast,0,1,1,2,46,50
Talking Taker,0,0,0,0,7,7
The Durenda Wilson Podcast,1,0,0,1,48,50
Filmstudy - Baltimore Ravens Talk,1,1,2,1,49,54
Counter Apologetics,1,1,0,1,27,30
ABorderPrince Warhammer Lore and History,0,0,0,1,8,9
Political Beats,0,2,4,9,35,50
Eyes on Isles Podcast on the NY Islanders,0,1,0,2,16,19
Growth Mindset Podcast,1,1,3,0,29,34
Scary Mysteries,6,0,4,5,60,75
Opera For Everyone,1,2,1,1,17,22
The NewsWorthy,8,1,3,1,37,50
Chair of Swords,0,0,1,0,2,3
Best of Both Worlds Podcast,8,11,9,8,87,123
How Good It Is,0,0,0,0,8,8
Against The Grain Podcast,3,0,1,2,40,46
Corporate Lunch,9,5,7,4,39,64
Hostile Worlds: Exploring Space,0,0,0,2,21,23
Cricket Badger Podcast,0,0,0,0,1,1
New England Legends Podcast,0,0,0,3,103,106
The Ken Coleman Show,18,6,2,6,126,158
Knowing Faith,0,2,1,6,118,127
Jews You Should Know,0,0,0,0,15,15
One Heat Minute Productions,0,0,0,0,21,21
The Critical Thinking Initiative,0,0,0,0,3,3
Eagle's Eye View: Your Weekly CV Update From ACC.org,0,0,0,1,2,3
Uncivil,2,1,0,1,46,50
Wrestling Omakase,3,0,0,0,6,9
The Virtual Couch,0,0,0,2,48,50
DISGRACELAND,83,25,30,19,343,500
Packernet Podcast: Daily Green Bay Packers Podcast,2,1,3,0,44,50
Angel - hosted by Jason Calacanis,0,0,0,0,50,50
The Complete Podcast,0,0,0,0,6,6
Accelerate Your Success with Amanda Tress,0,0,0,0,6,6
User friendly,0,1,0,0,7,8
Splintered Caravan,0,1,0,0,17,18
IDP Nation,0,0,0,0,17,17
The Auburn Undercover Podcast,2,1,1,5,26,35
SteadyTrade,0,1,2,1,46,50
The Alina Show,0,0,0,0,21,21
Cult Podcast,31,14,15,7,209,276
The Evolution of Horror,0,0,0,0,71,71
The Woodworking Morning Show (Audio),0,1,0,0,4,5
LBJ and the Great Society,1,0,0,1,48,50
Happy Mind: Meditations from the Ancient World to Modernity,0,0,0,1,17,18
Beyond Clean Podcast,0,0,0,1,15,16
Solutions to Problems,0,0,0,0,16,16
That SEC Football Podcast,0,1,0,0,499,500
Happy Mum Happy Baby,2,3,4,0,38,47
The Bow Tie Chronicles – Atlanta Falcons,0,0,1,1,3,5
Compliance Mastermind: Strategies for your healthcare compliance program and your career,0,0,0,0,10,10
Vegas Nation - Raiders Football,6,1,0,2,7,16
Going Deep,60,8,12,8,139,227
"Ladies, We Need To Talk",0,0,1,0,15,16
First Things First,57,19,28,32,133,269
Barstool Pick Em,13,2,11,2,94,122
Spark Joy,0,0,0,2,48,50
Andrew Talks to Chefs,2,1,0,3,77,83
Art Side of Life,0,0,0,0,19,19
Triathlon Taren Podcast,2,1,2,3,158,166
Tumanbay,3,2,2,2,41,50
Feed The Ball,0,0,0,0,30,30
Change Lab: Conversations on Transformation and Creativity,0,0,0,0,17,17
Bengals Booth Podcast,1,0,1,0,27,29
LOVELINK,1,0,0,2,38,41
Larkspur Underground,0,0,1,3,22,26
shunned,0,1,0,2,42,45
Through the Wire,5,4,4,6,480,499
Dyking Out - a Lesbian and LGBTQIA Podcast for Everyone!,2,0,0,0,48,50
The Gut Loving Podcast: All about IBS & the low FODMAP diet,1,2,0,3,10,16
The Narcissist in Your Life Podcast,0,1,0,0,27,28
Tesla: The Life and Times Podcast,1,1,1,3,33,39
Ologies with Alie Ward,6,2,3,5,484,500
crunch,0,0,0,1,3,4
Girls Night with Stephanie May Wilson,0,0,3,5,492,500
Strange Indeed a Fancast for The Stand,5,2,3,5,35,50
Dark Side Of Psychology,1,0,1,0,1,3
Magickando,0,0,0,0,1,1
Snap Judgment Presents: Spooked,7,10,24,26,133,200
I Only Listen to the Mountain Goats,0,2,4,2,42,50
What's The Frequency?,2,1,3,2,26,34
Dr. Bond’s Life Changing Wellness,0,0,0,0,15,15
It Makes A Sound,4,2,3,3,38,50
"RealiTV Recaps Married at First Sight, 90 Day Fiance & Sister Wives",21,4,7,4,273,309
Half Hour of Heterodoxy,3,0,0,1,11,15
The Learning Scientists Podcast,0,0,0,0,11,11
Lights Camera Barstool,14,5,5,2,467,493
Everything Iconic with Danny Pellegrino,13,2,8,9,468,500
Every Horror Movie On Netflix,0,2,0,2,20,24
Couch Wisdom,0,0,1,1,9,11
Three Guys Before The Game,1,1,1,1,68,72
Dark Histories,2,1,1,4,42,50
Scrubbing In with Becca Tilley & Tanya Rad,86,23,23,11,357,500
"Horns247 Podcasts: Longhorn Blitz, The Flagship, and State of Recruiting",2,2,2,4,113,123
TDN Fantasy,0,2,0,0,17,19
WNBA Nation,1,0,1,1,29,32
Greatest Show on Dirt,0,0,0,0,24,24
The Hockey Podcast Network,0,0,1,0,3,4
The Filmmakers Podcast,0,0,0,0,17,17
The Week in Art,0,0,1,1,6,8
Planet FPL - The Fantasy Football Podcast,0,0,0,0,8,8
Merely a Setback: A Podcast about Storytelling in the World of Warcraft,8,4,1,2,54,69
Paranormal Almanac,6,1,0,2,38,47
The Totally Football League Show,2,0,0,0,11,13
Pat Gray Unleashed,4,1,3,1,41,50
Dog Works Radio,0,0,1,1,21,23
The Great Books,9,0,5,5,100,119
Guided Meditations by One Mind Therapy,0,0,1,0,1,2
Canucks Central,1,0,0,0,0,1
The Humble Mechanic,1,1,2,0,11,15
Chasing Scratch: A Golf Podcast,0,0,2,4,197,203
Girl In Space,1,2,0,2,45,50
Words On Water,0,0,0,1,3,4
Spoken Garden Podcast,0,0,0,0,1,1
The Cryptid Cases,0,0,3,0,13,16
The American War,10,7,6,7,20,50
AsianBossGirl,1,3,3,3,139,149
Mindfulness+ with Thomas McConkie,0,1,0,0,76,77
Birds With Friends: A show about the Philadelphia Eagles,17,12,9,7,455,500
Hey YA,0,4,3,2,11,20
Corruption Crime & Compliance,0,0,0,0,3,3
Short Story,8,0,0,0,0,8
Calm Parenting Podcast,1,0,1,0,24,26
Redefining Wealth with Patrice Washington,0,0,0,3,306,309
Grief and Rebirth: Finding the Joy in Life Podcast,0,0,0,1,9,10
The Couples Therapist Couch,1,0,0,1,42,44
"Rebel Traders™ Podcast - Stock Market Trading Strategies, Insights & Analysis with Sean Donahoe & Ph...",1,0,1,1,32,35
Mark Groves Podcast,3,2,4,5,486,500
"Building HVAC Science -Comfort, health & energy efficiency",0,1,0,0,6,7
Power Problems,0,0,1,0,9,10
WagerTalk,7,3,4,9,12,35
Boom! Lawyered,1,0,1,0,48,50
The Migraine Miracle Moment,2,1,0,0,19,22
Speaking Brazilian Podcast,0,0,0,0,5,5
The Annex Sociology Podcast,0,1,0,1,4,6
Inside INdiana Business,0,0,0,0,1,1
Space Cats Peace Turtles,0,0,0,1,49,50
The Silicon Valley Insider Show with Keith Koo,0,0,0,0,12,12
Trauma-Informed Lens,3,0,0,1,3,7
Neon Brainiacs (80s Horror Podcast),0,0,1,0,34,35
The Long Run with Luke Timmerman,1,0,3,1,10,15
Listen Out Loud with The Loud House,5,0,3,1,41,50
Autzen Audibles: DuckTerritory's Oregon athletics podcast,1,1,3,2,37,44
THE HISTORY OF FOOD,3,1,1,0,22,27
ReMade,1,3,0,7,2,13
Ghostpuncher Corps,0,1,1,0,13,15
The Jim Jefferies Show Podcast,39,4,2,0,5,50
The Embodiment Podcast,4,0,1,2,21,28
Motivation Minute,0,0,0,1,18,19
2 Girls 1 Podcast,0,1,3,1,22,27
Techtonic with Mark Hurst | WFMU,0,0,0,0,3,3
Big Data Beard,0,0,0,0,8,8
Future Cities,0,0,0,0,2,2
Together Live Presents: Do it on Purpose,0,0,0,0,16,16
Level Design Lobby,0,0,0,0,6,6
BoxTrick: A Retro Gaming Podcast,1,1,1,1,16,20
Mommin' Ain't Easy the Podcast,1,0,1,0,36,38
"Sex, Birth & Trauma with Kimberly Ann Johnson",2,0,2,1,31,36
Mercury: A Broadcast of Hope,0,0,1,0,15,16
Professor Slots,1,0,0,1,6,8
The Cross Stitch Podcast,0,0,0,1,17,18
The Dave Ryan Show,5,2,4,1,21,33
Cults,69,54,63,63,195,444
Dr. Joseph Mercola - Take Control of Your Health,3,4,1,1,31,40
Legal Speak,0,0,1,0,4,5
Intelligence Matters,32,13,17,8,201,271
Better in Bed | A Sex & Sexuality Podcast,0,0,1,0,3,4
Inside Selling,0,0,0,1,17,18
Reasons to be Cheerful with Ed Miliband and Geoff Lloyd,5,1,5,7,121,139
Technado with Don Pezet (Audio),0,0,0,0,11,11
The Wild Life,0,1,0,0,12,13
Other Men Need Help,0,0,0,2,69,71
HACKED: Into the minds of Cybersecurity leaders,0,0,0,1,6,7
Entrepreneur Stories 4⃣ Inspiration,1,0,0,1,98,100
What Have You,2,1,2,0,88,93
This Naked Mind Podcast,0,1,5,5,39,50
Wahaj Tarin,0,0,0,0,2,2
American Suburb,4,0,1,1,21,27
"Help! I Suck at Dating with Dean, Jared & ....",113,57,45,53,232,500
Palimpsest,2,2,3,4,39,50
Project Upland Podcast,3,1,1,2,228,235
The Greatest Discovery: New Star Trek Reviewed,4,0,3,2,228,237
Sum of All Parts,0,0,1,1,15,17
How Success Happens,0,0,1,0,62,63
Ad Age Ad Lib,0,1,1,1,6,9
RealTalk MS,1,1,0,0,23,25
51 First Dates,2,2,3,6,174,187
Enlightenment Radio,0,0,0,0,3,3
"The ""Daily Call"" From Option Alpha",0,0,0,0,48,48
Periodic effects Cannabis Business & Science,0,0,0,0,30,30
Clients on Demand,1,0,4,3,42,50
RotoViz Overtime,0,0,0,3,29,32
College Football Fantasy Pod,1,0,0,0,1,2
Dynasty Tradecast,1,0,1,1,18,21
RotoViz Fantasy Football Show,0,0,1,0,4,5
Around the World in 80s Movies,0,0,0,0,8,8
ChinaTalk,3,0,5,1,16,25
Court-Side with Beilinson Tennis,0,0,0,0,4,4
Veggie Doctor Radio,0,0,0,1,33,34
Roll For Combat: Paizo's Official Pathfinder & Starfinder Actual Play Podcasts,2,1,2,0,45,50
Deadly Manners,8,7,2,2,31,50
Living Proof with Beth Moore,2,4,1,6,46,59
The Daily Zeitgeist,34,16,18,12,420,500
Benevolent Dictator with Jordan Raybould,1,0,0,0,49,50
Quest Friends!,0,0,0,0,18,18
The Art of ...,0,0,0,0,1,1
Runners On Trail,0,0,0,0,1,1
Talking About Cars with Randy Kerdoon,0,0,0,0,6,6
Experience This!,0,0,0,0,18,18
The Speaking Club: Mastering the Art of Public Speaking,0,0,0,0,12,12
The Modern Retail Podcast,0,0,0,0,7,7
PFT PM,13,2,4,3,100,122
Locatora Radio [A Radiophonic Novela],1,0,1,0,122,124
DLWeekly Podcast - Disneyland News and Information,4,4,4,5,76,93
The Perfectionism Project,3,0,0,3,24,30
Great Shot Podcast,0,1,0,0,22,23
"Reality NSFW with Jonny Fairplay: Survivor, Big Brother, The Amazing Race, The Challenge",10,6,4,3,49,72
Force Material: A Star Wars Podcast,0,1,0,0,11,12
The Sarah Prout Podcast,0,0,1,1,48,50
The One Who Got Away,0,0,1,0,6,7
Heat Rocks,0,0,1,0,49,50
Financial Residency with Ryan Inman,1,0,0,0,42,43
Enlightened Empaths,3,5,1,3,95,107
Hit Parade | Music History and Music Trivia,16,2,3,2,27,50
Bisexual Real Talk,3,0,0,1,4,8
Bacon and Eggs: A Movie Lover's Podcast,1,0,4,2,99,106
The Remnant with Jonah Goldberg,5,0,3,0,42,50
The Diary Of A CEO by Steven Bartlett,1,1,1,1,355,359
The Science of Sex,0,0,2,2,22,26
Sundial,0,1,0,0,1,2
History That Doesn't Suck,2,0,4,3,41,50
"Clean Eating for Women with Carrie Forrest, MPH in Nutrition",0,0,0,2,38,40
Success is a Choice,0,0,0,0,16,16
UMSO,1,0,2,0,47,50
The Lucky Die,0,0,1,1,48,50
CharlaGolf podcast,0,0,0,0,1,1
The Death of Dr. John Parker,14,8,4,1,23,50
Boys In The Cave,0,0,0,0,5,5
The Garden Log,0,0,0,0,9,9
The Phenomenon,1,1,3,4,41,50
Chasing the Horizon - Motorcycles and the Motorcycle Industry In Depth,0,0,0,0,8,8
Pinna Originals Playlist,11,4,4,2,11,32
Strong Mind Sports with Clint McGill,0,0,0,0,9,9
Heaven's Gate,2,3,4,6,35,50
The Fierce Marriage Podcast,2,6,10,18,464,500
The Funk'tional Nutrition Podcast,1,0,1,2,46,50
"Austin Anthem Podcast: Austin FC, Soccer, and Supporters Group News, Interviews, & Updates",1,0,0,0,14,15
When to Jump,1,1,0,1,30,33
Explain Me,0,0,1,0,6,7
Dementia Matters,1,0,0,0,2,3
Fistaz Mixwell,0,0,0,2,8,10
The Raw Dog Food Truth,1,3,2,1,10,17
Wretched Radio,7,2,3,5,250,267
The Racing Writer's Podcast,2,0,1,0,28,31
Birth Kweens,3,1,3,1,42,50
The Full 60 with Craig Custance,1,0,0,1,186,188
Millennials Are Killing Capitalism,2,0,0,1,8,11
Crooked Minis,11,7,4,7,235,264
Modernist BreadCrumbs,0,1,0,0,6,7
Speak the Language,1,0,0,4,258,263
Talk About the Passion,0,0,0,0,8,8
Hotline League,0,0,1,1,11,13
Child Care Rockstar Radio,0,0,0,0,39,39
WSJ Secrets of Wealthy Women,4,7,2,5,62,80
Superduperstitious,0,0,0,0,35,35
The Enneagram Journey,1,0,7,1,201,210
Victoriocity,0,0,1,2,47,50
The School of Morton Podcast with Ricky Morton and Scotty Campbell,3,1,0,3,16,23
Let It Roll,0,0,0,0,8,8
Voir Dire: Conversations from the Criminal Justice Policy Program at Harvard Law School,0,0,0,1,9,10
Tax Notes Talk,0,0,1,0,0,1
Unplaced | an audio drama,1,0,2,5,26,34
Haunted Places,33,31,39,25,372,500
StarDate Podcast,2,0,1,1,8,12
Collective Insights,0,0,9,11,136,156
Thankful Homemaker: A Christian Homemaking Podcast,0,1,1,2,140,144
The Buzz About Bees,0,0,0,1,4,5
2298,1,0,1,4,37,43
Brilliant Balance,0,0,0,0,90,90
Siim Land Podcast,0,0,1,0,32,33
Off-Nominal,0,0,0,0,3,3
The Impact,9,9,0,6,232,256
The Florida Roundup,0,1,0,0,1,2
Mediums in Action,0,0,0,0,7,7
GZero World with Ian Bremmer,4,0,0,0,8,12
The How-To Heretic,3,2,1,2,156,164
The Great Song Podcast,0,1,0,1,20,22
GraveYard Tales,2,4,6,9,479,500
Heaving Bosoms: A Romance Novel Podcast,1,0,1,1,197,200
Pretend Friends - Tabletop RPG Adventures,0,0,2,0,48,50
2 girls talking about sex,0,0,3,1,4,8
Jesus is Better: Bible Stories with Gospel Joy,0,0,2,1,22,25
Lead to Win,4,1,5,6,184,200
The  Period  Party,0,1,0,0,21,22
Supreme Court Audio Podcast,0,0,0,0,2,2
POLITICO Money,2,6,3,5,16,32
Astral Codex Ten Podcast,0,0,0,0,11,11
Marriage Therapy Radio,4,0,6,1,39,50
Mindful In Minutes,1,0,0,0,49,50
The 1-3-20 Podcast,0,1,0,2,13,16
The Big Ones,0,0,0,0,50,50
Hack or Slash - A Horror Movie Review Podcast,1,0,2,0,19,22
Another Kingdom,3,0,4,1,42,50
CLAIMED — Feminine/Masculine Polarity. Femininity. Embodiment.,2,1,1,0,105,109
Darknet Diaries,6,0,0,0,216,222
FReality - VR Podcast,0,0,0,2,10,12
Light Years: A Golden State Warriors Pod,11,2,3,1,67,84
The Aloha 360,0,0,0,0,23,23
Flightsim Community Podcast,0,0,1,0,3,4
Hagerty Sidedrafts: Cars | Classics | Racing,1,0,0,0,4,5
Gang Green Nation: for New York Jets fans,0,0,0,0,11,11
Make Money as a Life Coach,0,0,0,0,50,50
The Art of Film Funding,0,0,0,0,1,1
3 in 30 Takeaways for Moms,0,1,0,0,49,50
Podcast: The Ride,1,0,0,0,49,50
"Seven: Disturbing Chronicle Stories of Scary, Paranormal & Horror Tales",65,46,33,23,245,412
My Favourite Elliott Smith Song,0,0,0,0,8,8
Sean of the South,0,0,0,0,36,36
The Sopranos Show,1,1,0,3,78,83
The Night Owl Podcast,1,0,1,2,164,168
Restaurant Fiction,0,0,0,0,11,11
Behind the Racquet Pod,1,0,2,1,17,21
Dungeons and Demogorgons - A Stranger Things Podcast,6,1,4,1,96,108
Your Own Magic,6,3,5,1,422,437
The New Yorker Comment,0,0,0,1,5,6
Lez Hang Out | A Lesbian Podcast,0,0,2,2,49,53
#YourTorah,0,0,0,0,1,1
The Broadswords,0,0,0,2,48,50
The Grow Guide,1,0,1,0,6,8
Dying Alive,1,2,0,1,7,11
Slow Radio,9,1,1,2,6,19
The Unexplored Places,0,1,1,0,27,29
Book Marketing Show Podcast with Dave Chesson,0,0,0,0,35,35
"Hey, Beautiful! A How I Met Your Mother Podcast",0,0,1,1,60,62
I Don't Have Enough FAITH to Be an ATHEIST,13,5,1,3,446,468
Core IM | Internal Medicine Podcast,0,1,1,2,46,50
The World Nomads Travel Podcast,0,0,0,0,5,5
A Killing On the Cape,26,16,28,24,120,214
Valuetainment Episodes,5,1,3,3,113,125
Brooklyn Buzz: A Brooklyn Nets Podcast,0,0,1,2,14,17
Southern Mysteries Podcast,0,0,2,0,48,50
The Ethics Podcast - With Rabbi Yaakov Wolbe,0,0,0,0,2,2
Pitch List,2,0,3,1,22,28
Raising a Powerful Girl,0,0,0,0,13,13
The Angry Therapist Podcast,1,5,2,2,40,50
Projectified,0,0,1,1,6,8
XO Marriage Podcast,0,1,0,0,28,29
Dragon Ball Super Dope,1,0,1,0,16,18
Marketing Your Business - Marketing Strategies for Business Owners,0,0,0,1,49,50
Taco the Town,0,0,0,0,8,8
"Fascinating Gadgets, Gizmos, and Gear Based Technologies",0,0,0,0,2,2
Ridiculous History,9,5,8,7,21,50
Why Theory,2,0,0,2,36,40
This Podcast Will Kill You,42,21,17,12,408,500
Memory in Top 40 Music,0,0,0,0,8,8
Energy Week,2,0,0,0,5,7
The Witch Wave,1,0,0,1,143,145
The Paris Review,1,0,1,1,74,77
Negotiations Ninja Podcast,1,0,0,2,29,32
Clean Break with Matt Gondek,0,0,1,1,22,24
Dude Grows Show Cannabis Podcast,2,0,1,1,8,12
We Met At Acme,34,14,12,17,379,456
This is My Bourbon Podcast,2,0,2,0,36,40
Shojo & Tell: A Manga Podcast,1,0,0,0,7,8
Casual Cinecast: Blockbuster Movies to Criterion & Classic Film,2,0,0,0,46,48
I Guess That's Why They Call It The Elton John Podcast,0,0,1,1,8,10
Lonesome Pine Podcast,9,5,6,4,18,42
ABA Banking Journal Podcast,0,0,0,0,2,2
"What Next: TBD | Tech, power, and the future",6,4,5,5,28,48
The Big Loop,2,1,3,2,42,50
Watch What Happens Live with Andy Cohen,19,2,4,5,93,123
The Authentic German Learning Podcast: Deutsch lernen wie ein Baby | Learn German online | Personal ...,0,0,0,0,10,10
Everything Trying to Kill You,0,0,0,0,25,25
The Ultra Stories Podcast,3,1,2,0,10,16
Pimped: Ob/Gyn,0,0,0,0,14,14
Down The Garden Path Podcast,0,0,1,0,0,1
Pop Culture Man Children,0,0,0,0,3,3
3.55,0,0,0,0,2,2
Andy Rasool - Talking Supercars With SupercarTribe.com,0,0,0,0,3,3
The FOX News Rundown,28,3,4,5,10,50
The Tiny Meat Gang Podcast,4,1,0,0,45,50
Behavioral Grooves Podcast,0,1,0,2,24,27
20 Minute Fitness,1,3,3,4,39,50
SANDCAST: Beach Volleyball with Tri Bourne and Travis Mewhirter,0,0,1,1,16,18
Cocaine & Rhinestones: The History of Country Music,2,0,1,0,47,50
Wine & Spirits with Monica the Medium,1,0,2,4,493,500
General Intellect Unit,0,0,0,0,8,8
Theory of Content,1,1,0,1,25,28
Movie Crush,24,22,14,32,208,300
Things I Learned Last Night,1,0,0,0,49,50
Froning and Friends,5,5,6,7,109,132
60 Mindful Minutes,0,0,0,0,12,12
Class Bravo,0,0,0,0,3,3
Dark Poutine - True Crime and Dark History,22,11,11,11,340,395
Inside Running Podcast,0,0,0,0,4,4
Table Manners with Jessie Ware,32,30,54,41,343,500
Attachment Theory in Action with Karen Doyle Buckwalter,0,1,0,1,13,15
Immune,3,0,0,0,18,21
Classical Stuff You Should Know,2,2,1,1,44,50
Coffee Convos Podcast with Kail Lowry & Lindsie Chrisley,64,16,30,42,494,646
Weekly Motivation by Ben Lionel Scott,0,0,0,1,12,13
Britney's Gram,14,2,6,2,70,94
Cameron Chronicles,0,0,0,0,3,3
The Beatles Naked,0,1,0,3,23,27
"The Fairer Cents: Women, Money and the Fight to Get Equal",3,1,0,4,87,95
Evolve with Pete Evans,2,1,0,0,11,14
Motion Hatch: Helping Motion Designers Do Better Business,0,0,0,3,23,26
Tracks,0,0,1,1,8,10
For The Many,12,5,7,13,61,98
Kifarucast,4,1,4,12,479,500
First Team Podcast,0,0,1,0,0,1
Feminist Frequency Radio,20,1,0,3,46,70
The Holistic Herbalism Podcast,0,0,0,0,50,50
Better Faster Podcast,0,1,0,2,44,47
The Selby Is Godcast: A Cleveland Indians podcast,0,1,2,0,79,82
Buddhist Chanting,0,0,0,1,0,1
The Casual Birder Podcast,1,0,0,0,22,23
The Option Genius Podcast: Options Trading For Income and Growth,9,0,1,0,25,35
Me And My Golf Podcast,0,1,1,3,17,22
Tudors Dynasty Podcast,2,1,3,2,42,50
The Founder Hour,0,0,0,0,18,18
Middle:Below,1,0,1,0,17,19
GEAR:30,1,0,0,2,63,66
Our Pets Health: with Dr Alex,0,0,0,0,2,2
SouthBound,0,0,0,1,25,26
Photo Geek Weekly,1,0,0,1,13,15
Switchblade Sisters,1,0,1,0,124,126
Swindled,113,46,38,21,282,500
Teaching with Madly Learning®,0,0,0,0,1,1
The Ice Garden,1,0,0,1,4,6
The Empowering Neurologist Podcast,1,0,0,1,2,4
Majority 54,2,2,1,3,42,50
The Art of World Building: Creating Breakout Fantasy and Science Fiction Worlds In Stories and Gamin...,0,0,0,1,5,6
Backpacking & Blisters,2,0,0,5,62,69
The Unexpectables,0,2,2,2,44,50
NOAA Ocean Podcast,0,0,0,0,6,6
Lawful Stupid: A DnD 5e Actual Play Podcast,0,0,1,1,48,50
Grappling Rewind: Breakdowns of Professional BJJ and Grappling Events,0,0,0,0,3,3
Billy Yang Podcast,0,0,0,1,108,109
Outliers - Stories from the edge of history,0,0,0,0,14,14
Animal Spirits Podcast,3,3,5,5,184,200
Residence of Evil Podcast,0,0,0,0,3,3
The Modern Therapist's Survival Guide with Curt Widhalm and Katie Vernoy,0,0,0,1,30,31
PA Power Podcast: College Edition,0,0,0,0,1,1
Dads Drinking Bourbon,1,1,0,1,147,150
"Broken Record with Rick Rubin, Malcolm Gladwell, Bruce Headlam and Justin Richmond",27,20,16,22,153,238
All Creatures Podcast,1,1,1,2,91,96
Group Chat,0,1,1,1,47,50
The Weekly Typographic,0,0,0,0,1,1
NATURE on PBS,0,0,0,0,3,3
The Chad Prather Show,1,0,0,0,49,50
The Confident Single Woman,2,1,1,2,80,86
Cloud Accounting Podcast,0,0,1,0,49,50
"Broken, Alaska",0,0,0,0,4,4
The Outer Limits Podcast,0,0,0,1,19,20
Story,1,0,1,2,11,15
The Exam Room by the Physicians Committee,1,1,0,2,46,50
Sail On: The Beach Boys Podcast,0,0,0,0,50,50
The Insurance Guys Podcast,1,0,0,0,40,41
The AIAS Game Maker's Notebook,0,0,0,0,7,7
Raising Your Paws- Your resource for dog & cat pet parents,0,0,0,0,23,23
Toure Show,2,0,1,3,83,89
Millionaires Unveiled,4,1,2,0,84,91
Straight from the Stands : An Unapologetic LA Galaxy Podcast,0,1,0,0,3,4
The SG Tour Report from Secret Golf,0,0,0,0,3,3
Personality Junkie Podcast,3,3,0,0,2,8
Fox Sports Radio Weekends,1,0,1,0,20,22
Bloom and Grow Radio,1,2,1,2,44,50
The College Investor Audio Show,0,1,1,0,2,4
American History Tellers,5,2,2,2,39,50
The Daily Signal Podcast,7,1,2,2,38,50
Sunday Night's Main Event,1,1,2,0,8,12
The freeCodeCamp Podcast,0,1,0,1,47,49
IYAGI - Natural Korean Conversations For Learners,0,0,0,0,3,3
FreshNP's podcast,1,0,0,2,1,4
Norma Kamali Life,0,0,0,1,22,23
U Up?,6,2,3,3,36,50
Speak English with Tiffani Podcast,0,0,0,0,3,3
Around The Block,2,0,0,0,1,3
Learn English with EnglishTVLive,0,0,0,0,3,3
The Biology of Superheroes Podcast,0,0,0,3,23,26
All In with Chris Hayes,21,7,10,19,141,198
The ReidOut with Joy Reid,47,13,21,37,123,241
Mastering Diabetes Audio Experience,0,0,3,2,45,50
The Kink Academy Podcast,0,0,0,0,1,1
The Amelia Project,4,0,2,4,40,50
The California Report Magazine,0,0,1,0,6,7
Why Won't You Date Me? with Nicole Byer,13,4,6,10,467,500
Slow Burn,10,4,2,1,33,50
The Marketing Secrets Show,2,1,0,0,45,48
Weekly Energy Boost,0,0,0,0,34,34
Scale Model Podcast,0,0,1,2,3,6
Listing Agent Lifestyle - Real Estate Marketing,1,0,0,0,6,7
ElkShape,3,1,1,0,45,50
Wild Flower (Half) Hour,0,0,0,1,0,1
We Watched A Thing,2,0,0,1,60,63
You Must Remember Manson,4,3,5,6,32,50
Deviate with Rolf Potts,0,0,0,0,20,20
Solid Joys Daily Devotional,0,0,1,1,53,55
The Final Word Cricket Podcast,0,0,0,0,5,5
The Last Word with Lawrence O’Donnell,18,4,6,10,120,158
The Bob Lefsetz Podcast,6,3,3,1,29,42
Woman Evolve with Sarah Jakes Roberts,0,0,0,1,7,8
Living Skin by Dermalogica,0,0,0,0,10,10
Village Global's Venture Stories,1,2,3,1,8,15
My First Time,0,2,0,1,3,6
So Very Wrong About Games,5,4,4,2,16,31
The Franciska Show,0,0,0,0,28,28
The Doctor's Kitchen Podcast,2,2,3,3,81,91
First Ring Daily,0,0,0,0,2,2
What Bitcoin Did,4,0,2,2,192,200
Kowabana: 'True' Japanese scary stories from around the internet,1,1,1,0,57,60
The Wheelhouse with Jerry Dipoto,0,0,1,2,12,15
Medicine Stories,0,0,2,2,200,204
Duolingo Spanish Podcast,65,25,45,60,525,720
A Message to Lightworkers,0,0,0,0,2,2
Bravo Happy Hour,38,13,17,9,120,197
The Orisha Wisdom Podcast,1,0,0,0,12,13
Guerrilla Social Work Podcast,1,1,0,1,16,19
The Mindvalley Podcast with Vishen Lakhiani,4,0,0,2,24,30
The Mismatch,29,5,11,13,359,417
New Player Has Joined,13,4,10,3,222,252
MURDERISH,52,38,28,26,196,340
Animals To The Max Podcast,0,0,0,0,35,35
Tailosive Tech,5,4,3,11,101,124
Two Dykes and a Mic Podcast,2,0,0,1,41,44
Trillions,2,1,1,1,12,17
Omnibus,17,1,0,1,31,50
This Podcast Has Fleas,6,3,2,8,31,50
Law To Fact,1,0,0,1,14,16
Waist Away: The Intermittent Fasting & Weight Loss Podcast,2,2,0,0,46,50
The Boo Crew,2,2,1,1,97,103
Mind Love ♡ Modern Mindfulness,0,0,0,0,50,50
Pink Shade,26,10,12,9,349,406
Dave and Dujanovic,1,1,1,0,5,8
"Dating, Relationships, and Love (DRL)",0,0,0,1,31,32
Garage Gym Athlete,0,0,0,0,50,50
The Drone Trainer Podcast,0,0,0,0,17,17
The Fortnite Podcast,2,1,0,2,45,50
The Intuitive Customer - Improve Your Customer Experience To Gain Growth,0,1,0,0,7,8
Hairbrained Conversations,0,1,0,0,16,17
The Secret Podcast,0,0,0,1,5,6
"Real Talk with Dana | body image, non-diet nutrition and health at every size",2,0,0,0,48,50
Command Line Heroes,1,1,5,3,38,48
Electrek,9,8,5,1,22,45
Better Together with Maria Menounos,1,0,1,0,48,50
The Indicator from Planet Money,80,38,74,54,488,734
Off the Woodwork,0,2,0,1,8,11
Peds Soup: A Pediatrics Podcast,0,0,0,0,7,7
Cryptic Chronicles,1,0,0,0,5,6
Duggan Hill,1,0,2,2,23,28
Celtic Myths and Legends Podcast,0,0,0,1,45,46
Love People Use Things,0,0,1,0,21,22
Ham Radio Workbench Podcast,0,0,0,1,13,14
What'sHerName,2,0,1,1,46,50
Only in America with Ali Noorani,0,0,0,1,3,4
Manifestation Babe,0,1,1,1,47,50
Conspiracy Unlimited: Following The Truth Wherever It Leads,33,6,9,12,126,186
Third Pod from the Sun,0,0,0,0,7,7
AI with AI: Artificial Intelligence with Andy Ilachinski,0,0,0,0,12,12
Let's Talk About It With Taylor Nolan,46,0,0,0,4,50
A Podcast with Charlie Swenson - To Hell and Back,0,0,0,0,10,10
Endless Thread,39,16,23,17,170,265
Women Who Travel,5,4,5,5,27,46
Regular Car Reviews Podcast,0,0,1,0,11,12
The Mouse and More Podcast - Disney News and Reviews,4,0,1,1,54,60
Fashion Unzipped,0,0,0,0,3,3
Spiritual Queen's Badass Podcast,0,0,1,0,9,10
Big Biology,0,1,0,0,9,10
This Week in Immigration,0,0,0,1,2,3
Reversing Climate Change,1,0,0,0,61,62
CorConsult Rx: Evidence-Based Medicine and Pharmacy,0,1,2,1,38,42
Tides,1,1,3,2,34,41
The Wire Stripped,0,1,1,0,30,32
The Constant: A History of Getting Things Wrong,3,4,1,1,41,50
Bitcoin & Crypto Trading: Ledger Cast,1,0,0,0,32,33
Pickle,3,1,0,7,39,50
Crime Junkie,154,77,91,84,1666,2072
Your Favorite Band Sucks,99,18,15,13,355,500
The Cricket Ultras Podcast,0,0,0,0,1,1
Community Chickens,0,0,0,1,3,4
Serendipity City,0,0,0,0,5,5
Tips With Toni,0,0,0,0,14,14
Capital Weather Gang,0,0,0,0,1,1
Problematic Women,5,1,0,0,45,51
The Nocturnists,0,0,0,0,46,46
Go Fact Yourself,0,0,0,2,48,50
Behind The Trial,0,0,0,2,6,8
Keto Naturopath,1,0,0,0,11,12
The Multiorgasmic Mama: sexuality | motherhood | relationships | spirituality | intimacy | postpartu...,0,1,0,1,31,33
Startup Hustle,3,1,1,0,28,33
The Secret To Success with Antonio T Smith Jr,0,0,0,0,14,14
The Simply Luxurious Kitchen - Seasonal Fare to Elevate the Everyday Meal,0,0,0,0,4,4
Gensler Design Exchange,0,0,0,0,1,1
Say Your Mind,1,1,0,0,16,18
Pit Lane Parley,0,1,1,0,30,32
Atlanta Monster,171,78,67,45,139,500
Make it Stop: A Bad Music Podcast,2,2,0,0,13,17
The Back of the Range Golf Podcast,1,0,1,0,69,71
Golazzo: The Totally Italian Football Show,0,0,0,0,33,33
Keep It!,91,50,53,36,270,500
Kalila Stormfire's Economical Magick Services,1,0,0,2,39,42
The Insight,2,4,5,3,74,88
Station Blue,10,5,4,0,31,50
The Financial Samurai Podcast,9,1,0,2,36,48
Podnews podcasting news,1,0,0,0,16,17
Punch Up The Jam,4,3,4,2,37,50
Morning Report,0,0,0,0,9,9
Sunday Basket Paper Organization Podcast,0,2,0,0,7,9
15-Minute Matrix,1,0,0,1,24,26
Science History Podcast,0,0,0,0,10,10
Sports? with Katie Nolan,15,6,9,6,464,500
Otis Jiry's Scary Stories Told in the Dark: A Horror Anthology Series,1,1,5,2,41,50
The Episodic Table of Elements,0,0,0,0,15,15
The Sheepspot Podcast,0,0,0,0,21,21
No One Can Know About This: A Podcast Where We Play Every Final Fantasy,2,0,1,1,109,113
The Golfers Journal Podcast,4,0,0,0,15,19
March Madness 365 with Andy Katz,4,1,0,2,16,23
Great Disasters,1,0,2,1,33,37
Sweat Elite Podcast,0,0,0,0,3,3
The Eco Well podcast,0,0,1,0,7,8
Dan Carlin's Hardcore History: Addendum,5,1,3,1,40,50
CreepyPasta Reading,4,2,10,9,41,66
Marketer-to-Marketer - #M2M,0,0,0,0,2,2
"Pod Save The Queen - Royal family news, interviews and fashion",52,7,8,11,77,155
Another Zelda Podcast,0,0,0,1,49,50
Dynasty Trades HQ Podcast,0,2,0,2,98,102
Plain English Podcast | Learn English | Practice English with Current Events at the Right Speed for ...,0,0,0,0,8,8
Your Day Off @Hairdustry; A Podcast about the Hair Industry!,0,0,0,0,137,137
"2 Black Girls, 1 Rose: A Bachelor Podcast",12,1,1,7,337,358
The Kara Goldin Show,0,0,0,0,12,12
When Meghan Met Harry,5,0,4,2,48,59
The Hortoccult: A Horticulture Podcast,0,0,0,0,5,5
University of Dutch: The Dutch Mantell Show,4,1,4,2,26,37
Uncensored Tactical Podcast,1,0,0,1,7,9
The Collective Evolution Show - With Joe Martino,1,1,0,0,23,25
History is Gay,2,0,0,0,48,50
Atlas Avenue Beat,0,0,1,1,4,6
The Knowledge and Mileage Podcast,0,0,0,1,49,50
Love Your Life + Law of Attraction,0,0,0,1,49,50
Adult Bedtime Stories,4,0,1,1,1,7
All Crime No Cattle,18,10,9,15,448,500
Talk To Me In Korean - Core Grammar Lessons Only,0,0,1,8,13,22
Nintendo Power Podcast,7,1,3,3,36,50
Mark of the Maker,0,0,0,1,49,50
POST Wrestling w/ John Pollock & Wai Ting,14,2,1,3,156,176
Still Watching: WandaVision,30,11,13,15,131,200
Just Thinking Podcast,10,1,2,4,363,380
The Dennis Michael Lynch Podcast,4,0,0,2,76,82
Eat To Live Daily,0,0,0,1,3,4
Stand Partners for Life,0,1,0,1,44,46
The Official Vue News,0,0,0,0,4,4
The You-est You™ Podcast,0,0,1,0,72,73
Forever35,14,6,5,2,173,200
M*A*S*HCast,1,1,1,1,28,32
Get Pregnant Naturally,0,0,0,1,17,18
Satura Lanx,0,0,0,0,11,11
Make-Believe Heroes,0,0,0,0,50,50
An Idiom a Day,0,0,0,0,1,1
Global GoalsCast,1,0,0,0,16,17
Gup's Corner Podcast Network #FFG,3,2,3,2,490,500
Sober Speak-  Alcoholics Anonymous Interviews,0,0,1,0,14,15
Straight from a Scientist Medical Research Education and Discussion Podcast,0,0,0,1,3,4
The Sustainable Minimalists Podcast,0,1,0,0,49,50
Better Sex,0,0,0,0,49,49
Positive University Podcast,0,0,0,2,198,200
Calmer You Podcast: Anxiety & Confidence,0,0,0,1,14,15
The 10 Minute Entrepreneur,1,0,1,0,15,17
Talking To Teens: Expert Tips for Parenting Teenagers,0,1,0,0,9,10
Dear Premed,0,0,0,0,4,4
"Eat This, Not That!",6,12,9,5,18,50
Bachelor Party,129,46,35,33,257,500
BiggerPockets Money Podcast,29,24,23,20,104,200
MENTOR360,0,0,0,0,13,13
She Thrives Radio,1,0,1,1,47,50
AXE TO GRIND PODCAST,1,0,2,1,68,72
CoRecursive: Coding Stories,1,0,0,0,10,11
3 Pagans and a Cat,4,3,6,3,24,40
Drawing From Experience,0,0,0,1,14,15
Hollyweird Paranormal,8,4,1,2,53,68
Roast and Reason: A Coffee Podcast,0,0,0,0,24,24
Kick in The Creative's Podcast,0,0,0,0,16,16
Hurdle,2,0,0,0,48,50
500 Greatest Films Podcast,2,0,1,1,29,33
‎One-Hit Wonders of the World,0,0,0,1,2,3
My Hero Academia: Afterwatch,2,0,0,2,38,42
Your Home Story,1,0,0,0,27,28
The Fighter Pilot Podcast,0,0,0,0,50,50
Purple Patch Podcast,0,0,1,0,49,50
It's Wood - A show about all things woodworking,0,0,1,0,4,5
Rotor Riot: UNRESTRICTED,2,0,0,1,3,6
Other Record Labels - Starting & Running a Record Label,0,0,0,0,9,9
Decanted Wine Podcast,0,0,0,0,12,12
Wet Fly Swing Fly Fishing Podcast,2,1,1,2,42,48
An Unexpected Podcast: Talkin' Tolkien,1,1,5,3,121,131
Opposing Bases: Air Traffic Talk,0,0,0,0,50,50
New Horror Express,0,0,0,1,1,2
CAUTIONARY TALES with Jason Pettigrew,0,0,1,1,0,2
Comic Lab,0,0,0,0,43,43
Life on the Outside,0,0,0,1,49,50
Hello Sport Podcast,0,0,0,0,2,2
Bible Beaters,1,2,0,0,3,6
The Positive Pants Podcast,0,0,0,0,6,6
Just What You Needed,0,0,0,1,73,74
The Evidence Based Rheumatology Podcast,0,0,0,0,12,12
AP Cardiology,0,0,0,0,8,8
Trapping Today,0,0,0,1,68,69
Work/Life Imbalance,0,0,0,1,47,48
9to5Mac Daily,5,5,1,3,43,57
Nature & Nourish with Becky Cole,0,0,0,0,9,9
e-flux podcast,0,0,0,0,5,5
Is This Real Life? With Mandy Slutsker,5,1,0,1,41,48
This Week in Bitcoin,1,0,0,0,9,10
31 Thoughts: The Podcast,2,1,5,4,106,118
Stand Out,0,0,0,0,27,27
BIG MONEY STYLIST,3,3,1,0,39,46
Mile Higher Podcast,53,25,24,14,384,500
Slay Girl Slay,0,0,0,1,49,50
A Farmish Kind of Life,0,0,0,1,16,17
Crypto Basic Podcast: Teaching You The Basics of Bitcoin and the World of Cryptocurrency. CryptoBasi...,2,0,0,1,47,50
Jase & PJ,4,0,0,0,142,146
The Product Boss Podcast,0,1,0,0,49,50
Every Movie Reviewed & Ranked - Kinda Funny In Review,10,1,6,8,51,76
Somebody Somewhere,4,6,8,4,171,193
ADHD Essentials,0,0,0,1,39,40
SportsLine DFS Podcast,1,0,0,0,11,12
"It's Not About the Food: Intuitive Eating, Anti-Diet, Body Positivity with Dr. Stefani Reinold",1,4,1,2,42,50
The Enoch Saga,2,0,3,1,5,11
Bonsai Mirai: Asymmetry,0,1,1,1,20,23
Power To The Ground Podcast,1,0,0,0,0,1
Waiting To Dry,4,2,1,1,34,42
CzabeCast,20,4,6,5,181,216
Not So Random Facts,1,0,0,0,12,13
The Proceedings Podcast,0,0,0,1,8,9
The Amazing Nerd Show,1,0,0,3,93,97
The Afro Beets Podcast,0,0,0,0,2,2
Sailing Doodles Podcast,0,0,0,1,17,18
Unladylike,15,7,8,12,305,347
Locked On Yankees - Daily Podcast On The New York Yankees,19,3,4,3,22,51
Locked On Cubs – Daily Podcast On The Chicago Cubs,3,3,0,3,35,44
The Ross Bolen Podcast,12,0,0,2,36,50
Small Doses with Amanda Seales,2,0,2,1,45,50
GHT Overland - Overlanding Adventure,0,0,0,0,4,4
The Best Pick movie podcast,0,0,1,0,13,14
"Feel Better, Live More with Dr Rangan Chatterjee",5,0,0,5,355,365
The Going Scared Podcast with Jessica Honegger,0,0,0,4,496,500
Classic Lenses Podcast,0,0,0,0,1,1
Skullduggery,14,5,5,6,20,50
Bunny Ears,7,1,2,2,38,50
DOOMED with Matt Binder,1,2,0,3,74,80
Next Level Human with Dr. Jade Teta,0,0,0,0,50,50
Unstress with Dr Ron Ehrlich,0,0,0,0,3,3
Bedtime Explorers,4,0,1,3,42,50
Garage Guys Fantasy Sports Podcast,2,0,0,0,52,54
The Empowered Principal Podcast,0,0,0,0,19,19
The Ready State Podcast,0,0,0,0,28,28
Kubrick's Universe - The Stanley Kubrick Podcast,0,0,0,0,4,4
Future Hindsight,1,0,0,0,5,6
The Sword & The Trowel,0,1,0,1,30,32
The Lipstick Panel,0,0,1,0,3,4
Cool Facts About Animals,2,2,2,1,43,50
Orange and Brown Talk: Cleveland Browns Podcast,7,4,9,6,27,53
Relics Radio show,0,0,0,0,5,5
Leafs Hour,0,0,0,0,1,1
CLEANING UP THE MENTAL MESS with Dr. Caroline Leaf,48,24,24,44,368,508
Evidence Based Birth®,3,1,2,2,42,50
Eat with Confidence,1,0,0,0,49,50
Black Girl Experience,0,1,0,0,41,42
The Daily Show With Trevor Noah: Ears Edition,160,4,36,36,216,452
A F*ckup's Guide To Self-Help,2,2,1,3,42,50
"On A Dark, Cold Night",0,0,3,1,37,41
I'm Listening : A Frasier Podcast with Anita Flores,5,1,0,1,19,26
We Only LOOK Thin,1,0,0,0,49,50
Raising Lifelong Learners,0,0,0,0,20,20
"Not Your Average Runner, A Running Podcast",3,2,2,3,93,103
Not A Podcast ASOIAF Re-Read Podcast,1,2,4,4,120,131
Sub 70 Golf Podcast,0,0,0,0,2,2
RISE AND GRIND with Daymond John,2,0,1,1,58,62
Get In My Garden,0,0,1,1,2,4
Business Wars,12,32,32,28,364,468
NotiPod Hoy,0,0,0,0,1,1
Very Really Good,0,0,0,0,50,50
Thriving Stylist Podcast,0,0,0,0,50,50
Psychiatry & Psychotherapy Podcast,3,1,4,0,134,142
Five On The Floor: Miami Heat/NBA,6,0,3,6,60,75
Inside Julia's Kitchen,1,0,1,1,7,10
Evolving for the Next Billion by GGV Capital,3,0,2,0,21,26
DataFramed,0,0,2,2,39,43
Women at Work,2,1,4,1,69,77
Ask Me About Kpop,0,0,0,1,23,24
Pot and Cloche Garden Podcasts,0,0,0,0,1,1
Stoic Coffee Break,0,0,0,0,13,13
Out of Bounds Podcast,1,0,1,0,53,55
"Actually, You Are a Real Runner",0,0,0,1,10,11
the fastlife podcast,0,0,0,0,33,33
The Art Law Podcast,0,0,0,0,5,5
The Grit! with Chas Smith,1,2,2,1,19,25
Peer to Peer,0,0,0,0,50,50
The Subtext,0,0,0,1,8,9
The Noco Moto Motorcycle Podcast,0,1,1,0,48,50
This is Love,7,7,9,16,461,500
Podcasting Simplified,0,0,0,1,21,22
#RunPainFree Podcast,0,0,0,0,1,1
"Confessions of a Top-Producing Real Estate Agent, the Agent Grad School Podcast",0,2,0,1,15,18
Conspiracy Theories,246,106,96,64,230,742
Stay Paid - A Sales and Marketing Podcast,0,0,0,1,49,50
This Movie Changed Me,2,0,0,6,61,69
The Elevator,0,4,4,2,207,217
The Extra Inch (Spurs Podcast),0,0,0,0,76,76
How to Money,3,1,4,3,189,200
Choiceology with Katy Milkman,4,2,1,7,136,150
Battleground Podcast,0,0,0,0,17,17
The Everyday Sniper,1,0,0,0,43,44
Deida.live,0,0,0,0,1,1
NFL Draft Bible Podcast Network,0,0,1,0,25,26
Disgorgeous,2,1,0,0,14,17
The Mother Like a Boss Podcast,2,1,1,0,46,50
The Boat Galley,2,0,1,2,9,14
Abroad in Japan,5,9,5,6,136,161
Neurodiversity Podcast,0,2,0,1,13,16
Cog Hill Farm Podcast,1,0,0,0,34,35
The Echo Chamber,0,0,0,0,2,2
Pod To Pluto,0,0,0,0,10,10
Persian night story,0,0,1,5,26,32
"Drop-Tine Podcast -The official deer management, food plot & habitat podcast",0,0,0,0,34,34
Application Security Weekly (Audio),0,0,0,0,1,1
Application Security Weekly (Video),0,1,0,0,0,1
NICTalks,0,0,0,0,1,1
Learn French Conversation,1,0,0,0,8,9
American Toffee Podcast,0,0,0,1,32,33
Backpacker Radio,10,4,9,4,356,383
Growth Experts with Dennis Brown,1,0,0,2,47,50
De Dag,0,0,1,0,0,1
Suburban Dharma,0,0,0,0,3,3
THE STREET CONSERVATIVE PODCAST,2,0,0,0,7,9
Hoovering,1,0,2,0,46,49
The Business of Content,0,0,0,0,2,2
People of the Pod,1,0,2,0,11,14
The QUARTERDECK Sailing Podcast,1,0,0,0,21,22
I Am In Eskew,0,0,0,0,40,40
There Will Be Dungeons,1,0,1,4,36,42
Dear HBR:,10,2,4,3,26,45
Lightworkers Lounge,7,4,1,2,71,85
Dr. Berg’s Healthy Keto and Intermittent Fasting Podcast,3,4,0,1,42,50
Moneycontrol Podcast,7,1,0,4,6,18
Fantasy Football Podcast,2,1,0,2,81,86
The PFF Forecast,9,4,4,5,78,100
The Body Image Podcast,0,1,0,0,20,21
Spiritual Swingers,2,0,1,0,15,18
Business of Home Podcast,0,2,0,1,27,30
The Science of Happiness,6,3,4,2,63,78
Nonprofit Jenni Show,0,0,0,1,43,44
Shoot Fast Podcast,0,1,0,3,81,85
Adoption Hacks,1,0,0,0,27,28
EV News Daily - Electric Car Podcast,0,0,1,1,48,50
England Rugby Podcast: O2 Inside Line,0,0,0,0,4,4
Interior Design with Kandrac and Kole,0,0,0,0,40,40
Everything Happens with Kate Bowler,3,0,5,9,412,429
Mark Bell's Power Project,4,1,1,1,43,50
Just Wanna Quilt,8,1,6,3,25,43
The Home Service Expert Podcast,1,1,0,2,46,50
The Robby Row Show Baseball Podcast,0,0,0,0,50,50
Customs Out of The Closet,0,0,0,0,3,3
The 59th Minute FPL Podcast,0,0,0,0,8,8
Teaching Hard History,0,0,0,1,37,38
The Natural State with Dr. Anthony Gustin,0,0,1,0,49,50
Play Guitar Podcast,0,0,0,1,50,51
The Anthropocene Reviewed,4,1,2,6,487,500
The WW Bro Podcast w/ Anthony DiDomenico,0,0,0,0,50,50
Rock Candy,4,1,0,0,39,44
Ladies of the Fright,0,0,1,0,7,8
BIG Life Devotional | Daily Devotional for Women,0,0,1,0,60,61
The Power of Us,0,0,0,2,48,50
We Hunt the Keepers!,0,0,0,0,5,5
The Pan Dulce Life,0,0,0,0,15,15
Sound of the Loons,3,2,1,0,10,16
Mafia,14,18,18,28,167,245
Weave,1,1,2,2,15,21
Design Tribe Podcast,0,0,0,0,5,5
Retropod,3,3,2,8,34,50
Duck Gun Podcast,4,3,2,0,88,97
You'll Hear It - Music Advice,1,0,0,0,122,123
Loving Well,0,0,0,0,10,10
TCBCast: An Unofficial Elvis Presley Fan Podcast,0,0,0,1,13,14
Late Night Whenever,0,2,0,3,45,50
This Cultural Moment,3,1,0,7,380,391
Washington Post Live,1,0,0,1,1,3
The Betches Sup Podcast,1,0,0,0,49,50
Watch And Listen,2,0,4,4,16,26
TomoChoco Podcast,1,0,0,0,4,5
Art Matters,0,0,0,1,6,7
Marvel's Wolverine,5,7,10,16,162,200
Miraculous Mamas,4,3,1,2,40,50
The RunOut Podcast,2,0,1,0,18,21
"Threads Magazine Podcast: ""Sewing With Threads""",0,0,1,1,9,11
The Healthy Christian Women Podcast,0,0,1,2,25,28
Fit Strong Women Over 50,0,0,0,1,4,5
Not Another D&D Podcast,2,0,1,1,46,50
Spurs Insider,4,0,1,2,22,29
The Stepbrothers Podcast,0,0,0,0,3,3
The Productive Muslim Podcast,0,0,0,1,1,2
Chilluminati Podcast,3,0,4,3,40,50
Assyrian Podcast,0,0,0,0,17,17
Talking Buffalo Podcast,1,0,0,0,35,36
Sage Family,1,0,2,1,46,50
Northern Myths Podcast,1,8,6,2,25,42
Junior Golf Blueprint,0,0,0,0,29,29
Fast Keto with Ketogenic Girl,0,0,2,4,44,50
The Dog Health & Happiness Podcast | Bella & Duke,0,0,0,0,1,1
DayWeather Podcast,0,0,0,0,7,7
"Trump, Inc.",2,3,1,5,39,50
Cultaholic Wrestling,3,0,0,1,22,26
Let Me Tell You...With Joan Hamburg,0,0,0,0,3,3
The Jordan Harbinger Show,1,1,0,2,46,50
AvGeek Chronicles,0,0,0,0,6,6
Astros Baseball,0,0,0,0,52,52
The Divorce Survival Guide Podcast,4,2,2,0,42,50
Spanishland School Podcast: Learn Spanish Tips That Improve Your Fluency in 10 Minutes or Less,0,0,0,0,50,50
To 50 and Beyond,0,0,0,0,50,50
VR Flight World Podcast,0,0,0,0,3,3
Witness History: World War 2 Collection,0,0,1,0,6,7
Skimm'd from the Couch,12,8,14,21,80,135
The Voice of Social Sales,0,0,0,0,21,21
The Sacramento Bee Daily Flash Briefing,6,3,1,0,2,12
The Kansas City Star Daily Flash Briefing,1,0,0,0,0,1
Armchair Expert with Dax Shepard,53,23,42,40,341,499
The Southern Outdoorsmen Hunting Podcast,1,0,0,5,304,310
Tales,28,12,14,15,131,200
Happiness Spells,0,0,0,1,49,50
Simple. Handmade. Everyday.,1,0,0,0,49,50
Tasteless,1,1,0,1,109,112
"MudTalk Podcast – Pottery, Ceramics, Art and Business – Expert Clay",0,0,0,0,1,1
7 Good Minutes Daily Self-Improvement Podcast with Clyde Lee Dennis,0,0,0,0,3,3
"Today, Explained",73,40,40,39,308,500
The After Gambling Podcast,0,1,0,0,39,40
The Hunting Collective,55,11,15,9,382,472
WorkLife with Adam Grant,15,5,20,45,865,950
The Jungle Room,1,0,1,0,11,13
"The Examen with Fr. James Martin, SJ",0,0,1,0,28,29
The Fundamentalists,3,4,13,8,119,147
Ready Set Love!,0,0,0,0,41,41
The Green Building Matters Podcast with Charlie Cichetti,0,0,0,0,10,10
Horror Hill: A Horror Anthology and Scary Stories Series Podcast,1,0,1,1,47,50
HatCast - A Podcast About Hats,0,0,0,0,2,2
Redvolution Rampage,0,0,0,0,5,5
Global Seducer Quickie Podcast,1,0,0,2,64,67
This is War,18,17,23,17,232,307
Local SEO Tactics and Digital Marketing Strategies,0,0,0,0,50,50
Satan and Rainbows,0,0,0,1,10,11
Unconfirmed,3,1,1,1,21,27
Weed + Grub,0,0,0,0,50,50
Health Coach Power Community,0,0,0,0,49,49
Five Games for Doomsday,0,0,0,0,8,8
From Hostage To Hero,0,0,0,0,22,22
Pounded In The Butt By My Own Podcast,11,0,2,2,35,50
Supreme Court decision syllabus (SCOTUS),1,0,0,0,6,7
The Bricks King Podcast: LEGO,0,1,0,1,29,31
Congeria,2,4,7,1,36,50
"The PurposeGirl Podcast: Empowering women to live their purpose with courage, joy, and fierce self-l...",0,0,0,0,50,50
Second Life,9,5,12,7,167,200
Truth Seekers: Bible Stories for Kids,0,0,0,2,153,155
Brilliant Perspectives,0,0,1,1,78,80
Tomes & Tentacles - Call of Cthulhu Actual Play,0,0,0,1,37,38
The Bible Binge,15,9,8,7,461,500
No Bad Dogs Podcast,0,0,0,0,50,50
Voices of Your Village,0,1,0,0,40,41
The Aquarist Podcast,0,0,0,0,23,23
"Dear Men: How to Rock Sex, Dating, and Relationships With Women",0,0,1,0,14,15
Breaking Atoms: The Hip Hop Podcast,0,0,0,0,20,20
ASCO Guidelines Podcast Series,0,0,0,0,4,4
"BreakerCulture Podcast -- Sports Card Insight, Interviews, Investment, Stories, and much more!",2,0,1,2,45,50
The Dynasty Baseball Show,0,1,1,0,40,42
Order 9066,0,0,0,1,80,81
The Female Health Solution Podcast,0,0,1,2,28,31
Art History for All,0,0,0,2,26,28
Real Talk Kim,1,0,1,0,167,169
Ancient History Fangirl,3,1,1,3,37,45
Halloweenies: A Horror Franchise Podcast,5,1,5,5,114,130
What's Your Sign?,11,4,13,3,304,335
Southern Gothic,2,1,4,5,38,50
Quoth the Raven,10,2,1,2,35,50
The Big Fib,1,1,2,2,44,50
Six Minutes,2,1,0,3,44,50
Beauty Bytes with Dr. Kay: Secrets of a Plastic Surgeon™,0,0,0,0,50,50
Mighty Parenting | Raising Teens | Parenting Young Adults,0,0,0,1,12,13
KGI: Innovation in Applied Life Sciences & Healthcare,0,0,0,0,2,2
Nobody Told Me!,1,0,1,2,32,36
Girls Gotta Eat,8,0,6,1,35,50
Transformation Church,0,0,0,0,14,14
The Jordan Syatt Mini-Podcast,0,0,0,0,50,50
Board Game Barrage,1,0,1,0,48,50
Dead Meat Podcast,8,9,7,5,471,500
The Freethinking Podcast,0,0,0,0,6,6
Professional Troublemaker,3,0,0,3,190,196
Marriage After God,4,1,5,10,361,381
The Signal,3,1,8,5,72,89
Locked On Twins - Daily Podcast On The Minnesota Twins,1,0,1,1,63,66
Flower Power Garden Hour,1,1,2,0,24,28
Locked On Pirates - Daily Podcast On The Pittsburgh Pirates,1,0,0,3,6,10
Yahoo! Finance Daily,6,0,0,0,0,6
The Short Porch,34,11,1,4,223,273
Tumblehome: A Boundary Waters Podcast,0,0,0,1,22,23
The Rhino Podcast,2,0,0,0,17,19
Bossed Up,0,1,0,2,112,115
The Bay,1,0,4,0,45,50
Great Moments in Weed History,1,0,1,1,47,50
American Presidents: Totalus Rankium,0,0,2,3,45,50
The Virtual Ocean,1,0,0,0,3,4
KnockBack: The Retro and Nostalgia Podcast,0,0,0,0,50,50
Walford Weekly,0,0,0,0,8,8
Profit Maximalist,0,0,1,0,15,16
The What Podcast,0,0,1,1,69,71
Be There in Five,7,2,2,1,488,500
Citizen Bitcoin,0,0,1,0,26,27
Warriors In Their Own Words | First Person War Stories,3,0,0,5,25,33
The Music Industry Blueprint Podcast,0,0,0,1,186,187
Green Beauty Conversations by Formula Botanica | Organic & Natural Skincare | Cosmetic Formulation |...,0,0,1,7,131,139
"The Grave Talks | Haunted, Paranormal & Supernatural",41,33,24,17,385,500
Good Night Stories for Rebel Girls,0,0,0,2,48,50
UX Cake,0,0,0,0,11,11
Ninth Avenue Church of Christ,0,0,0,0,2,2
Inside Skunk Works,0,0,3,1,39,43
Dark and Twisty Tales: folk stories and fairy tales for the unafraid.,0,1,0,0,31,32
Dressed: The History of Fashion,7,15,33,14,93,162
The Metal Hammer Podcast,0,0,0,0,3,3
Physical Therapy Private Practice: Secrets of the Top 10%,0,0,0,0,13,13
Second Best: A DnD Adventure,0,1,1,0,48,50
The Magpies: A Blades in the Dark Actual Play,0,2,0,1,46,49
The A24 Podcast,2,1,4,8,61,76
Fierce Girls,4,0,2,8,36,50
Ask a Manager,0,1,5,8,52,66
The Cricket Mentoring Podcast,0,0,0,0,2,2
Steep Life Media,0,0,0,0,24,24
Unexplained Mysteries,9,5,9,4,23,50
Let's Talk Battle Rap Podcast,0,0,0,0,12,12
Anime Out of Context,1,0,1,1,47,50
Locked On Angels - Daily Podcast On The Los Angeles Angels,2,1,3,0,16,22
Locked On Reds - Daily Podcast On The Cincinnati Reds,2,0,4,2,23,31
Tundra Talk Podcast,1,0,1,1,56,59
Designed Today,0,0,0,0,9,9
You Can't Do That,0,0,0,1,64,65
Keelhauled: A Sea of Thieves Podcast,1,0,1,1,47,50
"Crypto Weekly | Cryptocurrency, Bitcoin, Ethereum, Altcoin and ICO news from the week",0,0,0,0,13,13
The Soundtrack Show,1,2,5,10,188,206
Locked On Orioles - Daily Podcast On The Baltimore Orioles,1,0,0,1,16,18
Boutique Chat,0,0,1,1,98,100
Squat University,0,0,0,1,49,50
Reef News Network,2,0,0,1,47,50
All Systems Goku,3,0,1,2,44,50
The Champions' Cast - Zelda Dungeon Podcast,0,1,2,3,24,30
Spread Aviation Podcast,0,0,0,0,2,2
Fungi Town,1,0,0,0,5,6
RFK Refugees Podcast,0,0,0,1,17,18
"The Scuffed Soccer Podcast | USMNT, Yanks Abroad, MLS, futbol in America",5,3,3,8,151,170
Explaining Brazil,0,1,0,1,4,6
Focused Compounding,0,1,0,0,44,45
The goop Podcast,1,0,1,1,1,4
"Get Tressed With Us! - Us Weekly Hair, Beauty and Style",0,0,0,0,2,2
The Gravel Ride.  A cycling podcast,0,0,0,1,40,41
In the Spirit of Horse,0,0,0,0,32,32
The ASMR Garden,1,0,4,3,42,50
The Rail~Volution Podcast,0,0,0,0,1,1
3 and Out with John Middlekauff,12,1,2,7,478,500
Undr The Cosh,0,3,8,10,479,500
Real Life Pharmacology - Pharmacology Education for Health Care Professionals,1,1,0,1,47,50
History Hyenas with Chris Distefano and Yannis Pappas,7,1,0,1,41,50
The Physician Assistant Startup Podcast,0,0,0,1,19,20
The Michael Shermer Show,11,4,3,1,20,39
Reductio: Adventures in Ideas,0,0,0,0,2,2
The Triathlete Beat: A Beginner Triathlon Podcast,0,0,0,0,1,1
Positive Mindset,0,0,0,1,5,6
Countdown To Classic,0,1,0,1,50,52
Happy Place,0,0,0,0,6,6
The Bettor Life,4,3,3,2,38,50
America's National Parks Podcast,2,2,5,1,82,92
Warriors Off Court,2,0,4,1,3,10
"Space, But Messier!",0,0,0,0,32,32
Chompers,3,0,6,7,34,50
Sustainable Asia,0,0,1,0,5,6
Solosaurus,3,0,0,3,32,38
Tom Rowland Podcast,3,0,0,3,320,326
SWISSCAST with Suhaib Webb,0,0,0,2,67,69
Let's Go To Court!,27,13,12,19,429,500
Pilot Episodes,0,0,0,0,1,1
Change Agent,5,3,3,4,98,113
NASW Social Work Talks,2,3,0,3,1,9
Mornings with Mayesh,0,0,0,0,1,1
City of the Future,0,1,0,1,20,22
Autonomous Cars with Marc Hoag,0,1,0,1,15,17
Plugged In Golf Podcast,0,0,0,4,9,13
The Succulent FAQ,0,0,0,0,8,8
Love Letters,6,2,2,3,64,77
Death Is Just Around the Corner,0,1,1,0,22,24
Felonious Florida,19,18,29,32,123,221
The HeirPod - Royal News & Interviews,18,8,2,4,18,50
Let's Learn Turkish,0,0,0,0,2,2
Spec Media,0,0,0,0,34,34
Deconstructed,8,2,2,2,36,50
Horns of a Dilemma,0,2,1,1,1,5
The Counsel of Trent,4,4,6,8,186,208
Light The Fight- Parenting Podcast,1,1,4,1,43,50
Fantastic Geeks (and where to find them),1,4,5,5,335,350
Built To Hunt by Huntin' Fool,0,0,0,0,8,8
Forever Mighty Podcast: Your Anaheim Ducks Podcast,0,0,0,0,11,11
Stop Over-drinking and Start Living,3,1,0,0,37,41
Working Class History,0,0,0,0,21,21
Start Here,4,1,3,1,41,50
School Leadership Reimagined,2,0,1,1,18,22
Techmeme Ride Home,5,2,3,2,38,50
Hot and Bothered,7,8,4,4,177,200
The Curtiss King Podcast,0,0,0,0,14,14
The Grey Rooms,5,1,3,4,37,50
The Easy Living Yards Podcast,1,0,1,0,19,21
VSiN Best Bets,3,2,6,2,14,27
Stop Me If I've Heard This,0,0,0,0,8,8
The Happy Times,0,0,1,0,49,50
"Don't Tell Our Wives: Warm Beer, Cheap Comedy, and News",2,0,0,0,8,10
The Edges & Sledges Cricket Podcast,0,0,0,0,4,4
God is Dead,0,0,0,0,15,15
Aethuran Dark Saga - A Dark Fantasy Audio Fiction,1,0,0,0,22,23
How to Get a Meeting With Anyone,0,0,0,0,8,8
Taking Back Your Power,1,0,0,0,49,50
The Love Drive with Shaun Galanos,0,0,0,1,97,98
"Ladies, First",0,0,0,1,4,5
All Things Internet's podcast,5,0,2,1,42,50
@theBar,0,0,1,0,9,10
Drinking Socially - The Official Untappd Podcast,3,1,5,4,33,46
La Vuelta Podcast,0,0,0,0,5,5
TASKMISTRESS,8,11,12,13,456,500
The Transgender Scientist,0,0,0,1,6,7
Evil Genius with Russell Kane,18,9,13,9,48,97
Asian Not Asian,1,2,1,1,45,50
First Class Fatherhood,2,0,0,0,30,32
Innovation in Compliance with Tom Fox,0,0,0,0,3,3
Good Moms Bad Choices,3,0,4,3,295,305
No Putts Given,5,0,0,3,62,70
The Panthers Podcast Network,0,0,1,1,11,13
Andy Frasco's World Saving Podcast,0,1,1,1,47,50
Help I Sexted My Boss,2,0,1,5,400,408
"Miles to Go - Travel Tips, News & Reviews You Can't Afford to Miss!",0,0,2,1,35,38
"InsideTheBoards Study Smarter Podcast: Question Reviews for the USMLE, COMLEX, and Medical School",0,1,0,0,37,38
Weight Loss for Foodies podcast | Ditch the Diet and Lose Weight with Shari Broder | Life Coach Scho...,1,1,0,2,31,35
Female Criminals,53,43,44,32,307,479
Write Or Die Podcast,0,0,2,1,41,44
The Truck Show Podcast,2,1,1,1,45,50
Slime Sabatoge,4,0,2,1,1,8
WHAT THE TRUCK?!?,3,0,0,2,16,21
KUNC's Colorado Edition,0,0,0,0,2,2
Bridge the Gap: The Senior Living Podcast,1,0,0,0,15,16
Score: The Podcast,0,1,3,2,66,72
The Sober Therapist SoberSoul Recovery Podcast,1,1,1,1,46,50
Chakra Girl Radio,15,0,2,0,33,50
And the Runner-Up Is,3,2,1,2,19,27
Breaking Beyond-Guided Meditation,0,0,0,2,15,17
Bible Thinker,0,1,1,1,40,43
Fowl Front Waterfowl Podcast,5,3,1,3,45,57
The Attack On Titan Podcast,1,1,0,3,14,19
ON BOYS Podcast,0,0,1,1,12,14
The Dance Moms Podcast,1,0,0,0,4,5
The Fuller House Podcast,1,0,0,1,1,3
The Athletic NBA Show,43,9,4,5,188,249
The Real Housewives of New Jersey After Show Podcast,2,1,3,0,3,9
The Real Housewives of Orange County After Show Podcast,13,5,3,0,4,25
The Real Housewives of Potomac Podcast,0,0,0,0,5,5
Democracy Works,0,0,0,0,16,16
GotTechED the Podcast,0,0,0,0,5,5
Wall Street Breakfast,21,22,23,11,22,99
Beauty Bosses,0,3,0,0,22,25
Toxic Schlock,0,0,0,0,13,13
Difficult Happens; Effective Communication for Bosses,0,0,0,0,24,24
Living Corporate,2,0,0,0,56,58
The Vegan Gym Podcast,2,0,0,0,48,50
The Mark Martin Podcast,0,0,4,0,34,38
The OT School House for School-Based OTs Podcast,0,0,0,0,17,17
Mid South Wrestling Television Review,3,2,1,3,51,60
The Priory Society - Sex Podcast for Swingers,4,2,1,0,43,50
The Tim Faller Show,0,0,0,0,8,8
Cannon Fodder,0,0,0,1,49,50
Marine Conservation Happy Hour,0,1,2,1,8,12
Spanish for Beginners,0,0,0,0,5,5
Heart of Dating,2,3,3,2,486,496
Forensic Files,16,25,17,21,104,183
All Ball with Doug Gottlieb,9,1,2,6,31,49
Alchemy with Ambi,1,0,0,1,69,71
The Perfect RIA,1,0,0,0,37,38
Relatable with Allie Beth Stuckey,5,0,0,0,45,50
HVAC Know It All Podcast,0,0,1,1,18,20
Learning to fly,0,0,0,0,3,3
Rockin' Eddy Oldies Radio Show,0,0,0,0,2,2
Endurance Horse Podcast,1,0,0,0,6,7
The DogBone Pawdcast,0,0,0,0,41,41
Ruchi Koval,0,0,0,0,5,5
Bitcoin Audible,0,1,0,1,34,36
Sibling Rivalry,0,0,0,1,49,50
The Intrazone by Microsoft,0,0,0,2,3,5
The Uncensored Empath,0,0,1,0,93,94
Top End Moto Podcast,0,0,0,1,10,11
No Hay Tos (Real Mexican Spanish),0,0,0,0,50,50
The Retirement Wisdom Podcast,0,0,0,0,5,5
Punk Rock HR,6,0,2,3,39,50
MarTech Podcast // Marketing + Technology = Business Growth,0,1,0,0,10,11
Wesam's World,1,0,0,0,17,18
Joseph: Season 1 - The Revenge of Opus,0,0,0,0,3,3
PC Flight Podcast,0,0,0,0,2,2
The Last Movie,7,9,7,4,23,50
The Good Girls Podcast,1,2,1,0,0,4
Star Wars STUFF Podcast,1,0,1,3,78,83
Make Do,0,0,0,0,4,4
Look Good Move Well,0,0,0,0,21,21
Design Voice Podcast,0,0,0,0,8,8
Two Vets Talk Pets,0,0,0,0,1,1
Dr Duck Waterfowl Podcast,1,0,0,0,37,38
Marketing Scoop Podcast,0,0,0,0,11,11
State of sportfishing - By Billfish,0,0,0,0,1,1
The NBA Daily Ding,2,2,0,1,70,75
upNXT: The Unofficial NXT Podcast,0,0,2,0,26,28
Girls Gone Boss,0,0,0,0,38,38
"Our Farms, Our Future",0,0,0,0,5,5
Scoops with Danny Mac,5,6,5,8,34,58
Lady Startup Stories,2,0,2,2,76,82
Star Wars Spelt Out Podcast,0,0,1,0,10,11
Craig & Friends,4,2,2,1,41,50
The Fifty One,0,0,0,1,7,8
"Somehow I Manage: Rewatching ""The Office""",5,0,0,2,41,48
In A Mississippi Minute with Steve Azar,0,0,0,0,3,3
Locked On MLB - Daily Podcast On Major League Baseball,6,3,2,3,35,49
Holding Space,0,0,0,0,17,17
"Essentially You: Empowering You On Your Health & Wellness Journey With Safe, Natural & Effective Sol...",0,0,2,3,45,50
Good Sex Bad Sex,0,0,0,0,1,1
Behind the Bookshelves,0,0,0,1,3,4
The Stacks,1,0,0,1,198,200
"Fujoshi Senpai | Boys Love, Yaoi, shojo",0,0,0,0,1,1
Time in Flight,0,0,0,0,1,1
Tim Pool Daily Show,52,16,10,8,112,198
Ancient Wisdom Today,5,3,3,2,423,436
Mind Body Garden,0,0,0,0,2,2
Habitat Podcast,1,0,0,1,169,171
MCHD Paramedic Podcast,0,0,0,0,16,16
Zero to Seven Figures Entrepreneur Podcast - Entrepreneur Tips & Entrepreneur Tactics,1,0,1,0,32,34
Vince Russo's The Brand,12,1,0,0,30,43
Khandaan- A Bollywood Podcast,0,0,0,1,24,25
Legends of the Old West,1,2,0,5,42,50
BEAUTY NEWS,0,0,0,0,9,9
After Hours,3,3,0,2,128,136
Be. Scared,3,2,2,5,38,50
Cyber Security Today,0,0,0,0,1,1
Filmography,0,0,0,1,1,2
The Producer's Guide: Todd Garner & Hollywood's Elite,0,0,0,0,40,40
Backpacking Light Podcast,0,0,1,1,27,29
Human Performance Outliers Podcast,0,2,3,4,41,50
Craft Hangout,0,0,0,0,50,50
Emotional Badass,0,0,0,1,49,50
The History of Vikings,0,0,1,1,48,50
3 Yards Per Carry - Miami Dolphins,10,5,2,8,43,68
Smash Bros Cast A Smash Bros Podcast,0,0,0,0,24,24
Black Millennial Marriage,1,0,0,0,100,101
Keeper Chat,1,1,1,2,101,106
Dinner Sisters,1,0,1,0,27,29
"Slow Italian, Fast Learning",0,0,0,0,1,1
The Marx Brothers Council Podcast,0,0,0,1,26,27
The Wild Episode,0,0,0,0,13,13
TPRS Russian – Effortless Russian,0,0,0,0,17,17
The Beat with Ari Melber,20,5,14,14,194,247
Velvet's Edge with Kelly Henderson,16,2,3,6,70,97
Take Back Time: Time Management | Stress Management | Tug of War With Time,0,0,0,0,7,7
The ReWire Podcast w/ Ryan Stewman,1,0,0,0,49,50
3 Books With Neil Pasricha,0,1,1,4,51,57
Popular Front,4,2,4,0,40,50
Uncover,63,67,106,74,190,500
Prospective Doctor (from MedSchoolCoach),1,0,1,0,3,5
Bulletproof Screenwriting™ Podcast with Alex Ferrari,1,2,4,2,19,28
Academy of Ideas,0,0,0,0,20,20
The Drunk Mormon Podcast,2,0,1,0,47,50
Ask Frank Kern,0,0,0,1,44,45
The Cozy Minimalism Podcast,3,2,0,1,9,15
Bad On Paper,6,3,5,7,179,200
Con Las Bases Llenas Podcast de Beisbol,0,0,0,0,3,3
Red Scare,104,20,11,18,182,335
Get Up!,33,11,9,9,29,91
Critical Update,0,0,0,0,1,1
Get Rich Or Get Drunk Trying,0,0,0,0,36,36
Montessori Education with Jesse McCarthy,0,0,0,1,49,50
LA Podcast,2,0,2,5,41,50
Sleep Meditation Podcast: The Podcast That Helps You Sleep 😴Nature Sounds & ASMR Sleep Triggers,3,1,2,6,38,50
Royally Obsessed,76,25,25,17,310,453
The David Suissa Podcast,0,1,0,0,4,5
STABcast,0,0,0,0,6,6
Fairways of Life with Matt Adams Golf Show,0,0,0,0,1,1
Crossed Up: A Phillies Podcast,0,1,0,0,37,38
Snow the Goalie: A Flyers Podcast,2,0,6,2,85,95
Alpha Male Buddhist From Brooklyn Podcast,0,0,1,1,9,11
Apple Bitz XL w/ Brian Tong,5,0,1,3,212,221
Raising Boys & Girls,0,0,0,1,49,50
Collider Ladies Night,0,0,0,0,57,57
The Femsplainers Podcast,18,5,4,0,23,50
Pull Up with CJ McCollum,11,2,8,6,192,219
Medical Stuff,6,2,2,1,26,37
MINDSET MAGIC & MANIFESTATION Podcast,5,0,2,2,37,46
Moms Don’t Have Time to Read Books,3,0,0,0,49,52
Unpacking the Power of Power Pack,0,1,0,0,14,15
A Paranormal Chicks,9,2,12,8,276,307
There Will Be Porn,0,0,0,0,12,12
The Health Code,6,3,1,4,36,50
The Damage Guild | A D&D Podcast,1,0,1,2,24,28
Popcorn Psychology,2,1,0,2,48,53
Deadline: White House,20,9,13,19,290,351
The Matt Walsh Show,18,2,2,2,172,196
The Daily Refresh with John Lee Dumas,1,0,0,0,34,35
"Dietitian Boss with Libby Rothschild MS, RD, CPT",0,0,2,0,17,19
This Sounds Serious,4,0,2,3,41,50
Plane Tales,0,0,0,0,25,25
First15 Devotional,1,4,2,5,173,185
The Howie Carr Radio Network,3,1,1,1,56,62
syzygy,0,0,0,0,2,2
Voice of the Victim Podcast,17,6,10,10,117,160
Plant Proof -  Evidence based nutrition,0,0,0,1,49,50
Discography,1,0,1,6,42,50
That One Time On Tour,0,0,0,0,50,50
Eye On The Market,2,0,0,1,7,10
X Factor Roping Podcast,0,0,0,0,15,15
Hothouse,0,1,0,1,4,6
Beltalowda - A Podcast for The Expanse,3,0,1,1,47,52
Alabama Saltwater Fishing Report,0,0,0,0,91,91
The Morning Toast,18,1,6,3,22,50
The End of Time and Other Bothers,0,1,0,1,23,25
Long Range Pursuit,2,1,2,2,35,42
Darko.Audio podcast,2,0,1,2,9,14
Stoicism On Fire,0,0,0,0,37,37
Lost Notes,4,0,1,4,94,103
A Better Peace: The War Room Podcast,0,0,0,0,2,2
The Smart Communications Podcast,0,0,0,0,6,6
Addiction Unlimited Podcast | Alcoholism | Life Coach | Living Sober | 12 Steps,3,1,1,2,43,50
The Ticket Top 10,3,6,8,6,31,54
Second in Command: The Chief Behind the Chief,1,0,1,0,45,47
Young and Profiting,0,0,0,0,50,50
Anime Cherry Bomb,0,0,0,0,1,1
The College Football Daily,8,3,2,1,60,74
4 Minute Bitcoin Daily News,0,0,0,0,5,5
The Sales Hacker Podcast,0,0,0,0,24,24
Non Toxic Environments Home Health & Wellness,0,0,0,0,30,30
The Habitat,31,46,39,41,220,377
GONE,10,8,6,5,21,50
TuneDig,0,0,0,0,12,12
The Big Honker Podcast,5,1,1,2,489,498
Dad Bod Rap Pod,0,0,0,0,12,12
Nutrition Coaching Secrets with Jason Phillips,0,0,1,0,10,11
Jessie Lee is The People’s Mentor,0,0,0,2,198,200
I'm In Love With That Song,0,0,0,0,18,18
The Queer Eye Podcast,0,0,0,0,9,9
We Need To Talk About Ghosts,3,0,0,3,97,103
Anatomy On The Go,0,0,0,0,5,5
Kubernetes Podcast from Google,1,0,0,0,8,9
American Innovations,18,5,14,20,182,239
The Wonderland Murders by Hollywood & Crime,51,38,42,22,131,284
Coffee & Kettlebells,0,0,0,0,50,50
All the Small Games with Andrew Levins and Jon Valenzuela,0,0,0,0,7,7
"Center Stage, with Milfred and Hands",0,1,0,0,2,3
Grilling JR,41,27,24,11,397,500
Sunday Sitdown with Willie Geist,8,3,0,7,32,50
"10,000 Swings - a Minnesota golf show by SKOR North",0,0,0,0,1,1
Shit They Don’t Tell You with Nikki Limo and Steve Greene,10,1,0,2,37,50
Bisimoto Tech2sDay,0,0,1,0,2,3
The Bar Exam Toolbox Podcast: Pass the Bar Exam with Less Stress,1,0,0,2,20,23
Match Point Canada,0,0,1,0,1,2
"Sweathead, A Strategy Podcast",0,0,0,0,22,22
Socialette: Bite-Sized Online Marketing Podcast,1,1,0,0,42,44
The LEGO® Technic Podcast,0,0,0,1,10,11
Mommy Millionaire,0,0,0,1,49,50
Shop Girls on MyTalk,0,0,0,0,1,1
Weekly Dish on MyTalk,0,0,0,0,3,3
One CA,0,0,0,0,2,2
Soberful,0,0,1,0,45,46
Locked On Cardinals - Daily Podcast On The St. Louis Cardinals Podcast,4,0,2,3,14,23
I Can't Believe That Happened History Podcast for Kids,1,0,0,1,2,4
Let's Go Devils Podcast,1,1,0,1,5,8
BDGE Fantasy Football,3,0,0,4,226,233
How to Love Your Body,2,2,1,1,44,50
Latinx Therapy,0,0,1,0,49,50
The Southern Charm Podcast,4,0,1,0,40,45
Warrior Kid Podcast,1,1,1,0,47,50
Kalyn’s Coffee Talk,0,1,8,3,38,50
Do It Scared® with Ruth Soukup,1,0,4,0,45,50
Love Works with Nicole Moore,0,0,0,2,117,119
The Voice of Louisiana Agriculture Podcast,0,0,0,0,2,2
Who Cares About the Rock Hall?,0,2,2,2,42,48
Malcom Reed's How To BBQ Right Podcast,0,0,0,0,33,33
Regenerative Agriculture Podcast,0,0,1,2,26,29
"The WealthAbility Show with Tom Wheelwright, CPA",3,3,0,0,52,58
Tiny House Lifestyle Podcast,1,0,1,0,30,32
Normalizing Non-Monogamy -  Interviews in Polyamory and Swinging,1,0,2,2,40,45
Put Me Over Podcast,0,0,0,0,3,3
40fit Radio,1,0,0,0,17,18
Back To One,4,0,0,0,14,18
The Buddy System Co.,0,0,0,0,2,2
Worst Seats in the House w/ Michael Russo & Anthony LaPanta - Minnesota Wild Podcast,4,1,1,0,6,12
7 Minute Stories w/ Aaron Calafato,0,0,0,0,48,48
The Jon Krawczynski Show - Timberwolves Podcast,2,2,3,0,5,12
Mystery Team Inc.,1,1,0,0,17,19
Outspoken Beauty,0,0,1,0,6,7
Deck The Hallmark,6,3,5,9,477,500
The Very Serious Crafts Podcast,0,1,0,1,15,17
NoBraking,0,0,0,0,7,7
I'm Fat Podcast,1,0,1,0,85,87
EDHRECast,2,0,0,0,48,50
Weather Geeks,0,1,1,3,11,16
"Research Insights, a Society of Actuaries Podcast",0,0,0,0,2,2
Podcast – The Children's Hour,0,0,0,0,9,9
Konor Knows Wrestling,0,0,0,0,3,3
Underdog Empowerment,0,0,0,1,99,100
The Shape of the World,0,0,0,0,6,6
Center For Investment Excellence,0,3,0,0,1,4
HER With Amena Brown,2,0,0,0,24,26
Behind the Bastards,104,39,46,45,266,500
The Place We Find Ourselves,1,2,0,1,122,126
"Dice, Camera, Action! – An Official Dungeons & Dragons Podcast",2,1,2,5,22,32
Master Passive Income Real Estate Investing in Rental Property,1,5,2,0,26,34
The Alternative Investor,0,0,0,0,48,48
SladyBoss Radio,0,0,0,0,78,78
Podcasts With Park Rangers - A National Parks Podcast,0,0,0,0,17,17
Social Proof Podcast,0,0,0,1,77,78
The Daily Dive,4,2,0,1,4,11
3 Point Perspective: The Illustration Podcast,1,2,2,8,179,192
Thriving In Motherhood Podcast,0,0,1,1,48,50
Private Practice Success Stories,0,0,0,1,4,5
Tacos and Tech Podcast,0,0,0,0,2,2
Frugal Friends Podcast,10,6,2,0,182,200
Diet Starts Tomorrow,9,3,10,5,23,50
Classic Movie Musts,8,2,2,2,267,281
Jemjammer,0,0,0,0,5,5
You Can’t Make This Up,28,13,8,4,56,109
This Week in Linux,1,0,0,0,2,3
Inside Trader Joe's,7,2,5,6,180,200
The Fallon Taylor Podcast,1,0,0,1,48,50
The Shakespeare Sessions,0,0,0,0,4,4
Unnecessary Roughness,64,15,16,13,160,268
Barstool Confessions,5,1,1,4,196,207
Idaho Matters,1,0,1,0,5,7
That's Awesome with Steve Burton & Bradford Anderson,0,1,2,8,348,359
The Dave Chang Show,8,0,5,4,482,499
Mic Drop from CBC Podcasts,0,0,0,0,6,6
The Woody Allen Retrospective Podcast,2,0,0,1,2,5
The Pam Sowder Podcast,0,0,0,0,7,7
Badass Manifester Podcast,0,0,2,1,99,102
The Lance Wallnau Show,0,0,0,2,10,12
Behind the Money,1,0,1,0,10,12
Bad Science,7,6,0,1,81,95
Androids & Aliens,0,1,0,2,47,50
Decoder Ring,14,5,7,11,120,157
Dear Joan and Jericha (Julia Davis and Vicki Pepperdine),14,4,8,8,287,321
Eagle Eye: A Philadelphia Eagles Podcast,8,5,2,6,101,122
Everything Under the Sun,0,0,1,0,4,5
Deadbeats Radio with Zeds Dead,0,0,0,0,15,15
"Sex, Love, and Addiction",2,0,0,1,14,17
Design Thinking 101,0,0,0,0,2,2
This Jungian Life,1,0,2,1,46,50
Upchukar Podcast,3,0,1,0,39,43
The FEMA Podcast,1,1,0,0,2,4
Sr Plus,0,0,0,0,2,2
Quicktake by Bloomberg,2,1,0,0,6,9
Replicon radio,0,0,0,0,5,5
Generation V,0,0,0,0,50,50
From the Wastes...,0,0,0,0,5,5
The Weirdest Thing I Learned This Week,31,13,24,15,296,379
What Would My Shrink Say?,0,0,0,2,39,41
Phoenix Radio,1,0,0,1,12,14
Sex for Saints,0,0,0,1,49,50
Nothing much happens; bedtime stories to help you sleep,3,9,6,12,258,288
Secrets to Marketing your Wellness MLM,3,0,0,0,37,40
cpp.chat,1,2,0,0,0,3
Uncommon Knowledge,2,3,1,1,38,45
Talent Development Hot Seat,0,0,1,1,65,67
NDE Podcast,4,3,5,3,86,101
Blue Collar Bourbon,0,1,0,0,18,19
Crazy/Genius,6,6,3,6,67,88
Whine Down with Jana Kramer and Michael Caussin,84,37,27,24,328,500
Weirdly Magical with Jen and Lou - Astrology - Numerology - Weird Magic - Akashic Records,1,0,0,2,39,42
The Keys and Anklets Podcast,1,1,1,3,19,25
Tech Buzz China by Pandaily,1,0,3,2,62,68
Business Unusual with Barbara Corcoran,1,0,1,5,186,193
California Now Podcast,0,0,1,0,9,10
The Holderness Family Podcast,1,0,1,0,48,50
Happier & Healthier with Maria Marlowe,1,0,0,1,48,50
Master Self Love,1,0,0,0,4,5
Find the Path Podcast,0,2,0,1,47,50
Saving Sex and the City 3,0,0,0,1,49,50
Love Sober Podcast,0,0,0,0,4,4
The Dallas Morning News,2,1,2,0,5,10
The Genius Life,1,0,0,0,49,50
Blanchard LeaderChat,0,0,0,0,16,16
Talk Murder To Me,10,3,1,1,485,500
The Colin and Samir Show,1,0,0,0,54,55
Morbid: A True Crime Podcast,162,66,48,38,656,970
You're Wrong About,114,62,54,46,714,990
C**t Talk,1,0,0,1,48,50
Let's Get Metaphysical,1,0,0,0,11,12
NEJM Resident 360 - Curbside Consults Podcast,1,0,0,2,10,13
Couples Therapy with Candice and Casey,37,16,18,19,410,500
83 Weeks with Eric Bischoff,1,2,6,1,48,58
Not Real Art,0,0,0,0,24,24
SportsTalk Mississippi,1,0,0,0,3,4
The Trade Guys,3,0,2,1,11,17
Rick & Bubba Show,1,0,0,2,47,50
The Goal Digger Girl's Podcast,0,0,0,2,38,40
The Cryptonaturalist,0,0,0,0,9,9
Car Ride Stories for GIGI Kids - christian stories for kids,0,0,0,0,3,3
How I Survived,0,2,5,2,48,57
New Construction Marketing Podcast,0,0,0,0,9,9
The Movement System podcast,0,0,0,0,11,11
Crrow777Radio.com,5,0,1,3,39,48
Broken Brain with Dhru Purohit,2,0,3,5,40,50
Unspooled,63,44,43,30,300,480
The Thriving Christian Artist,0,0,0,1,124,125
Kyle Meredith With...,0,0,0,0,7,7
WorkWell,0,0,1,0,10,11
Weird Science Marvel Comics,2,1,0,0,26,29
Queens of Adventure,0,0,0,0,50,50
Get Your Fit Together The Podcast,0,0,0,0,50,50
Mind Body Medic,0,0,0,0,9,9
The Crown Podcast,10,7,2,1,4,24
The Handmaid's Tale Podcast,5,2,5,1,2,15
Committed,26,15,17,9,152,219
Green Dreamer: Sustainability and Regeneration From Ideas to Life,1,0,2,1,114,118
Free Cookies,1,0,2,2,165,170
Dialed Podcast,0,0,0,1,16,17
Locked On Braves - Daily Podcast On The Atlanta Braves,6,0,2,0,10,18
Salt & Spine,2,1,0,0,27,30
SelfishBabe SelfishTalk Podcast,0,0,0,0,50,50
Smash Boom Best,1,1,0,4,44,50
"The Doctor's Farmacy with Mark Hyman, M.D.",36,24,36,14,88,198
Psychcast,0,0,0,0,6,6
Why Is This Happening? with Chris Hayes,53,6,21,24,396,500
The Backwoods Radio Show,0,0,0,0,16,16
Strong By Design Podcast,1,0,0,1,48,50
Feed Your Wild with Venessa Rodriguez,1,0,1,0,48,50
Self-Care for Extremely Busy Women,0,0,0,0,20,20
Sound Only,15,8,6,1,29,59
We Drink And We Know Things,0,0,0,0,50,50
What A Rush with Road Warrior Animal,0,0,0,0,9,9
"New Mindset, Who Dis?",2,0,0,1,47,50
We Are West Ham Podcast,1,0,0,0,1,2
The Fall Podcast,0,0,0,0,22,22
Healthy Hormones for Women Podcast,0,1,1,1,43,46
The Greatest Season That Was Presents...,0,0,0,0,1,1
Earth911.com: Sustainability In Your Ear,1,1,0,0,1,3
Kinks with KeKe,0,1,1,0,5,7
The Black Love Podcast,0,0,0,0,3,3
The Young n Muslim Podcast,0,0,0,0,27,27
The Modern Manager: Create and Lead Successful Teams,0,0,0,0,21,21
On the Job with PORAC,0,0,0,0,5,5
Mule Deer Foundation - Talking Mule Deer Podcast,0,0,1,2,2,5
Room 77 | Podcast: A Swinger Podcast,5,1,0,1,43,50
Hungry Girl: Chew the Right Thing!,5,2,4,2,187,200
R2C2 is UNINTERRUPTED,5,1,3,6,436,451
my millennial money,7,2,3,0,81,93
Failed Architecture,0,0,0,0,1,1
Kaleidotrope: A Romantic Comedy,2,3,0,2,19,26
Confessions of a Bikini Pro,0,1,1,0,48,50
Noclip,0,0,1,1,32,34
Best In Faction,3,0,1,2,23,29
Himeros LIVE,4,1,0,1,11,17
The Teacher's Pet,74,10,0,12,80,176
Dead End Hip Hop,0,0,0,0,5,5
Voice of Design,0,0,0,1,0,1
ZigZag,7,6,6,10,171,200
Hockey Training: Become a Better Hockey Player,0,1,0,0,24,25
Dodgers Nation: Blue Heaven Podcast,4,1,3,1,42,51
Zoo Logic,1,0,0,0,7,8
Cars of Carlisle,1,1,0,0,23,25
Squiz Today,2,1,3,3,86,95
Snacks Daily,133,25,21,8,313,500
The Ben Ferguson Podcast,2,0,0,0,48,50
Real Estate Disruptors,0,0,1,1,188,190
Tom Fitton's Weekly Update Podcast,8,1,2,6,33,50
Good Nurse Bad Nurse,3,1,0,2,37,43
Dark Ages,0,0,0,0,27,27
Speak Up Storytelling,0,1,0,4,94,99
The Blaque Tea,5,2,3,2,35,47
Tavern Chat,0,0,0,0,5,5
ESPNcricinfo Stump Mic Podcast,0,0,0,0,3,3
The Symbolic World,0,1,2,0,16,19
World Stealers,0,0,0,0,10,10
Young Ben Franklin,2,0,1,6,41,50
Big Dogs,0,1,0,2,47,50
Art and Labor,0,2,0,0,13,15
Big Blue Banter: A New York Giants Football Podcast,6,1,3,6,239,255
"Leadville: The 100 Mile Mountain Bike Race Podcast, p/b Floyd's of Leadville",0,0,1,0,38,39
Two Psychologists Four Beers,1,0,1,0,20,22
The Boardroom Podcast,2,0,1,1,13,17
Inside Jaws,27,18,21,5,115,186
The Uncle Hack Podcast,0,0,0,0,5,5
Yoga Teacher Resource Podcast,0,0,0,0,77,77
AMERICA'S DOCTOR: The Dr. Oz Podcast,15,1,3,2,29,50
The Cosmic Calling,2,0,1,2,88,93
Wabi Sabi - The Perfectly Imperfect Podcast with Candice Kumai,0,0,0,2,48,50
The USA Weightlifting Podcast,0,0,3,0,17,20
Talking Bay 94: Star Wars Interviews,0,0,0,0,50,50
Wicked Funny Podcast,0,0,0,0,30,30
Codex History of Video Games with Mike Coletta and Tyler Ostby,0,0,1,1,48,50
Covert,3,1,3,7,36,50
The Good Place: The Podcast,1,0,2,7,149,159
Branch Out,0,0,0,0,1,1
Earn Your Edge: Decoding Excellence in Golf & Life,0,0,0,0,134,134
The Busby Babe: for Manchester United fans,1,0,1,0,2,4
Art Class Curator,1,0,0,0,2,3
Tales from the Aletheian Society,1,0,0,0,3,4
The Michigan DNR's Wildtalk Podcast,0,0,0,0,6,6
StarTripper!!,0,1,0,2,47,50
The Impossible State,3,1,0,0,7,11
True Stories of Good People,0,0,1,3,49,53
Fire & Smoke,0,0,0,0,4,4
Highlights Hangout,11,4,6,11,18,50
The Create! Podcast,1,0,0,1,43,45
Baseball Cards Daily,0,0,0,2,48,50
Monster Porn: Weird Fiction & Horror Podcast,0,1,2,1,46,50
The Good Words Podcast,2,0,0,0,26,28
The Awake With Jake Show,0,0,0,1,49,50
Music History Monday,0,0,0,0,5,5
The Critshow,0,0,0,0,50,50
The Military Leader Podcast,2,0,1,0,26,29
Mortgage Marketing Expert,0,1,0,0,16,17
Gossip,1,3,2,2,192,200
The Taekcast: A (mostly) Sports Podcast,7,0,2,3,345,357
MLR Kickoff,0,0,0,0,18,18
Bubble,1,0,2,0,47,50
Sinisterhood,1,1,1,2,45,50
Full Marx - A Marx Bros. Podcast,0,1,0,1,11,13
The Control Group,3,2,7,3,35,50
Woke & Wired - Expanded Consciousness and Entrepreneurship,1,0,0,1,48,50
Hacking Humans,1,0,0,1,33,35
Row by Row Garden Show,0,0,0,0,3,3
Ask Father Josh (Your Catholic Question and Answer Podcast),1,0,2,3,220,226
Dispatches from the Multiverse,0,0,0,0,9,9
The Left Brain Artist,0,0,0,0,16,16
Awesemo Daily Fantasy,4,2,2,2,137,147
It's Haunted...What Now?,2,3,5,3,37,50
The Road Home with Ethan Nichtern,0,0,0,0,5,5
Let's Get Running Podcast,0,0,0,0,1,1
Nerdin Out,2,0,4,2,87,95
eCommerce Lifestyle,1,0,0,0,41,42
Growing the Valley,0,0,0,0,3,3
Teachers Need Teachers,0,0,0,0,31,31
Rabbi Daniel Lapin's podcast,0,0,0,0,5,5
Meru Media,0,0,0,0,1,1
"Peak Human - Unbiased Nutrition Info for Optimum Health, Fitness & Living",3,0,0,1,46,50
The /r/Anime Podcast,0,0,0,0,3,3
Bell to Bell with Bobby Blaze,0,0,0,0,13,13
The TASTE Podcast,0,0,0,1,15,16
Magic King Dom,2,0,0,0,12,14
Cuomo Prime Time with Chris Cuomo,17,2,3,1,27,50
Casting Actors Cast,0,0,0,0,16,16
The IBJ Podcast,0,0,0,0,1,1
What We Said,18,5,4,10,463,500
The Janet Jackson Podcast,0,0,0,0,27,27
Voices of Wrestling Flagship,0,0,0,1,3,4
Pure Skin Talk,0,0,0,2,48,50
Reptile n Chill Podcast,0,0,0,0,1,1
The Revival Motoring Podcast,0,0,0,0,50,50
Sox In The Basement,2,1,0,0,21,24
Litzenberger's Sailing Podcast,0,0,0,0,49,49
Horror Movie Club,2,2,3,3,44,54
The VBAC Link,0,0,0,2,48,50
Help for Hashimotos podcast,3,0,0,0,16,19
The Quilt Fiction Podcast,0,0,0,0,50,50
Ranks FC,0,0,0,1,56,57
Engine Noise Podcast,0,0,0,0,50,50
With Warm Welcome,0,0,0,1,3,4
bluemind ASMR,2,0,1,3,44,50
Hard Factor,17,4,2,4,473,500
Sam's Army,14,12,3,5,227,261
The Women of Illustration Podcast,2,1,2,1,17,23
The Gerry Anderson Podcast,0,0,0,1,30,31
The Sisterhood Podcast,1,0,2,3,97,103
The Black Scholars Podcast,0,0,0,1,11,12
The Blunt Report,0,0,0,0,4,4
The McCarthy Report,42,18,9,11,270,350
De Derde Helft - Eredivisie,0,0,0,0,1,1
Aaron Mahnke's Cabinet of Curiosities,3,0,2,5,40,50
Enlightened By Dogs with Kathy Kawalec,0,0,0,1,35,36
All in a Homeschool Day,0,0,0,0,10,10
Straight from the Horse Doctor's Mouth,0,0,0,0,21,21
The Bonfire with Big Jay Oakerson and Dan Soder,1,0,0,1,48,50
Joe Rogan Experience Review podcast,34,0,1,0,19,54
For the Love of Climbing,1,1,0,1,237,240
Remote Ruby,0,0,0,0,3,3
Dungeon Fables,0,0,0,1,49,50
Saturday Morning D&D Show!,0,0,0,0,6,6
Sports Gambling Podcast Network,6,1,0,2,144,153
This Had Oscar Buzz,3,6,9,7,131,156
The Food Medic,7,1,1,2,84,95
Your Queer Story: An LGBTQ+ Podcast,0,0,0,0,19,19
Mile Marker 181,218,46,42,33,161,500
The Lebo Lion Podcast,0,0,0,2,9,11
Coming Out with Lauren & Nicole,0,0,1,0,49,50
The DigitalMarketer Podcast,0,1,0,1,48,50
Spirit Dog Training Podcast,0,0,0,0,14,14
Anything Goes with James English,8,1,2,2,74,87
About The Cards,0,1,0,1,18,20
Green Rush Podcast,1,0,1,1,18,21
Throwin' Wrenches Automotive Podcast,0,0,0,0,10,10
Rabbi Moshe Weinberger,0,0,0,0,1,1
The Basketball Podcast,0,0,0,1,34,35
The Horror Virgin,13,10,4,9,332,368
PROFIT AND BEAUTY: A Show For Salon Professionals,0,0,0,0,1,1
The Joyful Mourning - A Podcast for Women Who Have Experienced Pregnancy or Infant Loss,0,0,0,0,35,35
The Witch Bitch Amateur Hour,3,0,2,1,261,267
Causepods,0,0,0,0,8,8
The Off The Hop Rope Podcast,1,0,1,0,43,45
Social Studies,0,0,0,0,50,50
The Timeline: A Phoenix Suns Podcast,1,1,0,0,46,48
The CRA Podcast with Linda Ezuka,0,0,0,0,1,1
Silent Waves,2,4,1,0,58,65
Life of an Architect,2,0,1,0,43,46
The Jon Taffer Podcast,8,1,1,4,66,80
Hysteria,52,37,26,27,358,500
That Fallout Show,1,0,0,0,49,50
Roots and All - Gardening Podcast,0,0,0,0,5,5
Aftereffect,1,2,1,2,37,43
The Fitnessista Podcast: Healthy In Real Life,2,1,0,1,46,50
The Dane Moore NBA Podcast,3,0,0,2,59,64
The David Rubenstein Show,0,1,0,0,1,2
The SSR Podcast,0,0,1,1,107,109
Pure Hustle Podcast,1,0,1,1,85,88
NIGHTLIGHT: A Horror Fiction Podcast,2,1,0,1,46,50
Mastering Blood Sugar,1,0,0,1,48,50
The Misfits Podcast,0,0,1,0,49,50
First Bite: A Speech Therapy Podcast,2,1,0,0,47,50
You Up with Nikki Glaser,9,2,2,5,32,50
The Process - Sports Recruiting Podcast,0,0,1,1,2,4
Controlled Aggression,0,0,1,0,23,24
The 443 - Security Simplified,0,0,0,0,2,2
Fitness Motivation,0,0,0,3,37,40
When in Spain,0,0,0,0,27,27
Clear+Vivid with Alan Alda,7,0,7,7,173,194
Just Roll With It,0,1,0,1,48,50
Film Stories with Simon Brew,0,0,0,0,15,15
Baseball & Chill,0,4,1,1,76,82
The Latinos Radio Show,0,0,0,0,1,1
What We're Tasting,0,0,0,0,1,1
MAKE SPACE with Cara Newhart // Home Design + DIY,0,1,1,0,35,37
Rosemary’s Ladies: A Horror Movie & Bad Movie Review Podcast,0,1,1,1,42,45
Stars and Stripes FC: for fans of USA soccer,0,0,2,0,2,4
Wild And Exposed Podcast,0,0,0,0,44,44
Urgent Care Basics,1,0,0,0,6,7
Physics World Weekly Podcast,0,0,1,0,1,2
Ham Radio Crash Course,3,0,2,3,139,147
The Peter Attia Drive,3,2,5,1,39,50
Gaslit Nation with Andrea Chalupa and Sarah Kendzior,29,15,20,22,338,424
"Get Paid: Fantasy, Gambling and DFS",0,0,0,3,16,19
The Rabbi Manis Friedman Podcast,0,0,0,0,3,3
Standing Post,0,1,0,3,21,25
Edifi With Billy Hallowell,0,0,1,0,2,3
Today With Jared James,0,0,0,1,36,37
The Mineral Rights Podcast: Mineral Rights | Royalties | Oil and Gas | Matt Sands,0,0,0,0,12,12
High Rollers DnD,2,1,2,5,40,50
Sales Leadership Podcast,0,0,0,0,17,17
Spiritual Boss Babe with Stephanie Bellinger,1,0,0,0,59,60
Marketing Geeks,2,5,4,0,38,49
The Proffitt Podcast,0,0,0,1,34,35
They Called This a Movie,0,0,0,0,2,2
Everyday Buddhism: Making Everyday Better,1,2,2,2,16,23
VinePair Podcast,2,2,6,3,16,29
From The Tips,0,0,0,0,6,6
A Sober Girls Guide,0,2,1,2,28,33
Australian Aviation Podcast Network,0,0,0,0,1,1
The Bulletproof Musician,0,0,0,0,7,7
Latest In Tech News,0,0,0,0,2,2
SquaMates,0,0,0,0,14,14
Honest HR: A Podcast from SHRM Spilling HR Truths,1,2,2,1,3,9
Beekeeping Today Podcast,1,0,0,1,15,17
The Stokecast,0,3,0,2,76,81
Access and Opportunity with Carla Harris,0,0,0,0,21,21
The Industry,0,0,0,1,25,26
Elk Talk,9,5,4,6,117,141
"Books Closed: Tattoos and the Internet Collide, Hosted by Andrew Stortz",0,0,0,0,67,67
The Laws of Style,0,0,0,0,1,1
Hannah and Erik Go Birding,0,1,0,2,35,38
History of the World podcast,0,0,0,1,49,50
The Bitcoin Standard Podcast,0,0,0,0,10,10
The Goodman & Hummel Basketball Podcast,0,0,0,2,30,32
History in Technicolor,2,0,0,1,14,17
House of Kim with Kim Zolciak,140,11,29,30,290,500
Throwing Sheyd,0,0,0,1,5,6
Symantec Cyber Security Brief Podcast,0,0,0,1,0,1
Self Improvement Daily,0,0,0,1,38,39
The Flower Podcast,0,0,0,2,43,45
Online Business Building Mamas,0,0,0,1,20,21
Daily Emunah Podcast - Daily Emunah By Rabbi David Ashear,0,0,0,0,5,5
The WellBe Podcast (getwellbe),0,0,0,0,50,50
Manger,0,0,0,0,2,2
Design Biz Survival Guide,0,0,0,0,8,8
Breaking Through,0,0,0,0,16,16
Vortex Nation Podcast,0,1,0,7,492,500
This Day in History Class,5,6,5,6,28,50
All Things Sensory by Harkla,0,2,0,1,47,50
Rekt Podcast: Bitcoin and Cryptocurrency Fun,4,0,0,0,22,26
Comic Book Workshop | A Podcast About Making Comics,0,0,0,0,11,11
WorkParty,1,2,2,2,27,34
Spitballers Comedy Podcast,0,0,0,1,49,50
The Brainy Business | Understanding the Psychology of Why People Buy | Behavioral Economics,1,0,1,2,43,47
Dynasty War Zone,2,0,0,1,106,109
Light The Fuse - A Mission: Impossible Podcast,0,0,0,1,69,70
ChasmQuest: a DND 5e Actual Play Podcast,0,0,0,1,49,50
The Rookie Fever Podcast,0,0,1,0,15,16
The Arthur Brooks Show,2,5,2,0,52,61
The Sunday Scaries Podcast,2,2,2,1,43,50
East Meets West Hunt,0,0,1,1,144,146
That Metal Podcast,0,0,0,0,5,5
Goldie On Ice Podcast,0,0,0,0,11,11
"Game-Changing Predictive Machine Learning, Presented by SAP",0,0,1,0,0,1
Locked On Vols - Daily Podcast On Tennessee Volunteers Football & Basketball,4,1,6,0,141,152
The Big Little Lies Podcast,4,5,1,1,4,15
The Treasury Update Podcast,0,0,0,1,17,18
Daily Inspiration: The Steve Harvey Morning Show,0,0,2,0,38,40
Bass University Live,0,0,0,0,13,13
P.U.C.L. Plus -More of P.U.C.L. a Pokemon Podcast,0,0,0,0,8,8
Photography Daily,0,0,0,0,6,6
NZ Everyday Investor,0,0,0,1,17,18
F1: Beyond The Grid,2,0,3,6,217,228
art for all,1,0,0,0,28,29
Style Masterclass,0,0,0,0,10,10
Passion City Church DC Podcast,0,0,1,2,43,46
Recovery Happy Hour,1,1,0,0,48,50
MAKE IT,0,0,0,0,6,6
A World Where,0,0,0,0,19,19
Catholic Sprouts: Daily Podcast for Catholic Kids,2,0,0,0,47,49
CritterCast,0,0,0,0,22,22
Growing Patriots,0,0,0,0,7,7
Sacred Symbols: A PlayStation Podcast,3,3,3,1,40,50
Automators,0,0,0,1,16,17
The Rick Shiels Golf Show,2,3,3,2,89,99
"Sean Carroll's Mindscape: Science, Society, Philosophy, Culture, Arts, and Ideas",9,6,4,7,202,228
Practical AI: Machine Learning & Data Science,1,0,0,1,8,10
Chat It U.P. Podcast,0,0,0,0,12,12
3 Things,3,0,4,6,16,29
"This Particular Album is Very, Very Important to Me",0,0,0,0,39,39
On Purpose With Alex Beadon,0,1,0,2,47,50
The Bitcoin.com Podcast,0,0,0,0,5,5
The Scene Vault Podcast,0,0,0,1,49,50
Big Woods Bucks - Deer Hunting -Education & Entertainment,0,0,1,0,52,53
Remember The Game? Retro Gaming Podcast,0,0,0,0,19,19
Hot Ones: The Classic Interviews,0,0,0,0,10,10
"The Black Vault Radio - Hosted by John Greenewald, Jr.",7,2,0,0,26,35
The Simplicity Parenting Podcast with Kim John Payne,1,0,0,0,8,9
Know Before You Go Travel Show,0,1,0,1,29,31
Philip's Apocalypse,0,0,0,1,7,8
How To Fail With Elizabeth Day,4,0,2,4,184,194
Encounters: A Paranormal Experience,1,0,0,0,18,19
Rise Together Podcast,13,3,2,2,30,50
The J. S. Bach Files Podcast,0,0,0,0,1,1
The Accad and Koka Report,0,0,0,0,9,9
BatFlip Crazy Fantasy Baseball,1,1,0,0,98,100
"Ghost Town: Strange History, True Crime, & the Paranormal",9,7,4,6,24,50
Les Ptites Histoires,0,0,0,0,2,2
Build Casters: A Gundam Podcast,0,0,0,0,1,1
Earth Rangers,2,0,2,6,40,50
Negotiate Your Best Life Podcast with Rebecca Zung,0,2,0,0,48,50
Films To Be Buried With with Brett Goldstein,0,0,0,0,53,53
Race Chaser with Alaska & Willam,25,16,28,15,416,500
"The Vibrant Music Teaching Podcast | Proven and practical tips, strategies and ideas for music teach...",0,0,0,0,11,11
Bodies,6,1,2,0,41,50
LawNext,0,0,0,1,12,13
The DriveTribe Podcast,1,2,0,1,1,5
BC the Beatles,0,1,0,1,25,27
The News & Why It Matters,14,3,14,7,458,496
Crain's Daily Gist,0,0,0,2,4,6
What Was That Like,4,1,1,0,48,54
Marriage and Martinis,9,6,6,4,355,380
WDW Opinion - A Weekly Podcast About Walt Disney World,0,0,1,0,35,36
We Need to Talk About Britney,8,5,4,2,40,59
The Speech Link: A Speech Therapy Podcast,0,0,0,0,7,7
The Vintage RPG Podcast,2,0,1,1,33,37
Commune with Jeff Krasno,1,2,4,4,35,46
Creature Feature,21,7,4,7,123,162
Unobscured,2,3,4,2,39,50
Kings of the Ring,0,1,0,1,5,7
The Logistics of Logistics Podcast,0,0,0,0,3,3
Comments by Celebs,26,14,18,10,432,500
Minnesota DNR Prairie Pod,0,0,1,0,10,11
While Black,17,0,2,3,28,50
Rheuminations,0,0,0,0,10,10
The FORT with Chris Powers,1,0,1,0,55,57
Nobody Listens to Paula Poundstone,4,1,2,2,41,50
Dirt Church Radio,0,0,0,0,1,1
The Kelli Show,1,0,2,1,309,313
Black Hills Information Security,0,0,0,0,1,1
Financial Freedom Podcast,0,0,0,4,46,50
Learn Italian with Italy Made Easy,0,0,0,0,9,9
Ultrarunning History,0,0,0,1,10,11
The Bold and Beautiful Podcast,1,0,0,0,3,4
The Big Story,0,0,0,0,1,1
The Psoriasis Geek Podcast,0,0,0,0,1,1
Business Wars Daily,8,7,4,5,25,49
Write-minded Podcast,1,0,0,3,119,123
HORSE,1,1,1,1,49,53
Innerbloom Podcast,1,1,1,1,103,107
Project Woo Woo,0,0,0,0,21,21
No Mercy Podcast,49,9,4,8,430,500
"Real Happy Mom Podcast - Time-Management, Gentle Parenting, & Self-Care Strategies for the Busy Work...",0,0,0,1,26,27
The Movies That Made Me,4,1,5,9,57,76
Chicks in the Office,34,15,24,19,408,500
Axios Re:Cap,6,4,9,2,29,50
Law Firm Autopilot,0,0,0,0,34,34
Marvel's Pull List,3,1,1,1,2,8
Lessons from a Quitter,0,0,1,0,98,99
Dr. Chapa’s Clinical Pearls.,0,1,0,0,1,2
Homeschooling Outside the Box,0,0,0,0,1,1
Relationship Psych | Love | Marriage | Conflict | Psychology |,2,0,0,1,117,120
Black History Buff Podcast,0,0,0,0,35,35
Hey Riddle Riddle,0,0,0,0,50,50
ibn abee omar,0,0,0,0,3,3
Tennish,0,0,0,0,7,7
Mothers of Invention,0,0,1,1,28,30
Reducing Crime,0,0,0,0,3,3
Seek Treatment with Cat & Pat,0,2,2,1,45,50
The Disney Dish with Jim Hill,4,0,0,3,62,69
The Michael Steele Podcast,14,3,13,29,157,216
The BBQ Central Show,1,0,1,1,23,26
The Stickbow Chronicles- Traditional Bowhunting Podcast,0,0,0,1,81,82
Last Seen,7,4,16,14,203,244
Beyond The Valley,0,0,0,0,1,1
A’s Plus,0,0,0,0,24,24
Tara Tremendous,3,2,1,4,40,50
Future Ecologies,0,1,0,0,11,12
"Make and Decorate with Stephanie Socha Design: Sew, quilt, decorate",0,0,1,1,9,11
TravelPulse Podcast,0,1,0,7,60,68
Views from The Porch,5,3,1,0,125,134
The Professional Noticer,0,0,0,1,99,100
Talking Tudors,0,0,0,2,24,26
The Adulting With ADHD Podcast,0,0,0,0,5,5
Meditation for Women,0,0,0,0,50,50
The My Hero Academia Podcast,0,0,1,0,11,12
AGI Podcast,0,0,0,0,3,3
Folk on Foot,0,0,0,0,6,6
TRAINED,0,1,0,2,47,50
Windy City Gridiron: for Chicago Bears fans,0,2,1,1,10,14
CoinDesk Podcast Network,1,0,1,0,28,30
Daily Study of Jewish Law,0,0,0,0,1,1
Without Warning,41,25,29,14,160,269
The Final Fourcast - WVU Basketball & Everything Else,0,0,1,1,12,14
The Dropcast,1,1,1,0,2,5
The Writer's Almanac,3,3,2,2,75,85
The Business of Branding,0,0,0,0,8,8
With Me Now's podcast,0,0,0,1,0,1
Squad Tactica - A Warhammer 40K Kill Team Podcast,0,0,1,1,11,13
Logos,1,2,0,5,33,41
The Science of Psychotherapy,0,0,0,0,6,6
Into the Aether,1,0,0,0,27,28
Stephan Livera Podcast,1,0,0,0,62,63
Gals on the Go,105,22,22,8,43,200
How to Write Fiction: Alone in A Room With Invisible People TM: How to Write Fiction,0,1,1,1,27,30
The John Maxwell Leadership Podcast,0,0,0,0,3,3
Giants Splash,0,0,0,0,7,7
"Intimate Judaism: A Jewish Approach to Intimacy, Sexuality, and Relationships",0,1,0,0,4,5
LS11 - Leeds United Podcast,0,0,0,0,2,2
Locked On Bulldogs - Daily Podcast On Georgia Bulldogs Football & Basketball,5,2,1,0,41,49
REROOT with Eamon and Bec,1,0,3,6,319,329
Dyl & Friends,2,0,1,1,91,95
Running Divine Podcast,0,0,0,0,5,5
The Totally Scottish Football Show,0,0,0,0,1,1
Friendly Confines Chicago Cubs Baseball Podcast,0,0,0,0,11,11
The 3-0 Take,1,2,0,0,115,118
FOMO Sapiens with Patrick J. McGinnis,0,0,2,0,48,50
"Look Out, Sir! Warhammer 40k Podcast",1,0,0,0,9,10
Angels Recap with Trent Rush,0,0,0,0,14,14
Schoolhouse Rocked: The Homeschool Revolution!,1,0,0,0,33,34
The Animals at Home Network,0,0,0,0,15,15
Commuting the Cosmos,0,0,0,0,1,1
Catholic Daily Reflections,0,0,1,0,16,17
KidNuz,4,1,0,4,41,50
Platts Future Energy,0,0,0,1,0,1
Comfort Food,1,0,0,0,25,26
Birthday Skin,0,0,0,1,16,17
Sorry Mom,2,0,0,2,18,22
Alice Fraser Trilogy,0,0,0,0,18,18
Your Life Matters,1,0,0,0,49,50
Wait Five Minutes,0,0,0,1,22,23
Horror Movie Talk,7,3,2,2,92,106
"Gardens, weeds and words",0,0,0,0,7,7
Gin & Spin with Crafty Housewife Yarns,0,0,0,0,1,1
nocrumbsleft table talks,0,0,0,0,91,91
Call Her Daddy,288,32,15,14,145,494
Milan Weekly Podcast,0,0,0,1,4,5
The Belt and Road Podcast,0,0,0,0,2,2
The Uncaged Clinician,0,0,0,0,8,8
Didn't I Just Feed You,2,0,1,1,96,100
Spilling Eve - A Killing Eve Podcast,3,1,0,0,29,33
The Radio Ga Ga Podcast,0,0,0,0,29,29
Project Nova,0,0,1,2,47,50
Hokage Thots,0,0,0,0,50,50
The Nose Knows Podcast,0,0,0,1,44,45
Attention Pliss! with Arnab Ray,0,0,0,1,4,5
Cyber Work,1,0,0,10,45,56
The Browns Wire Podcast,1,0,0,0,5,6
EXPANDED Podcast with Lacy Phillips,2,2,2,2,42,50
Dropping the Gloves,12,1,4,2,103,122
Pinstripe Alley: for New York Yankees fans,0,1,0,0,16,17
The Research Like a Pro Genealogy Podcast,0,0,1,1,48,50
Men’s Health Minute,2,1,0,0,0,3
Leading Equity,0,0,0,0,30,30
Crime In Music,1,0,3,0,5,9
300 Yards To Unknown | By RickRunGood,0,0,0,1,336,337
Rogers Waterfowl Podcast,1,0,0,0,4,5
Sober in the Sunshine,0,0,0,0,8,8
Words Matter,10,4,3,3,30,50
KSL Unrivaled,1,1,0,1,5,8
Spectrum Autism Research,1,0,0,1,0,2
"Sit, Breathe, Bow",0,0,0,1,11,12
Today In Jewish History,0,0,0,2,11,13
Legal Beagle- Personal Injury Law Podcast,0,0,0,0,3,3
Tinsel Tunes Podcast,0,0,0,0,17,17
Looking For The Middle: The Christian Girl's Guide to Modern Dating,0,2,1,1,25,29
Dr. Death,12,3,12,21,452,500
Schwab Market Update Audio,0,0,2,3,2,7
Contractor Growth Network,0,0,0,0,16,16
Jump Street Podcast,0,0,0,0,88,88
Ghost of a Podcast: Astrology & Advice,3,1,0,0,46,50
The No Chill Podcast,4,5,5,8,56,78
Unexpected Reviews and After Show - AfterBuzz TV,0,1,0,2,1,4
Land & Legacy - Sportsmen's Nation,0,0,1,0,37,38
Warriors Weekly Rugby Podcast,0,0,0,0,1,1
Thunder & Lightning,8,1,3,7,213,232
Inside the Strategy Room,1,1,0,0,1,3
The Secret History of the Future,2,2,0,3,46,53
FRAMED: An Investigative Story,25,39,43,11,146,264
The Chewjitsu Podcast,0,0,0,0,56,56
Jimmy Akin's Mysterious World,4,1,1,5,175,186
Yahoo Sports College Podcast,24,3,2,6,104,139
Yahoo Sports NFL Podcast,8,1,4,1,486,500
Big Fat Positive: A Pregnancy and Parenting Journey,3,1,1,1,38,44
Becoming Mother Nature,1,0,1,2,46,50
The First Degree,65,26,45,31,333,500
Fixing Healthcare Podcast,1,0,0,1,10,12
Pit Life BBQ,0,0,0,0,6,6
90 Day Fiance Cray Cray,36,27,18,14,405,500
Women's Health By Heather Hirsch,0,0,0,0,12,12
Pardon the Mess with Cynthia Yanof,1,0,1,0,118,120
The Laura Horn Art Podcast,0,0,1,0,67,68
Never a straight answer,0,0,0,0,13,13
More Plates More Dates,0,0,0,1,17,18
The Punies by Kobe Bryant,1,1,0,0,48,50
I Hear Design: the i+s podcast,0,0,0,0,1,1
Mega,0,0,0,0,50,50
SAPIENS: A Podcast for Everything Human,1,0,0,1,26,28
Psychopharmacology and Psychiatry Updates,0,0,0,0,2,2
Dlisted: The Podcast,3,0,1,1,121,126
Batwoman Podcast,2,1,1,3,2,9
"Roots, Rednecks, and Radicals",0,0,0,0,2,2
Justa Runners podcast,0,0,0,0,7,7
Alliteration Am Arsch,0,0,0,0,1,1
The Great Books of Literature Podcast,0,2,0,0,4,6
The Passing Shot Tennis Podcast,0,0,0,0,1,1
NPTE Studycast | Physical Therapy,0,0,0,3,5,8
Fear Initiative: Dungeons and Dragons and Horror,2,0,1,3,27,33
Superwomen with Rebecca Minkoff,2,2,1,3,78,86
Housing News,0,0,1,0,1,2
70 Million,0,0,0,1,10,11
getWITit | Women in Technology,0,0,0,0,3,3
Real Leaders Podcast,0,0,1,1,37,39
Gola,1,0,1,1,14,17
The Rational Reminder Podcast,0,0,0,0,31,31
The Play's the Thing,0,3,1,0,22,26
Defying the Status Quo,0,0,0,0,8,8
Hold My Popcorn,1,1,1,0,32,35
You Beauty,15,10,12,6,50,93
Cidiot,0,0,0,2,14,16
Sufi Heart with Omid Safi,0,0,0,0,8,8
Nerd Radio,0,0,0,1,6,7
"Km42 - Courir, manger, dormir, recommencer",0,0,0,0,1,1
My Hero Academia Podcast,0,0,1,0,9,10
Navigating Neuropsychology,0,0,0,1,46,47
Rogue Ways,0,0,0,0,13,13
QAnon Anonymous,82,19,21,16,299,437
Living Well with Multiple Sclerosis,0,0,1,0,2,3
Seven Stripes Fishing,0,0,0,0,11,11
Hit the Bricks,1,0,0,4,11,16
Filter Stories - Coffee Documentaries,0,0,0,2,23,25
Delicious Ways to Feel Better,12,6,6,12,178,214
SojuTalk Kpop Podcast,1,0,1,0,8,10
Crime After Crime,1,2,3,2,67,75
Move The Line,0,0,0,0,20,20
TogetherBHA,0,0,0,0,6,6
Horror Tales,5,2,1,3,22,33
The Fundamism Podcast,0,0,0,0,29,29
#JCsMusicology,0,0,0,0,15,15
Mirrors,0,1,2,0,47,50
Brain Inspired,0,0,0,0,9,9
Smarter Building Materials Marketing,1,0,0,0,12,13
Resoundingly Human,0,0,0,0,1,1
Jewelry Journey Podcast,0,0,0,0,3,3
Under Review Tennis Podcast,0,1,1,0,29,31
The Stop Binge Eating Podcast,0,1,1,1,47,50
Locked On Sooners - Daily Podcast On Oklahoma Sooners Football & Basketball,2,0,0,0,20,22
Producing The Beatles,0,0,0,0,50,50
FCCFREE RADIO,0,1,0,0,2,3
Fly Fish Food Shop Talk Podcast,1,0,0,0,9,10
The Fundraising Talent Podcast,0,0,0,0,3,3
The State of The Universe,1,0,0,1,23,25
Zero Waste Life Hacks Podcast,0,3,0,0,11,14
Awake At Night,0,0,1,0,21,22
Squared Circle Psychobabble,0,0,0,0,1,1
Locked On Razorbacks - Daily Podcast On Arkansas Razorbacks Football & Basketball,5,0,0,0,11,16
Spooky Troop: The Last Halloween,1,1,2,4,18,26
Plenary Session,0,1,1,3,88,93
Sweaty and Pissed,0,0,0,0,50,50
Locked On Cougars - Daily Podcast On BYU Cougars Football & Basketball,3,1,0,1,114,119
The B.rad Podcast,0,0,1,1,41,43
Chrisley Confessions,11,1,1,2,35,50
The Daily Stoic,0,0,0,0,5,5
Gag On This...Podcast,0,0,0,0,4,4
Cosmonaut Tabletop,0,0,0,0,50,50
Pretty Rich,0,0,0,1,51,52
American Revolution Podcast,0,0,0,1,49,50
The Konnichiwa Podcast - Conversations in English and Japanese,0,0,0,0,4,4
The New Hunters Guide,0,0,0,0,15,15
The Downbeat,0,0,0,0,29,29
"Big Fat Negative: TTC, fertility, infertility and IVF",0,0,0,0,50,50
The Fitness Business Podcast with Erin Dimond and Jordan Dugger,0,1,0,1,48,50
The Collector’s House,0,0,0,0,2,2
The Inspiration Place,0,0,0,0,119,119
Screen Drafts,1,1,0,1,70,73
Voices of Search // A Search Engine Optimization (SEO) & Content Marketing Podcast,1,0,0,0,11,12
Married With Horses,1,0,3,4,89,97
The Love Lab Podcast: Sex | Love | Relationship,1,0,0,1,24,26
After Adult with Siri Dahl,4,2,0,1,38,45
The Lets Read Podcast,4,10,10,13,222,259
Monday Match Analysis,0,0,0,0,11,11
Gettin' Better with Ron Funches,1,1,0,2,46,50
Roommate From Hell,0,0,0,0,15,15
People Who Read People: A Psychology Podcast,0,0,0,1,12,13
Car Chat,0,0,0,0,6,6
Magic on The Inside,1,0,0,0,50,51
Design:ED,0,0,0,1,15,16
The City,16,12,15,16,131,190
Everyone's A Critic,0,1,1,0,48,50
"Locked On Bama - Daily Podcast On Alabama Crimson Tide Football, Basketball and Randomness",1,1,0,1,23,26
Lone Duck’s Gun Dog Chronicles,1,0,0,1,95,97
Cobra Kai Kompanion,1,0,0,0,19,20
The FlyLife Podcast,0,0,0,3,8,11
The Smiling Homeschooler Podcast,0,0,0,0,18,18
The Spawn Chunks - A Minecraft Podcast,0,0,1,1,48,50
WhatCulture Gaming,1,2,1,3,9,16
The Daily Poem,0,1,0,3,86,90
The Royal Rota,11,2,2,5,9,29
BTR Boxing Podcast Network,0,0,0,0,2,2
Bonded in Bourbon,0,0,1,1,5,7
The Born And Raised Audio Experience,1,0,0,0,128,129
Cast and Crank Fishing podcast,1,0,1,2,161,165
Gut Health Gurus Podcast,0,0,0,0,6,6
The Major Wrestling Figure Podcast,1,0,1,2,46,50
Secrets of Top Selling Agents Podcast,0,0,0,0,3,3
"Fit, Healthy & Happy Podcast",0,0,0,0,50,50
The Ryen Russillo Podcast,61,10,10,19,399,499
The Snowboard Project,5,0,0,2,73,80
In Your Head with Chris Medina,1,1,0,0,48,50
WHOA That's Good Podcast,3,3,0,9,261,276
The Agora,0,0,0,0,14,14
The Devin Nunes Podcast,10,1,3,3,33,50
Two Girls One Mic: The Porncast,1,0,2,2,45,50
Yellowstone Reviews and After Show - AfterBuzz TV,0,0,0,1,2,3
Acting Class Weekly with Sean Whalen,0,0,0,0,23,23
The Pomp Podcast,10,5,3,4,178,200
"Architecture, Business & Design",0,0,0,1,2,3
Front & Nationwide: A show about the Columbus Blue Jackets,1,2,0,0,6,9
CRISPR Cuts,0,0,0,1,8,9
Global Connected Aircraft Podcast,0,0,0,0,2,2
Food Talk with Dani Nierenberg (by Food Tank),0,0,0,0,11,11
The FI Show,0,0,0,0,61,61
Super Ordinary,0,2,1,1,22,26
Thick & Thin,28,3,5,2,115,153
Pure Nurture Pregnancy and Birth,0,0,0,0,18,18
Primary Care Update,0,0,1,0,13,14
Wingnut Social: The Interior Design Marketing and Business Podcast,0,0,0,0,111,111
Lex Fridman Podcast,30,6,6,36,672,750
Life With Liz,0,0,0,0,4,4
The Creative Endeavour,0,0,0,0,40,40
Real Estate Agent Success Calls,0,0,0,0,28,28
MIMI,6,2,0,1,41,50
Cheat Sheet Podcast from The Daily Beast,4,2,2,1,9,18
Indiana Sports Beat with Jim Coyle,1,0,1,0,1,3
Carlos Pagni en Odisea Argentina,0,0,0,0,2,2
School Librarians United with Amy Hermon,0,0,0,1,9,10
Erazno y La Chokolata El Podcast,5,0,1,2,42,50
The Dog Savant Podcast,0,0,0,0,11,11
Worth The Calories - A Great British Bake Off Podcast,0,0,0,1,7,8
The Midnight Boys Present: A Free Podcast,0,0,0,0,11,11
Forty20 Rugby League Podcasts,0,0,0,0,1,1
The Femails,3,0,1,2,96,102
Detour To Neverland,0,0,1,1,61,63
Peds RAP,0,0,0,0,1,1
Primary Care RAP,0,0,1,1,2,4
Urgent Care RAP,0,0,0,0,1,1
Appaloosa,0,0,0,0,1,1
Wonders and Miracles,0,0,0,0,44,44
The Dr. Gundry Podcast,3,1,1,1,44,50
Mean Book Club,4,0,0,2,36,42
We Built A Thing,0,1,0,0,33,34
Tai Asks Why,3,1,2,3,41,50
The Wise Consumer,0,0,0,0,12,12
Wild Thing,7,11,11,16,279,324
Bastards of Boston Baseball (Red Sox),8,0,0,1,80,89
Emotional Abuse,0,0,0,0,1,1
Rivals of Waterdeep,0,0,1,0,6,7
Shaun Attwood's True Crime Podcast,1,2,0,0,14,17
Just Us Weirdos,0,0,2,3,45,50
Consumer Finance Monitor,0,0,0,0,2,2
Asimov's Science Fiction,0,0,0,1,4,5
Broken Harts,118,85,77,61,159,500
Zoo,3,9,2,2,26,42
The Hyperfine Physics Podcast,0,0,0,0,2,2
Happy Face Presents: Two Face,60,81,116,80,163,500
No Bullsh!t Leadership,0,0,0,0,5,5
Rewilding Earth Podcast,0,0,0,0,7,7
The View,15,5,5,6,19,50
Mobile Suit Breakdown: the Gundam Anime Podcast,0,0,0,2,48,50
The Fisheries Podcast,0,0,1,0,2,3
My DVC Points Podcast,1,0,1,1,82,85
Adventures in New America,15,1,3,7,24,50
American Greed Podcast,4,2,1,2,28,37
The Jeselnik & Rosenthal Vanity Project,8,3,2,5,182,200
With Intention,2,1,4,2,41,50
USMLE Step 2 Secrets (An InsideTheBoards Podcast),1,0,0,1,17,19
The Not For Lazy Marketers Podcast,0,0,0,0,50,50
Confidence & Self Esteem Podcast,0,0,0,0,2,2
Diet Doctor Podcast,0,0,1,1,40,42
Wine Face,0,0,1,0,39,40
90 Minutes Or Less Film Fest,0,0,0,0,1,1
Her Brilliant Health Revolution with Dr. Kyrin,0,0,0,0,31,31
Beth Tikkun Messianic Congregation,0,0,0,0,3,3
Gold Goats 'n Guns Podcast,0,1,0,0,3,4
MASH Matters,0,0,0,0,53,53
Siempre es Lunes,4,0,1,0,45,50
I Love Old Time Radio,0,1,0,0,4,5
Arden,2,4,3,2,39,50
Crypta,0,0,0,1,26,27
1994,1,0,0,0,8,9
BE THE PEOPLE,0,0,0,0,16,16
4:13 Podcast with Jennifer Rothschild,0,1,1,4,253,259
The Pat McAfee Show 2.0,24,4,8,6,148,190
The Phinsider: for Miami Dolphins fans,4,1,1,3,49,58
Everyday Wellness,1,0,0,0,49,50
True Tales From Old Houses,0,0,0,0,12,12
The Pod,5,3,3,1,38,50
Women of Impact,0,0,1,2,47,50
Let's talk about the 2000's,0,0,0,0,7,7
PCOS and Food Peace,1,0,0,1,5,7
The Shotgun Start,5,6,2,2,199,214
The Unapologetic Man Podcast,0,0,0,0,50,50
"Trading Nut | Trader Interviews - Forex, Futures, Stocks (Robots & More)",0,0,0,0,25,25
The Jim Rome Show,4,0,0,1,17,22
The Art Business Podcast,0,0,0,0,2,2
The Small Nonprofit,0,0,0,0,10,10
Currently Reading,15,10,11,7,157,200
Eggplant: The Secret Lives of Games,0,1,0,1,20,22
Smart Marketing for Small Nonprofits,0,0,0,0,4,4
"The Seo Singh Show: Content Marketing, Influencer Marketing and Blogging Tips",0,0,0,0,3,3
Beginners Guide to Star Wars: Legion,1,0,1,2,16,20
Stanford Steve & The Bear,5,2,7,2,87,103
The Fashion Geeks,0,0,0,0,8,8
Random but Memorable,0,0,1,1,15,17
Pass The Mic,7,0,2,1,328,338
Morgan Evans More or Less Pickleball Podcast,0,0,0,0,2,2
American Scandal,65,45,20,55,570,755
Crystal Paine Show,3,3,2,4,38,50
Lightning Radio REPLAY,0,1,0,0,0,1
Arabic in 60 Steps Podcast,0,0,0,0,4,4
Club Cool,2,2,2,1,193,200
Le Run Down,0,0,0,0,2,2
The Internet Book of Critical Care Podcast,0,0,0,0,28,28
History Storytime - For Kids,0,0,0,1,9,10
Pre-Loved Podcast with Emily Stochl,0,2,0,0,13,15
The Well Of Sound,0,0,0,0,23,23
Oilersnation Radio,0,0,0,0,5,5
The Pack Animal Podcast,0,0,0,0,1,1
The Dream,85,64,82,25,244,500
Bass Fishing Dads's Podcast,0,0,1,0,12,13
Sporadically Board with Mike and Dan,0,0,0,0,7,7
Unspeakable Crime: The Killing of Jessica Chambers,8,10,12,10,24,64
The 4 Phase Cycle Podcast with Zesty Ginger || Hormone Balance | Women's Health | Mindset,0,0,0,5,45,50
Locked On Wolverines - Daily Podcast On Michigan Wolverines Football & Basketball,5,1,2,2,10,20
Accounting 101 with Jimmy Stewart,0,0,0,0,26,26
Big Blue View: for New York Giants fans,8,1,8,1,18,36
the talking greenkeeper,0,0,0,0,9,9
The Golf Practice Podcast,0,0,0,1,3,4
Raising Adults: Future Focused Parenting,0,0,0,1,49,50
Haunted Happenstance,0,0,3,1,46,50
Beauty Biz Bffs,5,1,1,3,190,200
Upzoned,1,0,0,0,6,7
Bucher and Friends,6,0,1,4,59,70
The Last Round,1,0,0,0,15,16
That Peter Crouch Podcast,6,2,6,8,126,148
How To Make Friends Podcast,0,0,0,2,6,8
Queer America,0,0,0,0,2,2
The Sporting KC Show,1,1,0,0,5,7
The Adam Rank Podcast,3,0,0,0,12,15
Brewbound Podcast,1,0,0,1,8,10
Retro Game Guys (A Retro Gaming Podcast),0,0,0,0,4,4
Protagonist Podcasts,0,0,0,0,3,3
Orbitals,0,0,0,0,1,1
Internal Comms Pro: The Podcast,0,1,0,0,3,4
Connecting Threads Quilting Podcast,0,0,0,0,1,1
JAT Podcasts,0,0,0,1,1,2
Saga,0,0,2,4,51,57
Our Ludicrous Future,1,1,1,4,65,72
"Another Way, by Lawrence Lessig",1,0,1,1,15,18
Ghosts In The Night a Hauntings and Paranormal Podcast,0,0,1,1,7,9
Dear Albie,8,5,9,5,302,329
Gaze At the National Parks,0,0,0,0,28,28
The Catholic Talk Show,1,4,1,10,188,204
"I Like Your Work: Conversations with Artists, Curators & Collectors",0,0,0,0,50,50
Cult Liter with Spencer Henry,6,2,1,3,488,500
Bogleheads On Investing Podcast,1,2,0,0,16,19
Locked On LSU - Daily Podcast On LSU Tigers Football & Basketball,0,0,0,1,40,41
"What's Your Favorite Part? | To All the Boys (TATBILB), High School Musical: The Musical: The Series...",0,0,0,0,3,3
Countdown to Capture,7,5,8,9,21,50
Predators Official Podcast Presented by Two Rivers Ford,1,1,0,0,49,51
Please Explain,10,2,5,10,26,53
The Homeowners Show,1,0,0,0,15,16
The Social Work Stories Podcast,0,1,0,1,18,20
Geeky Retro Nerds Show - Pop Culture Podcast,0,2,0,0,13,15
Good Girls Talk About Sex,2,0,0,0,24,26
I Love You So Much With Kenzie Elizabeth,11,6,4,0,29,50
The Brendan O'Neill Show,0,1,1,1,26,29
FOMO,0,0,0,0,2,2
Alden's Amazing Roblox Review,3,1,1,3,42,50
I am a bit of an Expert: A Peppa Pig Podcast,1,0,1,1,4,7
No Feeling Is Final,0,0,0,0,2,2
Daniel and Jorge Explain the Universe,10,7,21,11,177,226
Creepy Club Podcast,1,0,0,3,27,31
Bear Hunting Magazine Podcast,1,0,1,0,135,137
"Grimm, Grimmer, Grimmest",4,1,1,1,43,50
The Simple Ayurveda Podcast,1,0,0,1,48,50
"The Orisha : Right Character, Real Power, and True Tradition",0,0,0,0,6,6
Undertaking: The Podcast,1,0,0,0,31,32
Calling Darkness Podcast,4,2,1,1,22,30
Offshore Wind Insider,0,0,0,0,1,1
The Savagely Sincere Podcast,0,0,0,1,1,2
Hero Notes: The My Hero Academia Recap Podcast,1,0,0,1,8,10
Brat Perversions Podcast,0,0,0,0,1,1
The Ozark Podcast,4,2,1,1,6,14
The Garden Podcast,0,0,0,0,1,1
Nonprofit Lowdown,0,0,0,0,29,29
Atlanta Braves Radio Network,0,0,1,0,10,11
#ITSNEEDED,0,1,0,0,49,50
The Chuck Oliver Show,2,1,0,1,6,10
The Pierre T. Lambert Podcast,0,0,0,0,11,11
Artful Painter,0,0,0,0,7,7
Eat My Globe,1,0,1,1,42,45
The Dream Bigger Podcast,0,0,0,3,40,43
Way Too Early with Kasie Hunt,4,3,5,3,28,43
Awaken With JP Sears Show,9,0,0,0,41,50
Plant-Powered People Podcast,0,0,0,0,12,12
Threedom,0,0,3,2,45,50
How We Run: Tips and Tales of Non-Profit Success,3,1,0,0,4,8
Behind the Song,0,0,1,1,2,4
The Creative Voyage Podcast,0,0,0,0,8,8
Upbringing,0,1,0,0,49,50
Hollywood and Beyond,0,0,0,0,5,5
Peak of Serenity,0,0,0,2,3,5
Wizards After Dark: A Washington Wizards Podcast,0,1,0,0,42,43
The Goal Standard,0,0,0,0,32,32
Five Minute Feng Shui,0,0,0,0,13,13
Puck Bunnies,1,1,0,0,44,46
Luke Dunkin's Low Budget Live,0,0,0,0,34,34
The Eavesdrop Podcast,1,0,1,0,48,50
The Simplicity Sessions,0,0,1,0,13,14
The Protagonistas,0,0,0,0,33,33
No One Told Me,0,0,0,1,39,40
Talking Practice,0,0,0,0,3,3
Behind the Braves,0,0,3,5,49,57
Professor Theo's Mystery Lab,0,1,0,0,21,22
The Naked Marriage with Dave & Ashley Willis,4,0,1,1,305,311
The Modern Lady Podcast,0,0,0,0,46,46
Overnight Success,1,0,0,0,28,29
The Horror of Dolores Roach,1,4,3,4,38,50
ClubProGuy Podcast,1,0,0,0,18,19
Without Fail,10,6,15,11,158,200
The TED Interview,1,0,7,3,156,167
Sold In America,31,45,21,16,87,200
The Readback,1,2,2,0,13,18
Between the Worlds Podcast,11,2,5,3,372,393
AIR JORDAN: A FOOD PODCAST,1,1,0,0,65,67
A Scary Home Companion,0,0,0,0,14,14
Dark Dice,0,0,1,0,45,46
A History Of Rock Music in Five Hundred Songs,0,0,0,0,46,46
The Course Of Life,0,0,0,0,2,2
Homeschool with Moxie Podcast,0,0,0,0,1,1
Ghoul Intentions,1,1,0,0,43,45
The Problem Was Me,1,0,0,0,16,17
How to Start a Podcast,0,0,0,0,50,50
Infamous America,3,1,3,0,43,50
Woodshop Life Podcast,0,0,0,0,50,50
Lionhearted Dentists with Dr. Steve Rasner,0,0,0,0,9,9
Read Me a Poem,0,0,0,0,6,6
The Creative Rising,0,0,0,2,55,57
Queer Dungeoneers,0,0,0,0,12,12
The Mina Kimes Show featuring Lenny,7,2,1,4,286,300
Locked On Spartans - Daily Podcast On Michigan State Spartans Football & Basketball,3,4,5,3,32,47
The Mark Davis Show,3,0,0,1,1,5
Wireframe,1,4,5,4,9,23
The End Of The World with Josh Clark,12,12,10,16,450,500
One to Grow On,0,0,0,0,17,17
Fly Maui,0,0,0,0,5,5
Curious Kid Podcast,0,1,3,0,46,50
Renuncia Feliz Podcast,1,0,0,1,48,50
USCHO Weekend Review,0,0,0,0,1,1
PensBurgh: for Pittsburgh Penguins fans,0,2,0,0,7,9
Sue Larkey Podcast,0,0,0,0,1,1
Wild Swim Podcast,0,0,0,0,2,2
CREOGs Over Coffee,0,0,0,0,26,26
Front Porch Swingers,1,1,1,1,38,42
Come Rain or Shine,0,0,0,0,23,23
Prep Life,1,1,1,1,46,50
It Happened In Hollywood,9,2,0,0,28,39
Are Weeb There Yet?,0,0,0,0,8,8
A Call to Lead,1,0,0,2,54,57
Hell and Gone,116,84,81,54,165,500
Riffs on Riffs,0,0,0,1,18,19
Net Assessment,3,2,3,0,18,26
Death by Dying,0,0,0,0,50,50
Jupiter Saloon,1,0,0,0,8,9
Chick Chat: The Baby Chick Podcast,0,0,0,0,3,3
The Great Indoors,0,0,1,1,70,72
The Slowdown,0,0,1,1,68,70
Flyest Fables,0,0,1,5,44,50
JonBenet Ramsey,4,0,0,0,2,6
Olive Hill,0,1,1,5,43,50
"THE STEFANIE GASS SHOW - Clarity Coaching, Kingdom Entrepreneurs, Podcasting, Courses, Christian Bus...",0,0,0,0,150,150
Dreamboy,4,3,1,4,38,50
"Two Minutes in the Garden: Gardening Tips, Science, Myths",0,0,0,0,3,3
The Monster Hunters,0,0,0,0,20,20
Chaos Agents DND,0,0,1,0,4,5
The Dose,0,1,1,1,1,4
Dear Murder Street,0,0,1,1,48,50
The Insider,0,0,0,0,4,4
Gladiator: Aaron Hernandez and Football Inc.,27,11,21,33,408,500
The Crappie Connection,0,0,0,0,8,8
Book Cheat,1,0,0,0,85,86
Behind The Screen,0,1,0,1,1,3
"It's Britney, Bitch!",10,3,0,2,119,134
Flow Podcast,0,0,0,0,4,4
The Darkroom,0,0,1,3,38,42
Porcelain Peak,0,0,0,0,21,21
Clean With Me,3,1,3,1,42,50
Fanimated,0,0,0,1,18,19
The Key Nutrition Podcast,0,0,0,0,50,50
The Big Story,9,3,1,0,4,17
Katie Piper's Extraordinary People,1,1,2,2,42,48
Hot Hollywood - The Hottest Entertainment News From Us Weekly,2,1,2,0,23,28
House of Rugby,0,0,0,0,7,7
The Argument,124,62,62,57,195,500
Deconversion Therapy,1,0,1,1,53,56
"Heal, Survive & Thrive!",0,0,0,0,32,32
LitReading - Classic Short Stories,0,0,1,2,29,32
Conan O’Brien Needs A Friend,32,13,19,16,419,499
Crafting & Coffee with Amy Latta Creations,0,0,0,0,5,5
En 5 minutes,0,0,0,0,1,1
TV's Top 5,8,2,1,4,115,130
The Horrorble People's Podcast,0,0,0,0,11,11
Age of Plastic,0,0,0,0,2,2
Detail Therapy with Amy Landino,3,0,1,0,88,92
Mature Audiences Mayhem,0,0,0,1,5,6
You Bet Your Garden,3,1,1,1,22,28
Biceps After Babies Radio,0,0,0,1,49,50
Future Perfect,7,2,5,3,52,69
Sleepover,0,0,0,0,1,1
Something Scary,9,0,8,6,177,200
FearScape Paranormal Podcast,0,0,0,0,3,3
Pour Minds Podcast,0,0,2,0,48,50
The Bloom & Grow Show with Amber Housley,0,0,0,0,21,21
Entrepreneurial Thought Leaders Video Series,0,0,2,0,0,2
The Power Trip After Party,4,0,0,1,51,56
Full Cast And Crew,2,1,2,1,8,14
Golden Edge - Vegas Golden Knights Hockey,0,0,0,2,5,7
The Bitchuation Room,1,0,0,1,48,50
Mom Brain,32,4,3,1,10,50
Empowering Women Physicians,0,0,0,1,49,50
Green Industry Podcast,2,1,0,1,96,100
Sex Magic Podcast,0,0,1,0,15,16
Run Farther & Faster — The Podcast with Coaches Lisa Levin and Julie Sapper,0,0,0,1,119,120
Boring Books for Bedtime,4,3,2,4,37,50
Deliver Us - True Paranormal Stories,0,0,0,0,10,10
Carruth,0,0,4,1,96,101
The Vietnamese Boat People,0,0,0,0,8,8
Runners of NYC,2,2,1,1,52,58
FT News Briefing,0,0,0,0,4,4
Journey with Story -  A Storytelling Podcast for Kids,0,0,1,0,40,41
Young Nails Biz Talk,0,0,0,0,3,3
Native Stories,0,0,0,0,5,5
The Motivated Mind,2,0,1,2,31,36
House Party,0,0,0,1,12,13
Pseudo-Intellectual with Lauren Chen,9,3,2,5,31,50
Alchemy This,1,1,0,0,48,50
Proof,8,7,12,11,126,164
The Alert 5 Podcast,0,1,0,0,0,1
Kingpins,43,23,25,14,111,216
The A Million Little Things Podcast,1,2,0,0,1,4
Unspookable,4,1,0,4,41,50
GUIDE Culture® Podcast,0,1,1,0,71,73
Jereshia Said,0,0,0,0,50,50
Commentary Club,0,0,0,0,2,2
Racer's Edge Podcast,0,0,0,0,23,23
Canadian Prepper Podcast,0,0,0,1,16,17
Between the Reps with Brooke Ence & Jeanna Cianciarulo,1,1,0,0,48,50
The Writer's Way | How to Market Your Children's Book,0,0,0,0,21,21
Time:Bombs,1,0,1,1,59,62
The Story Song Podcast,0,0,0,0,10,10
Islamic History X,0,0,0,0,12,12
Hello Dysfunction,0,0,0,0,50,50
That's Pediatrics,0,0,0,0,2,2
And She Rises…,6,0,0,1,43,50
The Trend Reporter,4,1,1,1,89,96
The Other Side of Weight Loss,0,0,0,1,29,30
The Weirdness,3,1,1,5,40,50
An Arm and a Leg,1,3,1,4,107,116
Tantra Made Easy,0,0,0,0,2,2
Locked On Utes - Daily Podcast On Utah Utes Football & Basketball,0,0,0,0,29,29
Cover Stories with Chess Life,0,0,0,0,1,1
Blackwood,1,2,6,6,35,50
The Self-Love Club®,1,2,1,2,16,22
Simple on Purpose | Intentional living for Christian moms to simplify and live on purpose,0,0,0,0,23,23
That's Spooky,1,0,0,2,241,244
Next Level Skiing,0,0,1,1,18,20
Read Me Romance,11,1,4,4,180,200
To The Point - Cybersecurity,0,0,0,1,4,5
This Might Get Weird,4,0,1,0,45,50
Lethal Lit: A Tig Torres Mystery,1,2,2,3,29,37
Consumer Reports Daily,2,0,0,0,4,6
Goblet Of Wine: A Drunken British Harry Potter Podcast,0,1,0,1,60,62
What Next | Daily News and Analysis,7,5,5,6,27,50
Cannabis Tech Talks,0,0,0,0,3,3
Wrath & Story,0,0,0,1,36,37
My Marvelous Year,0,1,0,0,49,50
Ehsanoo,0,0,0,3,46,49
Balanced Black Girl,0,1,0,0,49,50
NHL Fantasy on Ice,0,0,4,3,117,124
D.R.E.A.M.,0,1,0,0,2,3
Tao of Our understanding Alcohol Recovery Podcast,0,0,0,0,7,7
Knicks Film School,2,2,1,2,73,80
The Five Moore Minutes' Podcast,0,0,0,0,1,1
"Moonbase Theta, Out",1,0,0,2,25,28
Casual Swinger - A Swinging Lifestyle Podcast,4,0,0,1,23,28
SHE  with Jordan Lee Dooley,2,3,2,0,193,200
Empath's Alchemy,0,1,0,0,40,41
Doggie Club,0,0,0,0,24,24
You're Booked,0,0,0,3,1,4
The Divorce Doctor,0,0,0,0,9,9
Meet Me at the Museum,0,0,0,0,1,1
Shedunnit,0,0,0,0,71,71
State of the Unions,0,0,0,0,9,9
Video Palace,2,1,2,4,41,50
The Big Picture,79,44,67,53,205,448
Setting The Pace: A Pacers Podcast,1,0,1,0,18,20
2Legs: A Paul McCartney Podcast,0,0,0,0,3,3
Experts on Expert with Dax Shepard,5,2,2,4,37,50
Bite Me - A Texas Saltwater Fishing Podcast,1,0,2,2,26,31
The CEO Teacher Podcast,1,1,0,1,197,200
Husk,1,1,2,1,28,33
Podcasting Business School with Adam Schaeuble,0,0,1,0,49,50
What's Good with Miniminter and Randolph,17,0,2,6,310,335
The Contracting Experience,0,0,0,0,3,3
Talk More Talk: A Solo Beatles Videocast,0,1,1,0,0,2
The American Mind,2,1,4,0,43,50
For the Record: The 70s,1,0,0,1,15,17
The Confidence Chronicles,0,0,0,0,32,32
The Goal Achievement Podcast,0,0,0,0,14,14
Red Pilled America,2,2,8,5,382,399
FastTrack Your Fashion Brand Podcast,0,0,0,0,18,18
Talk Art,2,1,3,1,43,50
"The Cure for Chronic Pain with Nicole Sachs, LCSW",2,0,0,2,46,50
Motherhood Simplified,0,1,1,1,33,36
Suze Orman's Women & Money (And The Men Smart Enough To Listen),12,1,5,3,179,200
My Paranormal Story,0,0,0,0,5,5
The Inspirational Runner Podcast,0,0,0,0,1,1
Truth Wanted,2,0,0,0,6,8
Exeter,0,0,0,0,50,50
Authentic Influencer Podcast,0,0,0,1,49,50
Farm Food Facts,0,0,0,0,4,4
Pretty Basic with Alisha Marie and Remi Cruz,0,0,0,0,46,46
Diet Riot,1,0,0,1,34,36
PPC Den: Amazon PPC Advertising Mastery,1,0,0,0,49,50
"Certified Noonas Podcast - kdrama, kpop, and more",0,0,0,1,0,1
Mad Dog Recovery AA Speakers,0,0,0,1,6,7
Reverberate,0,0,2,1,6,9
The Research Her,0,0,0,0,75,75
Drilled,7,9,9,7,196,228
OT 4 Lyfe,0,0,0,0,15,15
Basic Folk,0,0,0,0,12,12
Drum History,0,0,0,0,22,22
The Sourdough Podcast,0,2,2,1,34,39
Ground Control - The Official Podcast of the Winnipeg Jets,0,0,0,1,0,1
Imagined Life,4,1,5,1,39,50
Timestorm,0,0,0,0,23,23
So You Think You're Intuitive Podcast,3,3,1,2,283,292
The Political Orphanage,4,1,1,2,160,168
Trail Running Women,0,0,0,1,30,31
Rap Radar,1,1,0,0,1,3
Keep Calm and Cook On with Julia Turshen,0,0,1,0,49,50
The MCAT CARS Podcast,0,0,0,0,3,3
Children's Stories Read By Moe Train,1,1,0,0,0,2
How To Own The Room,0,0,0,0,3,3
Eat Capture Share - a podcast for food bloggers,0,0,0,0,7,7
Field Gulls: for Seattle Seahawks fans,3,0,0,0,22,25
#MOMTRUTHS with Cat & Nat,10,3,2,3,182,200
Architecture Academy,0,0,0,0,1,1
Rumors of Grace with Bob Hutchins,0,0,0,0,9,9
Vega: A Sci-Fi Adventure Podcast!,5,1,1,3,40,50
The MIT Press Podcast,0,0,0,0,1,1
Bulldog Mindset Podcast,0,0,1,0,2,3
My Best Vintage Life Podcast,1,0,0,0,20,21
Design Your Dream Life With Natalie Bacon,2,0,2,0,46,50
All In,3,4,4,6,483,500
We're Alive - Archive,4,0,0,1,6,11
The 500 with Josh Adam Meyers,12,2,8,3,263,288
Prognosis: Coronavirus,12,14,24,13,39,102
Women in Data Science,0,0,1,0,4,5
Radio Ananda con Ricardo Ponce,1,0,0,0,3,4
Forever Ago,5,0,2,8,34,49
The Agenda,0,0,0,0,1,1
Fresh Scoop,0,0,0,0,2,2
Murder Book,20,24,22,36,398,500
Cryptid Campfire,1,2,1,2,10,16
BloombergQuint All You Need To Know,1,1,0,0,6,8
The Better Question,0,0,0,0,1,1
Today in Focus,0,0,0,0,9,9
Confessions Of A Crappy Christian Podcast,10,2,3,4,274,293
The Angel of Vine,0,0,3,2,45,50
Fated Mates - A Romance Novel Podcast,0,0,1,2,72,75
JaM Session,0,0,1,2,49,52
Hollywood Raw Podcast,3,2,0,0,45,50
The Sex Ed,0,0,1,0,49,50
BYU Men's Basketball,0,0,0,0,2,2
Chymamusique's Podcast,0,0,0,0,2,2
Learning The Tropes: A Podcast for Romance Novel Veterans and Virgins,0,0,1,0,73,74
Extra Time,0,0,0,2,46,48
Building Utopia: Bhagwan Shree Rajneesh,0,0,0,1,27,28
Whiskey Ginger w/ Andrew Santino,4,1,1,2,42,50
Beyond The Mask: Innovation & Opportunities For CRNAs,0,0,0,0,8,8
The MAJic Hour,0,0,0,0,120,120
Ashlee Off-Air,0,0,0,0,1,1
DianaUribe.fm,0,0,0,0,50,50
The Change Healthcare Podcast,0,0,0,0,1,1
Childish,3,1,1,2,43,50
LIMBO,0,2,1,0,8,11
Intermittent Fasting Stories,3,3,4,2,38,50
The Theatre Podcast with Alan Seales,0,0,0,1,7,8
Ayn Rand Institute Live!,0,1,0,0,12,13
Janus Descending,3,5,4,3,27,42
Nox Bedtime Stories,0,0,0,0,50,50
Oh K Drama,0,0,0,0,3,3
Unapologetically Sensitive,1,0,1,1,47,50
Garage Heroes In Training,1,0,0,0,10,11
Front Row Material with Jerry Lynn & Mikey Whipwreck,2,1,0,0,37,40
Staggars & Jags,0,0,0,0,12,12
American Comedy Horror Story,0,0,0,0,4,4
Heston's Journey to the Centre of Food,0,0,0,1,2,3
The Plain People's Podcast,7,3,1,9,30,50
Financial Decoder,0,2,0,1,15,18
Curious Neuron,0,0,0,0,7,7
Dan Lok Show,2,1,0,2,95,100
Real Life Ghost Stories,0,0,1,0,49,50
4 Eyes Academia,0,0,0,0,1,1
The Integrated Schools Podcast,1,0,0,3,27,31
RUDIS Wrestling Podcast,0,0,2,2,15,19
Reinforced Running Podcast,0,0,0,0,18,18
The Wooden Teeth Show,0,0,0,0,7,7
Marx Madness,2,0,1,5,41,49
"Witch, Yes!",0,0,1,0,119,120
Kou Sopheap's Podcast,0,0,0,0,2,2
The Bible Recap,3,0,0,0,276,279
Stuff We've Seen with Jim and Teal,0,0,0,0,2,2
Space Junk,0,1,0,0,5,6
Cultish,65,15,26,22,177,305
Sleep Tight Stories - Bedtime Stories for Kids,4,1,2,5,38,50
The Declutter Hub Podcast,0,0,0,0,9,9
Shadows at the Door: The Podcast,0,0,2,1,47,50
Black Flame Immersion: The Diabolist ™,0,0,0,0,8,8
Nos Reiremos de Esto!,1,0,0,0,49,50
40 and 20: the WatchClicker Podcast,0,1,2,2,15,20
The London Necropolis Railway,0,0,1,4,39,44
Undefended Dharma with Mary Stancavage,0,0,0,0,2,2
The Glossy Beauty Podcast,0,1,0,1,4,6
The Bid,1,2,0,0,7,10
Psych With Mike,0,0,0,0,33,33
The Joe Rogan Experience Experience,29,1,1,0,19,50
Rock's Backpages,0,0,0,1,7,8
The Hockey Think Tank Podcast,0,0,1,0,41,42
Signal To Noise Podcast,0,0,0,0,3,3
Assassinations,15,6,5,7,17,50
High School Hoops ( Coaching High School Basketball),0,0,1,0,49,50
Food For Thought,0,0,0,0,43,43
Your PUSH Coach,0,0,0,0,50,50
The First Mrs. Claus,6,0,0,4,35,45
Hellitalk,0,1,2,2,43,48
this is not a podcast the podcast,0,0,0,1,49,50
Hello Seven Podcast,0,1,0,0,60,61
Fundraising HayDay,0,0,0,0,7,7
SciShow Tangents,1,1,2,13,235,252
The Underdog,0,0,0,1,8,9
The Underdog Sports NFL Show,1,0,0,0,2,3
Dark Future Dice | A Cyberpunk 2020 Podcast,0,0,0,1,49,50
The Moving Screen,2,2,1,1,85,91
Spooky Troop: A Very Scary Christmas,5,2,2,1,15,25
Lactation Business Coaching with Annie and Leah,0,0,0,0,27,27
The Alpha Male Coach Podcast,0,0,0,0,50,50
American Hysteria,73,29,37,27,237,403
The Session,0,0,1,1,7,9
We've Got Nothing Better To Do,0,0,0,0,2,2
"Trail Tales - Thru-Hiking, Backpacking, and Peak-Bagging",0,1,1,5,89,96
Beauty Business Babes,24,4,1,0,118,147
Bikes or Death Podcast,1,3,0,5,78,87
Travel Genius,6,2,3,1,27,39
Hammer Dahn,2,0,1,1,46,50
Work for Change Podcast,0,0,1,0,49,50
The Numberphile Podcast,0,0,0,2,43,45
The Six Disappearances of Ella McCray,0,3,2,1,7,13
Actor Aesthetic,0,0,0,1,44,45
Cash Considerations: A Chicago Bulls Pod,1,1,3,3,10,18
Thumb Cramps,0,0,0,1,16,17
Pod Goes Punk,2,0,0,1,47,50
Changing Minds with Owen Fitzpatrick,1,0,0,1,12,14
Buddhism for Everyone with JoAnn Fox,0,0,0,0,22,22
The Mind Online,0,0,0,0,1,1
Low Carb MD Podcast,3,1,5,2,39,50
The Rock & Roll History Show,0,0,0,0,1,1
Chatty Broads with Bekah and Jess,1,1,1,0,47,50
Into Africa,1,1,0,0,12,14
Awaken Your Inner Witch,0,1,0,1,36,38
Locked On Hawkeyes - Daily Podcast On Iowa Hawkeyes Football & Basketball,1,1,2,2,17,23
Cold,2,2,6,4,176,190
The KICK-ASS Stepmom Podcast,0,0,1,1,48,50
Straight White American Jesus,0,1,0,2,47,50
Tore Says Show,6,1,0,2,41,50
Sometimes Dead is Better,0,0,0,2,18,20
Ask NT Wright Anything,3,0,0,2,80,85
Meteor City,1,3,4,6,16,30
Real Moms of Bravo,4,2,1,4,75,86
Good Heavens!  The Human Side of Astronomy,0,0,0,0,5,5
CYBER,17,3,13,6,30,69
Quillette Podcast,4,5,4,4,20,37
Reading Teachers Lounge,0,1,0,0,19,20
The Orthobullets Podcast,0,0,1,2,16,19
Everyday Espionage Podcast,1,1,0,1,35,38
Raider Cody Podcast - Las Vegas Raiders Fan Show,7,1,0,1,57,66
Chasing Your Best | GOLF SHOW,0,0,0,0,16,16
When We Talk About Animals,0,0,0,0,8,8
Schnitt Talk,120,22,20,9,329,500
The Art of Sales with Art Sobczak,0,0,1,0,35,36
Sew & Tell,2,2,1,1,19,25
The Better Behavior Show with Dr. Nicole Beurkens,0,0,0,0,27,27
Family Secrets,49,45,66,40,200,400
Demystifying College Admissions,0,0,0,1,10,11
"Salam, Girl!",1,1,0,2,112,116
This is the Gospel Podcast,0,0,2,4,494,500
Solar Maverick Podcast,1,0,2,0,8,11
Slightly Foxed,0,0,1,0,18,19
Chasing Kangaroos - For international rugby league fans,0,0,0,0,1,1
ALLD20,1,0,0,1,37,39
Watch If You Dare,1,0,0,2,410,413
Rainmaker Fundraising Podcast,0,0,0,0,10,10
From Betrayal To Breakthrough,0,0,1,1,31,33
Oeuvre Busters,1,0,0,0,17,18
BEHIND THE SCENES,71,26,32,24,347,500
Heart of the Home,1,0,1,0,31,33
The Prickwillow Papers,0,0,0,2,6,8
Capability Amplifier,0,0,0,0,21,21
The Opus,4,1,1,1,19,26
The Story Corner with Bear,0,0,0,0,7,7
David Harvey's Anti-Capitalist Chronicles,0,0,0,0,13,13
The Ginsburg Tapes,1,0,0,0,14,15
The Truth About Vintage Amps with Skip Simmons,0,0,1,0,91,92
Cafe Binge,1,0,0,0,44,45
What’s On Disney Plus Podcast,1,0,0,1,5,7
#NoFilter With Zack Peter,2,0,1,1,48,52
Your Money's Worth,1,4,3,1,20,29
Bleav presents On The List with Brett Gursky,0,0,0,0,2,2
Impaulsive with Logan Paul,8,1,2,1,37,49
Natchez Glen House Stories,0,2,0,1,26,29
The No Name RC Podcast,0,0,0,0,9,9
Berning In Hell,14,0,0,2,34,50
Everything Under The Sun,0,0,0,0,2,2
Amazin' Mets Alumni Podcast with Jay Horwitz,0,0,0,1,4,5
All Eyes On Fishing's Podcast,0,0,0,0,8,8
NORA,0,0,0,1,9,10
Get Offset,0,1,1,2,30,34
4 Things with Amy Brown,1,0,0,1,48,50
Marketing Trends,2,1,0,0,27,30
Prime Time with Ravish,1,0,0,0,12,13
Beatles City,0,0,0,0,7,7
The Fourth Ambit,0,0,0,0,9,9
Aria Code,2,2,2,6,320,332
Peace Of Mind with Bhi Bhiman,1,0,0,1,35,37
The All American After Show Podcast,0,0,1,0,4,5
Mike Giant Podcast,0,0,0,0,12,12
Drifting,0,1,0,2,28,31
Steel Magnolias - Uplifting Conversations About Life in the South,0,1,1,0,70,72
School Colors,0,0,0,0,50,50
Sports Card Nation,1,2,0,1,20,24
Three Rivers Land Trust Campfire Conversations,0,0,0,0,13,13
Mythology,3,0,4,3,40,50
Off Menu with Ed Gamble and James Acaster,12,4,20,6,186,228
The SURVIVAL SHOW,1,0,0,1,26,28
Sector 0,0,0,0,0,2,2
The Microbiome Report,0,0,0,0,13,13
FromThe108: White Sox for the Inebriated,1,0,0,0,22,23
The Habershow: Tom Haberstroh’s NBA Podcast,2,2,0,1,25,30
Slop City,0,1,0,0,49,50
Queers Next Door,0,0,0,0,11,11
Parenting Autism,0,0,0,0,16,16
Strong Songs,1,0,0,1,259,261
Green Architects' Lounge,0,0,0,0,5,5
Pretending to be People,0,0,3,0,47,50
CONFLICTED,1,3,0,0,12,16
THE INTELLECTUAL DARK WEB PODCAST (HOBBES + LOCKE + ROUSSEAU + US CONSTITUTION in ONE BOOK for 29$),2,1,2,1,1,7
90 Day Fiance Trash Talk,23,9,7,4,282,325
Power Hour,1,0,0,0,129,130
True Crime Bullsh**,43,21,45,55,336,500
The Veil Audio Drama,9,3,4,4,32,52
ADHD for Smart Ass Women with Tracy Otsuka,0,0,0,0,50,50
The Art School Podcast,0,0,0,1,31,32
The Crypto Chick with Rachel Wolfson,0,0,0,0,1,1
Believe: Paranormal & UFO Podcast,1,0,0,0,15,16
Obgyno Wino Podcast,0,0,0,1,22,23
10 Things That Scare Me,8,1,1,3,72,85
Into the Ether,0,0,0,0,9,9
Could It Be Oak Island Podcast,4,1,0,1,37,43
Wild Health Podcast,0,0,1,1,48,50
Therapy as a Christian,0,0,0,0,24,24
Learn Spanish Con Salsa | Weekly conversations and Spanish lessons with Latin music,0,1,1,0,13,15
Opinionated History of Mathematics,0,0,0,0,1,1
Lab Coat Agents Podcast,0,0,0,0,24,24
Nightgeist,0,0,0,0,37,37
B For Better Health,0,0,0,0,35,35
BBC Earth Podcast,0,0,0,1,17,18
The Healing Trauma Podcast,1,0,1,0,41,43
The Morning Brew Christian Podcast - On iHeartRadio,1,0,0,0,1,2
EmpowerHER,0,0,0,0,50,50
Ask Mr. Wonderful,1,0,0,0,28,29
The Lovecraft Investigations,3,0,1,5,41,50
The Art of Photography :: Off Camera,0,1,0,0,7,8
The Market Huddle,2,0,0,0,35,37
Champion Puppy Training Podcast,2,0,1,1,40,44
Not Skinny But Not Fat,44,7,7,7,376,441
Seltzer Squad - Staying Sober In The City,0,1,0,0,49,50
Craft Cook Read Repeat,1,0,0,0,5,6
Awkward Silences,0,0,0,0,7,7
Northwest Nature Matters Podcast,0,0,0,0,9,9
The James Smith Podcast,7,2,1,6,484,500
MTB Fitness - Mountain Biking Podcast,0,0,1,0,4,5
Sentimental Garbage,0,0,0,1,62,63
Relationship & Marriage Advice Podcast,0,0,0,0,20,20
The Caped Wonder Superman Podcast,0,0,0,0,11,11
Hypnosis for Sleeping Deeply,2,0,0,0,1,3
An Amber a Day: The Functional Nutrition Podcast,0,0,0,0,3,3
FIREBALL with Ashleigh Mayfield,2,0,0,0,48,50
The INFJ Whisperer,0,0,0,0,8,8
long range shooting and custom rifle building podcast,0,3,1,0,10,14
Post Reports,12,3,3,8,24,50
Giuseppe Ottaviani Podcast,0,0,0,0,3,3
Desire Made Real: A Discovery of Witches Podcast,0,0,0,0,1,1
The Big One: Your Survival Guide,19,16,14,6,80,135
UI/UX Design Tips,1,0,0,0,0,1
The Leah Remini: Scientology and the Aftermath Podcast,5,0,0,0,6,11
A Torah State Of Mind,0,0,0,0,1,1
Queen of S-Mountain,0,0,0,0,28,28
College Tennis Talk,0,0,0,0,2,2
Podcast Secrets of the Pharaohs - a Peep Show podcast,0,0,1,1,21,23
Precision Medicine Podcast,0,0,0,2,2,4
SNR Drive with Matt & Dale (Pittsburgh Steelers),1,4,0,1,15,21
"Be you, Unapologetically.",0,0,0,1,64,65
Stars Atmosphere,0,0,0,0,3,3
The Sweaty Startup,1,0,1,0,48,50
Austin Idol World Wide!,0,0,0,0,3,3
Over the Cap Podcast,2,0,0,0,6,8
The Ultimate Deck Podcast,0,0,0,0,3,3
Intuitive Awakening,0,0,0,0,16,16
Loose Units: The Podcast,16,4,6,4,65,95
The Leighton Smith Podcast,2,0,0,1,19,22
Sound By Nature,3,0,1,1,24,29
Feel Good Running | For the Everyday Runner!,0,0,0,0,12,12
Affirmations by A.,0,0,0,1,9,10
The Emerging Cricket Podcast,0,0,0,0,1,1
Face the Truth,0,2,1,0,10,13
The Science of Getting Rich Podcast with Gerald Peters,0,0,0,0,21,21
The Love Hour,0,0,0,3,47,50
WHOOP Podcast,4,4,1,4,29,42
Inspirational Women,0,0,0,0,1,1
Weight Loss For Nurse Practitioners,0,0,0,0,18,18
Train Your Own Horse with Stacy Westfall,0,0,0,2,30,32
Southern Disgrace,6,1,1,3,36,47
Resources Radio,0,0,0,0,2,2
A Conversation With...,0,2,1,1,51,55
Adventures in Jewish Studies Podcast,0,0,0,0,5,5
MPR News with Angela Davis,1,0,0,0,2,3
Voices of Misery Podcast,3,0,0,0,304,307
The Habit Coach with Ashdin Doctor,0,0,0,2,9,11
Fantasy NASCAR Podcast,0,0,0,0,16,16
The Narrow Caves,9,6,3,2,23,43
Standard Docking Procedure,0,0,2,0,5,7
"Life, Death and the Space Between",1,2,0,1,72,76
Nationals Talk,0,4,0,3,30,37
The Astrology Hub Podcast,5,2,11,20,186,224
Hot Marriage. Cool Parents.,1,2,1,0,46,50
Disc Golf Discussion,1,0,0,0,3,4
The Zookeeper's Voice,0,0,0,0,2,2
Zombie Diaries,2,0,0,2,1,5
Daily Rosary Meditations,1,0,0,5,29,35
Pitchfork Economics with Nick Hanauer,2,2,0,0,46,50
"VoxCast: The Official Warhammer 40,000 Podcast",0,0,5,2,3,10
The Blossoming Moms Show,0,0,0,1,42,43
Medical Mnemonist (from MedSchoolCoach),0,0,0,0,11,11
Hoopin with Hoops:  The College Basketball Betting Show,3,6,4,0,50,63
Mahabharat Hindi Podcast,0,0,0,0,4,4
Woolie Will Figure It Out,1,0,0,1,34,36
"Beach Too Sandy, Water Too Wet",1,0,1,1,47,50
A Way Out - AA Speaker Meeting,0,0,1,0,8,9
Phil in the Blanks,77,24,34,43,322,500
The Fighting Entrepreneur,2,1,0,7,140,150
Era Uma Vez Um Podcast,0,0,0,0,5,5
Sarah's Bookshelves Live,3,1,4,3,116,127
The French History Podcast,7,1,2,2,28,40
The Clinical Problem Solvers,0,1,2,0,30,33
The Hot Zone with Chuck Holton,0,0,0,0,6,6
Round the Cauldron,1,0,0,1,5,7
Posted Up with Chris Haynes,1,0,1,0,22,24
The Clinical Consult,0,0,0,0,5,5
The Feminist Frame,0,0,0,0,1,1
Buzzcast,0,0,0,0,35,35
NOUS,0,0,0,0,2,2
Cultra Trail Running,0,0,0,0,44,44
House Guest by Country & Town House | Interior Designer Interviews,0,0,0,0,2,2
Student Loan Planner,0,1,0,0,20,21
Donald J Trump Podcast,30,0,0,0,20,50
South Texas Gardening with Bob Webster,0,0,0,0,4,4
"Spill The OT: Real Talk Occupational Therapy, Physical Therapy, and Speech Language Pathology",0,0,1,1,44,46
Bossy Bruja Podcast,0,0,0,0,18,18
Parsha in Progress,0,0,0,0,15,15
Ages of Conquest: a Kings and Generals Podcast,0,0,2,2,27,31
Here's The Thing,0,0,0,0,50,50
Candlestick Chronicles: A 49ers Pod,2,2,4,1,30,39
Podcast About List,2,0,0,0,48,50
Genetics Unzipped,0,0,0,1,4,5
Dynasty Rook Fantasy Football Podcast,0,0,0,0,17,17
Backcountry Rookies - Big Game Hunting Podcast,2,0,0,1,39,42
Prepping 2.0,17,13,12,3,32,77
Oz 9,0,1,2,1,44,48
The Mitzvah Podcast - With Rabbi Yaakov Wolbe,0,0,0,0,3,3
I Have ADHD Podcast,1,1,1,2,45,50
Drag Her! A RuPaul's Drag Race Podcast,48,34,23,22,373,500
The Sub-Beacon Podcast,9,5,3,11,328,356
Happy Homebirth,0,1,0,0,49,50
Hallmark Channels’ Bubbly Sesh,10,3,4,5,143,165
WellsCast,89,40,35,24,246,434
Well Well Villanelle: A Killing Eve Podcast,0,1,1,2,38,42
Relaxation Hypnosis for Stress & Anxiety,2,1,0,0,1,4
We're Not Weighting's podcast,0,0,0,0,21,21
Making Math Moments That Matter,0,0,1,0,49,50
In It: Raising Kids Who Learn and Think Differently,0,0,0,2,25,27
Sleep sounds by nature,0,2,0,0,4,6
Allow Us to Rethriftroduce Ourselves,0,1,1,0,36,38
Wellfed Creative Podcast,0,0,0,0,9,9
Understanding Your Enneagram,1,0,0,1,13,15
ToKCast,0,0,0,0,2,2
Fnaf vs. Fortnite,9,1,2,6,15,33
Life in the Fasting Lane,1,0,2,2,11,16
Body Positive Health and Fitness,0,0,0,0,19,19
Team TaylorMade Podcast,0,0,0,0,20,20
The Alpha Girl Confidence Podcast,0,0,0,0,14,14
Six Miles To Supper,3,0,0,0,15,18
Global Caveat,0,0,0,0,5,5
Trashy Divorces,4,2,2,4,38,50
Nutrition Rounds Podcast,5,2,0,1,42,50
First Year Married,1,0,0,0,28,29
The Concept2 Workout Podcast,0,0,0,1,22,23
Something Was Wrong,72,67,64,48,247,498
Scary Stories,0,0,0,2,32,34
Creation Science Podcast - Ultimate Homeschool Radio Network,0,0,0,0,2,2
The Rachel Cruze Show,3,3,1,2,41,50
JAAOS Unplugged,0,0,0,0,7,7
Creative Queso Podcast,0,0,0,0,13,13
So Dead,3,5,4,1,113,126
Second City Hockey: for Chicago Blackhawks fans,4,2,1,0,1,8
Well Far: The Running Podcast,0,0,0,0,7,7
Kap Slap Mixes,0,0,0,0,8,8
Birgit O'Connor and The World of Watercolor Painting,0,0,0,0,2,2
Brother Ben X Podcast,0,0,0,0,12,12
InGoal Radio Podcast,0,0,0,1,14,15
High and Wide Radio | Philadelphia Flyers Podcast,0,0,0,0,6,6
All About Pregnancy & Birth,0,0,0,0,50,50
The Weekly Scraps Podcast,1,0,2,1,25,29
Storytime Anytime,0,0,0,0,4,4
Blackout,1,3,1,4,41,50
SIBO Made Simple,0,0,0,0,50,50
The Connected Life,0,0,0,0,50,50
The Stylish Bride,0,0,0,0,2,2
Creativity School,0,0,1,0,39,40
The Hurricane Tapes,0,0,0,0,21,21
King and the Sting,7,1,1,5,35,49
The Nicole Walters Podcast,0,0,0,1,149,150
The Bulwark Podcast,41,15,19,33,387,495
The Six Figure Esthetician Show,0,0,0,2,3,5
Flight Risk: A Star Wars Actual Play Crime Dramedy,0,0,0,1,3,4
COURAGEOUS PARENTING,5,3,2,6,324,340
The Construction Management Podcast,0,0,0,2,36,38
Podcast Pray as you go,1,1,4,5,38,49
Sussex Squad Podcast,8,2,1,4,49,64
"Wollinspirationen - DER Podcast zum Stricken, Spinnen, Häkeln und anderen Faserkünsten",0,0,0,0,1,1
Hiking Thru,1,2,2,3,21,29
The Dive Down,0,0,0,0,50,50
Spirit School,0,0,0,0,23,23
Dearly Departed Podcast,2,0,1,2,112,117
Millionaire Muslim,0,0,0,0,1,1
House of Jordans - Sports Card Podcast,0,0,0,1,49,50
The Gayly Prophet | A Harry Potter Podcast,0,0,0,0,123,123
Cultivating H.E.R. Space: Uplifting Conversations for the Black Woman,1,1,0,2,46,50
The Parenting Junkie Show,1,0,1,1,47,50
Millionaire Mindsets,2,1,3,8,76,90
Muscles and Management,0,1,0,0,38,39
Mindful Muslimah Speaks,0,0,0,1,49,50
Educational Duct Tape,0,0,0,0,49,49
Wives of Jannah: Islamic Relationship Advice,0,0,0,0,9,9
Ramblin' Radio,0,0,0,0,144,144
Black Equity Podcast,0,0,1,0,9,10
Over My Dead Body,88,55,69,54,234,500
Think Positive: Daily Affirmations,2,0,1,1,23,27
Stephen Scullion's Road to Tokyo 2020,0,0,0,0,11,11
Dan Jones Hypnosis Sleep Stories,2,0,0,1,9,12
Audible Anarchism,0,0,0,0,3,3
Enneagram & Coffee,2,4,3,1,40,50
Nutrition Made Easy,0,0,0,0,4,4
200 Miles Before Breakfast,1,0,1,0,2,4
The Sal Vetri Show - Fantasy Sports & Sports Betting,2,0,0,1,497,500
Contra*,0,0,0,0,2,2
Sex Stories,6,1,1,2,40,50
The Mystic Rebel Podcast,0,0,0,0,42,42
The Jeff Does Vegas Podcast,0,0,0,1,8,9
Life After PTSD: A Podcast About Healing From Trauma,1,0,0,0,6,7
Curioscity,0,0,0,0,12,12
The Medieval Podcast,2,1,0,2,16,21
Let’s Talk Dubs,0,0,0,0,50,50
Morally Grey: A Podcast on the Lore of Warcraft,2,0,0,1,47,50
Bad Examples w/ Tracy DiMarco & Jessica Romano,32,7,11,12,382,444
Going West: True Crime,18,15,13,25,429,500
Riki Rachtman's Cathouse Hollywood Podcast,1,1,3,3,42,50
The Left of Greg Podcast,0,0,0,0,7,7
Affiliate Marketing & Side Hustles on the Doug.Show,0,0,0,0,18,18
Thrive Podcast #forflorists,0,0,0,0,27,27
Manifest Daily,0,0,0,1,22,23
Easy Stories in English,1,0,0,0,2,3
Kalaf,1,0,2,0,16,19
Go To There: A 30 Rock Podcast,0,1,2,0,3,6
The Viall Files,116,36,51,52,245,500
Muscle Intelligence,3,0,2,3,42,50
The Ninja Selling Podcast,0,0,0,0,47,47
AcaDames,0,0,0,0,5,5
Dynasty Command Center Podcast,5,0,4,3,64,76
Come Follow Me for Us podcast,3,2,2,4,489,500
Necronomipod,21,9,10,8,413,461
Evan and Katelyn Podcast,1,0,0,0,49,50
The Baton: A John Williams Musical Journey,0,1,0,2,21,24
Baltimore Sun,0,0,0,0,3,3
Witches of the City,0,0,0,0,2,2
Pizza City with Steve Dolinsky,0,0,0,0,6,6
Black Girls Heal,1,3,5,2,39,50
Orgasmic Enlightenment,19,4,2,1,24,50
Ajahn Sona,0,0,0,0,1,1
SonicScoop Podcast,0,0,0,0,31,31
Self Care IRL,1,0,0,1,48,50
Autoflower Podcast,0,0,0,0,13,13
Find The Magic,0,0,1,2,47,50
ARCS,1,0,1,0,48,50
Masala Jones,0,1,1,1,47,50
Cushman & Wakefield's Greater LA Podcast,0,0,0,0,2,2
Cybernautica,1,1,1,3,3,9
Tru Heel Heat,0,0,0,0,2,2
Mavs Step Back Podcast,2,1,1,2,52,58
The Critter Shed,0,0,0,0,3,3
Late Night Riders,0,0,0,0,3,3
IlmFeed Podcast,0,0,0,0,5,5
Saint Stories for Kids,0,1,1,1,47,50
Positive Regression: A Motorsports Analytics Podcast,1,0,0,0,32,33
Talking Precision Medicine,0,0,0,0,1,1
The Dog Walk,3,1,2,0,196,202
Scottish Watches,1,0,1,0,32,34
The Exorcisters Podcast,0,0,0,0,13,13
The Ryan Knorr Podcast,0,0,0,1,11,12
Zerodha Educate,0,0,1,0,3,4
Shout It Out Loudcast,0,0,2,0,36,38
Captains Collective Fishing Podcast,0,0,0,0,32,32
Ain't No Seats,6,0,1,0,57,64
DRaysBay: for Tampa Bay Rays fans,0,0,0,0,4,4
The Hidden People,5,5,5,9,26,50
Fine Blue Line Podcast | Law Enforcement,0,0,0,0,7,7
School of Inspiration,0,0,0,0,16,16
Real Estate & Financial Independence Podcast,0,0,1,0,49,50
Up2,0,0,0,0,13,13
Spot On!,0,0,0,0,16,16
The Freemasons Podcast,2,0,1,0,55,58
Seattle Real Estate Podcast,0,0,1,0,7,8
CelticsBlog: for Boston Celtics fans,0,0,2,1,15,18
Evolve With Emily,3,0,0,0,47,50
Speaking of Racism,2,0,0,0,25,27
BJJ Mental Models,0,0,0,2,9,11
The Phillip Scott Audio Experience,1,0,0,0,18,19
You Betcha Radio,0,1,1,1,47,50
Bare Marriage,1,2,4,2,39,48
Snoozecast,1,0,2,7,40,50
Afrobeats Update (Monthly Mixes),0,0,0,0,1,1
Secrets of Technology,0,0,0,1,6,7
Rock N Roll Archaeology,0,1,0,0,22,23
The Nick Zentner Geology Podcast,1,0,0,2,82,85
Nite Shift Video,0,0,0,0,8,8
Pleasant Ridge Today,0,0,0,0,1,1
MCAT Basics (from MedSchoolCoach),1,0,0,2,41,44
Ratchet & Respectable,6,2,5,6,401,420
Dear Anxiety,0,0,1,2,24,27
Horror Queers,2,0,0,2,81,85
The Byron York Show,4,0,1,1,44,50
Mobituaries with Mo Rocca,0,0,1,2,47,50
"Mental Health Download: Exploring Mental Illness, Suicide, Homelessness and Incarceration",0,0,0,0,6,6
Organizing Work,0,0,0,0,2,2
The Fully Charged PLUS Podcast,3,3,0,0,28,34
Voyage to the Stars,0,1,0,1,48,50
The Editing Podcast,0,0,0,0,10,10
Energy Healing,0,0,0,0,7,7
Emotions Mentor podcast,0,3,0,0,47,50
Extraterrestrial,57,18,19,10,84,188
Wrestling Is Gross,0,0,0,0,6,6
Food Matters Podcast,0,0,0,1,49,50
The Jeremy Brett Sherlock Holmes Podcast,0,1,0,0,37,38
DarrenDaily On-Demand,0,0,0,1,199,200
Disneyland For Designers,0,0,0,0,42,42
Western Hunter,0,0,0,0,18,18
Hotboxin With Mike Tyson,53,13,18,19,392,495
Weight Solutions for Physicians,0,0,0,0,16,16
The Self Love Fix,0,1,5,7,304,317
Mom Worthy,0,0,0,0,50,50
Talkin’ Giants (Giants Podcast),6,1,1,0,235,243
Fallout Lorecast,0,0,0,1,49,50
It’s A TRIBE Thing — Behind The Scenes of Successful Membership Sites,0,1,0,1,48,50
Rye Smile Films,0,0,0,0,29,29
The Lorin Krenn Podcast,0,0,0,0,6,6
Great & Terrible,0,2,0,0,17,19
Gabinete de curiosidades,0,0,0,0,6,6
Eyes For Ears,0,0,0,0,24,24
"Marginal Gains Cycling Podcast, Presented by Silca",1,0,3,0,16,20
"Unwell, a Midwestern Gothic Mystery",5,5,4,5,31,50
Film School,0,0,0,0,9,9
Tungsten Originals Podcast,0,0,0,0,16,16
They Had to Go Out,1,1,1,0,14,17
The Dropout,8,12,0,10,78,108
Richest Hill,0,1,0,0,21,22
Car Buying Podcast,0,0,0,0,11,11
The Disney Dining Show,1,0,1,3,34,39
The Game of Rassilon: A Doctor Who Roleplaying Game Podcast,0,0,0,0,3,3
P-Car Talk Podcast,2,0,1,4,43,50
As a Woman,3,0,1,1,45,50
Hormones in Harmony,0,0,0,1,16,17
BBVA Blink,0,0,0,0,1,1
Hamilton,5,1,1,0,1,8
Backstage - TV & Film,0,0,0,0,2,2
Mimosas with Moms,0,0,1,1,46,48
Brotherly Pod,0,0,1,0,6,7
The Intelligence,3,0,0,0,33,36
The OSINT Curious Project,0,0,0,0,2,2
Space4U,0,0,0,0,1,1
Cat Talk Radio,0,0,0,0,6,6
HITS K-9:  Police Dog Training for Cops by Cops,0,0,0,0,2,2
One Life One Chance with Toby Morse,0,0,0,2,48,50
Stiff Socks,1,0,1,0,48,50
Vogue Knitting Knitterviews,0,1,1,1,13,16
Rogue Theory: A New Rockstars Podcast,0,0,0,0,65,65
The Ron Burgundy Podcast,5,1,0,0,44,50
LSAT Pros,0,1,0,0,13,14
Talking Elite Fitness,2,2,2,3,41,50
Pod Yourself A Gun - A Sopranos Podcast,5,1,0,2,142,150
A Ninth World Journal,0,0,0,0,14,14
I Don't Speak German,14,2,4,2,28,50
Millionaire Car Salesman Podcast,0,0,1,0,21,22
Fall of Civilizations Podcast,3,1,5,4,132,145
The Motherly Podcast,2,2,1,1,44,50
Bash Bros Podcast,1,0,2,1,19,23
CARAVAN,2,1,2,3,42,50
Run Lift Mom,0,0,0,0,48,48
Case Closed,37,36,62,28,65,228
David Tennant Does a Podcast With…,2,1,2,3,82,90
Daily Grace,3,0,1,6,490,500
Karly and Craig,0,0,0,0,2,2
Before Breakfast,7,8,4,2,29,50
Essential Oil Solutions with doTERRA,13,2,2,1,32,50
Wheels Off with Rhett Miller,0,0,0,1,49,50
Slightly Offensive with Elijah Schaffer,5,1,1,0,493,500
The Hive Jive - Beekeeping Podcast,1,0,0,2,15,18
Odd Tonic,0,0,1,0,36,37
Teach Create Motivate Podcast: Motivational Tips & Tricks for Teachers,0,0,1,0,49,50
Chasin' The Racin',0,0,0,0,2,2
Soaring the sky a glider pilot's Podcast,0,0,1,0,7,8
The Double Shift,0,1,3,0,46,50
WITH A STRAIGHT FACE,2,0,0,0,38,40
Choralosophy,1,0,0,1,11,13
Earn Your Leisure,4,0,0,4,170,178
The Equalizer Podcast,1,3,3,3,28,38
10 Things To Tell You,2,0,1,2,103,108
"The Not So Sexy, Sexy Podcast with Liv Milano",1,0,0,0,22,23
Dlucs_ Podcast,0,0,0,0,15,15
What Day Is It?,1,1,0,0,37,39
PintheQ Podcast,0,0,0,0,3,3
Turn Two Fantasy Baseball Podcast,1,0,0,1,29,31
Dungeons and Daddies,1,0,1,0,48,50
Best to the Nest with Margery & Elizabeth,0,0,0,0,50,50
The Matt and Joe Woodworking Fun Hour,0,1,2,4,14,21
Root of Evil: The True Story of the Hodel Family and the Black Dahlia,34,27,23,27,389,500
HLTV Confirmed,0,0,0,0,3,3
Mind Over Macros,1,0,0,0,27,28
Women of the Military,0,0,0,0,14,14
The Enthusiasm Project,0,0,0,0,6,6
The Merman Podcast,0,0,0,0,3,3
The Official Scottish Rugby Podcast,1,0,0,0,0,1
Spooky,3,0,0,0,21,24
LSAT Unplugged + Law School Admissions Podcast,1,0,0,0,10,11
All Things Work From SHRM,0,0,0,0,7,7
The Soccer Coaching Podcast,0,0,0,0,4,4
Martha Runs the World Podcast,0,0,0,0,10,10
Stir the Plot,0,0,0,0,13,13
Chris Voss Podcast,2,0,0,0,0,2
Construction Genius,0,0,0,0,18,18
Material Matters with Grant Gibson,0,0,0,0,3,3
The Plotting Shed,0,0,0,0,1,1
AUSA's Army Matters Podcast,0,0,1,0,4,5
Transitions Daily Alcoholics Anonymous Recovery Readings Podcast,0,0,1,0,3,4
Sincerely Fortune,2,0,0,2,46,50
Deeper Dating Podcast,1,1,0,0,65,67
Raising Mums,0,0,0,1,11,12
She's So Reel,0,0,0,1,7,8
BRStv Podcasts,0,0,0,0,5,5
The Brandel Chamblee Podcast with Jaime Diaz,3,1,5,2,17,28
That Park Life Podcast,0,1,0,0,18,19
Transport Topics,1,0,0,0,1,2
"Very, Very, Quite Contrary Podcast",2,0,0,0,48,50
The ModernJeeper Show,1,2,1,0,6,10
Birth Story Podcast,0,0,1,0,42,43
Mama Said with Jamie-Lynn Sigler & Jenna Parris,8,6,4,5,27,50
Black Flagged Podcast,2,0,0,0,10,12
Rock and Roll Heaven,1,1,0,2,6,10
In a Time of Ancient Gods: The Xena Podcast,0,0,0,0,6,6
Sagittarius Eye Podcast: Elite Dangerous' leading news network,0,0,0,0,2,2
The Climate Champions,0,0,0,0,3,3
How i Died,0,1,1,2,46,50
The Rational Republican,0,0,0,0,7,7
The Hard Times Podcast,2,2,1,1,22,28
TTMCast Sports Collectibles Podcast,0,0,0,0,2,2
I Thought I Knew How: A Podcast about Knitting and Life,0,0,0,1,41,42
Monday Night Pod: Wrestling's War,0,0,0,0,13,13
Molly of Denali,2,1,0,6,41,50
New England Travel Journal Podcast,0,0,0,0,1,1
Smart Muslima,0,0,0,0,3,3
Cracks Podcast con Oso Trava,0,0,0,0,31,31
Compete Like a Champion,0,0,0,0,3,3
"Gay Therapy LA with Ken Howard, LCSW, CST",0,0,0,0,4,4
BRN Podcast: Buddhist Recovery Network,0,0,0,0,2,2
It's My Pleasure,0,0,0,0,50,50
"Tending Seeds: Adventures in Farming, Gardening, and Herbalism",0,0,0,0,16,16
SoulWords- Full Library,0,0,0,0,5,5
Let's Hear It,0,0,0,0,3,3
Trials & Trebuchets,2,0,0,0,20,22
Dare to Awaken,0,0,0,0,33,33
The Italian Football Podcast,1,1,0,0,13,15
Stewart-Haas Radio,0,1,0,0,7,8
The PowerScore LSAT PodCast,3,3,2,1,32,41
On Purpose with Jay Shetty,147,91,175,91,1897,2401
Espoilers Podcast,2,1,0,1,4,8
What Is Life?,0,0,0,0,2,2
Dames who Dish,4,1,0,0,73,78
ARRL So Now What?,0,1,2,0,7,10
Sporting Dog Talk,1,2,0,1,45,49
Scrapbook Your Way,0,0,0,0,18,18
Fatwa,0,0,1,0,2,3
Sports Psychology Podcast,0,0,0,0,2,2
Tailgate Guys BBQ Podcast,0,0,0,0,1,1
The Dirty John Podcast,1,0,1,0,0,2
Bardown Breakdown,0,0,0,0,7,7
Big Swing Podcast,0,0,2,0,234,236
Throughline,14,10,18,12,136,190
Blockbuster,6,9,5,7,266,293
SEX COMMUNICATION,0,0,0,0,9,9
A.K. 47 - Selections from the Works of Alexandra Kollontai,0,0,0,0,12,12
The Ladies Guide to Dude Cinema,0,0,0,0,15,15
Cooking with an Italian accent,0,0,0,0,16,16
Dorky Geeky Nerdy Trivia Podcast,0,0,0,0,2,2
The Flexible Dieting Lifestyle Podcast,1,0,0,0,49,50
SEN Live,9,3,2,4,482,500
Aviation LO Down,1,0,0,2,11,14
The League of Ultimate Questing,0,0,0,0,16,16
"Seven Out Gambling, Poker and Casino Podcast",0,0,0,0,50,50
1Up Podcast with Gary Williams,0,0,0,0,8,8
The Like Attracts Like Podcast,0,0,0,0,4,4
Artist/Mother Podcast,0,0,0,0,69,69
The Plant Based Podcast,0,1,0,0,2,3
Wholly Jewish,0,0,0,0,2,2
The Better Human Podcast,2,0,1,1,6,10
Indy Ball Report,0,0,0,0,2,2
Angels and Awakening,1,0,1,1,460,463
Accelerate 2 Great,0,1,0,2,197,200
Stars Like Us: Astrology with Aliza Kelly,1,0,2,1,49,53
Moms Out Loud,0,0,0,0,6,6
Pastor Robert Morris Ministries on Oneplace.com,2,1,8,8,13,32
Switch4Good,0,0,0,1,49,50
Practice You with Elena Brower,2,2,1,1,76,82
The White House Brief,6,0,1,6,209,222
The Quicky,11,2,7,10,66,96
Who the Hell is Hamish?,9,4,7,10,57,87
Sh**ged Married Annoyed,16,4,17,2,461,500
Red School Bus - Clean Comedy,0,0,0,1,49,50
"Art Juice: A podcast for artists, creatives and art lovers",0,0,1,0,65,66
Do It For the Process from Emily Jeffords,0,1,0,1,50,52
You Can Learn Chinese,0,0,0,0,28,28
Inward with Rabbi Joey Rosenfeld,0,0,0,0,10,10
Music Business Podcast,0,0,0,0,15,15
Podcast63,0,0,0,0,2,2
Two Strike Noise - A Baseball History Podcast,0,0,0,0,14,14
The Bellas Podcast,19,6,12,11,452,500
Dr. Drew After Dark,9,8,1,5,27,50
The Air Force Starts Here,0,0,0,0,3,3
Channel F,0,0,0,0,14,14
Crime Beat,3,4,2,7,148,164
Flying the Line,0,0,0,0,3,3
The Michael Scott Podcast Company - An Office Podcast,11,7,10,16,135,179
Alpha Male Strategies,1,0,1,0,20,22
Best-Self Management,0,0,0,0,36,36
Windfall,0,0,0,0,50,50
Real Life Real Crime,21,16,8,11,444,500
NOISEXTRA - The noise podcast.,0,0,0,0,13,13
Fireside Chat with Dennis Prager,7,0,1,0,42,50
Reds Alert Podcast,0,0,0,0,7,7
Two Titans And A Hunter: A Destiny 2 Podcast,0,0,0,1,12,13
Formula Girls,0,0,0,0,5,5
The All New Dennis Miller Option,5,1,1,2,41,50
Highside / Lowside: Motorcycle Podcast,1,1,1,1,46,50
Crimes of Passion,52,37,44,21,208,362
FiveOne Volleyball,0,0,0,0,3,3
Dakota Spotlight Podcast,3,1,4,2,55,65
Pretty Spiritual Podcast,0,0,0,0,33,33
Mating Matters,7,2,1,0,77,87
How to Start a Business,1,0,0,0,2,3
Pax Britannica,0,0,0,2,26,28
DevOps and Docker Talk,0,0,0,0,1,1
The Rise & Conquer Podcast,24,14,26,14,120,198
Thanks For Visiting,0,1,0,0,49,50
America First with Sebastian Gorka Podcast,15,3,3,1,28,50
The Insurance Dudes,1,0,0,0,49,50
The Full Bloom Podcast - for body-positive parenting,0,0,0,1,24,25
The Disclosure Podcast,0,0,0,0,120,120
Canine Conversations,0,0,0,0,19,19
True Crime Daily The Podcast,26,6,8,6,33,79
11Point7: The College Baseball Podcast,2,0,0,0,35,37
The Zibra Blog’s BEFORE AND AFTER Furniture Refinishing Podcast,0,1,0,0,14,15
Sweating The Small Stuff,0,0,0,0,29,29
Saucy Rockets,1,0,0,0,2,3
SLAKR Moto Radio | Motorcycle Podcast,0,0,0,0,2,2
Stuck Not Broken,1,5,2,3,21,32
Among the Stars and Bones,2,1,3,5,39,50
Becoming Great.com,0,0,0,0,5,5
Newt's World,18,5,8,16,453,500
The Band: A History,0,1,1,1,15,18
Know Your History,0,0,0,0,13,13
Buddha’s Teachings,0,0,0,0,2,2
Narcissist Apocalypse,3,0,2,3,42,50
The Cel Cast,0,0,0,0,1,1
Quilt & Tell,0,1,0,1,22,24
Hide and Seek,14,22,24,14,113,187
unFAITHFUL: redeeming infidelity,0,0,0,1,6,7
"The MapScaping Podcast - GIS, Geospatial, Remote Sensing, earth observation and digital geography",0,0,0,0,9,9
Red Menace,2,1,0,1,46,50
OMG Artistry Podcast: Social Savvy Stylist Olivia Smalley,0,0,0,1,55,56
How I Built My Business &...  l🔨,0,0,0,0,7,7
Becker’s Healthcare Podcast,0,0,1,0,3,4
Explain Like I'm 5: Bite sized answers to stuff you should know about - in a mini podcast,1,1,0,0,25,27
Crazy Money with Paul Ollinger,3,0,2,0,106,111
Eso Fue Sarcasmo con Fabian Castillo,1,0,0,0,39,40
The Movie Podcast,0,0,0,0,1,1
I'm Not Your Shrink,0,0,0,0,4,4
"Elder Scrolls Lorecast: Lore, ESO, & More",0,0,1,1,48,50
Another Name For Every Thing with Richard Rohr,3,0,3,1,179,186
Algo Diferente Ministry,0,0,0,0,1,1
A Bird Hunter’s Thoughts- Turn ‘Em Loose,0,1,1,0,4,6
Knuckleheads with Quentin Richardson & Darius Miles,4,0,2,9,207,222
The Austin Rugby Podcast,0,0,0,0,1,1
Carbon Removal Newsroom,0,0,0,0,16,16
Dope Labs,0,0,1,1,33,35
Private Practice Elevation with Daniel Fava,0,0,0,1,17,18
Kibbe on Liberty,1,0,0,1,22,24
Locked On Badgers - Daily Podcast On Wisconsin Badgers Football & Basketball,3,0,0,0,18,21
The Social Work Tutor Podcast,6,2,1,0,10,19
BirdNote Presents: Grouse,3,2,1,3,29,38
Waltrip Unfiltered,1,3,2,5,48,59
Plane Crash Podcast,7,3,3,8,101,122
Modern Architect Radio Show with Tom Dioro,0,0,0,0,2,2
Gutter Boys,0,0,0,1,6,7
Million Dollar Life Lessons,16,1,0,3,174,194
Dirty Strength Radio™,0,0,0,0,11,11
Foodie Pharmacology Podcast,0,0,0,0,10,10
Golf with Jay Delsing,0,0,0,0,2,2
Let's Talk Homeschool,0,0,0,0,5,5
Virtual Curbside,0,0,0,0,6,6
Yahoo Fantasy Baseball Podcast,3,0,4,2,3,12
Song Vs. Song,4,1,2,1,48,56
What We Wore,0,0,0,1,6,7
Rebel Report,1,0,0,0,12,13
Capitalmind Podcast,1,0,0,0,6,7
Harlem Queen,0,0,0,0,13,13
Verbal Diorama,0,0,0,0,33,33
Pod Of The Pops (The Girlband Popcast),0,0,0,0,4,4
The Farrier's Bellows,0,0,0,0,2,2
The A Show on RNC RADIO,0,0,0,0,5,5
National Parks Traveler Podcast,3,0,0,0,1,4
The Craft Room Podcast,0,0,0,0,1,1
Froggy Stories,0,0,0,0,5,5
The BossBabe Podcast,0,0,0,0,21,21
New York Red Bulls Radio Network,0,0,0,0,7,7
Recovering From Reality,4,0,1,0,45,50
Witchy Woman Podcast,1,1,0,0,21,23
SCP Archives,6,2,3,7,32,50
Mike In The Morning,0,0,1,1,5,7
Psychic Insights for the Modern World with James Van Praagh,1,0,1,0,36,38
The Trouble with Sex,0,0,0,0,10,10
Count the Dings (Official),4,2,0,3,41,50
Mystic Witch,0,1,0,2,6,9
Big Kid Problems,0,0,0,0,50,50
Serious Sellers Podcast: Learn How To Sell On Amazon,0,0,0,4,96,100
Disorderly Dogs!,0,0,0,1,27,28
Pawsome University,0,0,0,0,16,16
Off The Couch,1,0,1,0,8,10
Become Your Own Therapist,0,0,0,0,1,1
"On Friar, A San Diego Sports Wrap Podcast",1,1,2,0,5,9
The Last Bohemians,0,0,0,0,7,7
For Your Reference,1,0,0,1,178,180
The Ella Ringrose Podcast,0,0,0,0,40,40
SmoshCast,0,0,0,2,48,50
Baseball 365,1,0,1,0,17,19
The Future Of Fashion Business,1,0,0,0,2,3
The 12:37,0,2,1,1,20,24
For What It's Earth,0,0,0,0,1,1
81 All Out - A Cricket Podcast,0,0,0,0,3,3
Beekeeping at Five Apple Farm Podcast,1,0,0,0,40,41
Pri-Med Podcasts,1,2,1,1,3,8
Oblivity,0,1,0,0,10,11
Harrison's PodClass: Internal Medicine Cases and Board Prep,0,0,0,0,12,12
Adult Conversation Parenting Podcast,0,0,0,0,29,29
To Live and Die in LA,44,34,27,20,375,500
6 Degrees with Mike McKenna,0,0,0,0,28,28
Trees A Crowd,0,0,0,1,19,20
Deepak Chopra’s Infinite Potential,6,1,4,2,202,215
Love and Abuse,1,1,0,2,34,38
Poison!,0,0,0,0,10,10
Hello Monday with Jessi Hempel,5,1,1,4,117,128
Super Rugby Podcast,0,0,0,0,9,9
Don't IEP Alone.,2,0,0,1,16,19
Killer Instinct,86,71,60,30,147,394
Wilderness Podcast,0,0,0,0,7,7
SHOW CENTER The Airshow Podcast,0,0,0,0,5,5
Life Kit: Parenting,1,1,0,2,26,30
Dental A Team with Kiera Dent,0,0,0,0,29,29
The Mister(ess) of Pop Culture 🖤,1,1,0,0,1,3
K9s Talking Scents,0,0,1,0,8,9
Shweet! A Ladies Guide To Bro Culture,0,0,0,0,15,15
Elevate with Robert Glazer,0,0,0,0,50,50
Becoming Something with Jonathan Pokluda,0,1,1,4,494,500
The Official RuPaul's Drag Race Podcast,6,10,7,4,12,39
The Jim Day Podcast,0,0,0,2,303,305
Mitolife Radio,3,1,0,1,33,38
Meditation Life Skills Podcast - How To Meditate,0,0,0,0,2,2
Double Impact,0,0,0,0,30,30
Naval,0,0,1,0,2,3
Fully Free with Taylor Lee,0,0,0,0,29,29
The Acquirers Podcast,0,1,1,3,31,36
The Ministry of Motion Pictures Podcast,0,0,0,0,1,1
American Girls,2,4,1,1,42,50
Schnozzcast,0,0,0,0,1,1
Black Women Talk Work,0,0,0,0,15,15
Wealth Management Today,0,0,0,0,1,1
Easy EdTech Podcast with Monica Burns,0,0,0,5,45,50
Australian Finance Podcast,1,0,0,3,30,34
Into Final Space,0,0,0,0,3,3
Uncle Josh's True Scary Stories,0,0,1,4,33,38
Stonechats from Wildwood Curriculum,0,0,0,0,1,1
Hey! Remember the 80's?,0,0,0,0,3,3
Learned Lag,0,0,2,2,2,6
True Tales of Luxury,0,0,0,0,2,2
Books And Travel,0,0,0,0,14,14
The Minimalist Vegan Podcast,0,0,0,0,3,3
Couch Riffs,2,0,0,0,23,25
Full Disclosure with James O'Brien,13,6,13,15,52,99
Not So Wimpy Teacher Podcast,0,0,0,2,48,50
Golden Hour - Hosted by Dave Maze,0,0,1,0,22,23
Boss Maidel Podcast,0,0,0,0,17,17
All My Relations Podcast,1,0,3,0,239,243
Rocked Up,0,0,0,0,2,2
CruiseTipsTV Unplugged - Cruise Tips and More,1,0,0,1,180,182
Nite Callers Bigfoot Radio,1,0,0,1,1,3
Fly Fishing Insider Podcast,0,1,2,0,2,5
OCD RECOVERY,0,1,0,1,16,18
College to Canton,0,0,0,0,18,18
Three Chords and the Truth: The Apologetics Podcast,0,0,0,0,38,38
The Backhanders,0,0,0,0,4,4
Girls on Porn,3,4,2,6,35,50
The CharacterStrong Podcast,0,0,0,1,49,50
The Candace Owens Show,36,2,0,4,142,184
Russian For Cats,0,0,0,0,9,9
100% United - A Manchester United Podcast,0,0,0,0,11,11
Fibromyalgia Podcast,0,0,0,0,17,17
Beyond the Surface,0,0,0,0,4,4
Plowtalk,0,0,0,1,1,2
Stryd Power Podcast,0,0,0,0,3,3
High Speed Dining (+ Marijuana Ringtones) with Stoner Food Critic Joel Haas,0,0,1,0,1,2
The Cricket Podcast,0,0,0,0,1,1
The Gold Card Podcast,0,0,0,0,5,5
Protecting the Frame,0,0,0,0,9,9
Chris Simms Unbuttoned,8,4,7,9,202,230
ML Soul of Detroit,4,0,5,2,71,82
Crazy Town,0,0,0,2,24,26
Rants with Danny Shih,0,0,0,0,2,2
"DIY Money | Personal Finance, Budgeting, Debt, Savings, Investing",1,2,1,2,44,50
Of Witches and Women,0,0,0,0,7,7
Ohio Folklore,0,0,0,0,14,14
Investing with IBD,1,1,2,0,29,33
Sow The Land,0,1,0,1,26,28
Superquest Saga,0,1,0,1,48,50
The Cannon: for Columbus Blue Jackets fans,0,1,0,0,3,4
The Money Sessions,0,0,0,0,15,15
Unswtnd + Unfltrd,0,0,0,1,187,188
The Christian Health Club Podcast,0,0,0,1,49,50
Feminist Wellness,0,0,0,0,50,50
The Structural Engineering Podcast,0,0,0,0,4,4
So You Want To Be A Healthcare Executive?,0,0,1,0,7,8
Blue Collar Elk Hunting,0,0,0,0,140,140
Mormon Sex Info,0,3,0,0,8,11
6 Figure Influencer,0,0,1,2,197,200
Warden's Watch,0,0,0,0,36,36
For What It's Worth,0,0,0,0,3,3
The Mini-Break,0,0,0,1,15,16
Out To Lunch with Jay Rayner,4,2,2,4,36,48
Sports Bullies The Game,0,0,0,0,13,13
The Deca Tapes,0,0,0,0,30,30
Contagious Conversations,0,0,0,0,8,8
Union Strong - New York State AFL-CIO,0,0,0,1,3,4
FBoL : A comedy podcast about toxic people in literature,5,0,2,4,43,54
Presenting Hitchcock,0,0,0,0,6,6
Articles of Interest,1,1,0,5,193,200
The Jim Fortin Podcast,0,0,0,0,50,50
Still Lives,1,2,1,6,37,47
Unmanned Uncovered,0,0,0,0,1,1
Weather Insider,1,0,1,0,4,6
OT After Dark,0,0,0,0,4,4
Laughter Permitted with Julie Foudy,1,1,0,5,243,250
How to Buy a Home,1,1,1,2,41,46
Communal Table,2,0,0,0,12,14
What To Watch,1,0,0,0,9,10
Heal Thy Self with Dr. G,1,2,1,3,43,50
Against the Rules with Michael Lewis,28,21,20,18,372,459
TILclimate,0,0,0,0,9,9
Scary Story Podcast,4,6,5,9,152,176
The Pink Aisle: A Barbie Movie Podcast,1,0,0,0,3,4
Backcountry Hunting Podcast,4,1,1,2,92,100
The Wild with Chris Morgan,1,0,5,2,198,206
The Slutrepreneur Podcast,1,0,0,0,49,50
Get Around Me,0,0,0,0,1,1
Dear Art Producer,0,0,0,0,15,15
Think Like a Hacker with Wordfence,0,0,0,1,5,6
Locked On Tigers - Daily Podcast On The Detroit Tigers,4,1,1,4,58,68
Readastorus - Classic Children's Stories,0,0,0,0,3,3
Civics 101: New Hampshire,0,0,0,0,1,1
Michelle's Sanctuary: Bedtime Stories & Sleep Meditations,0,0,0,0,3,3
SWOON: Love Lessons with Julie and Gina,0,0,0,1,42,43
Jensen and Holes: The Murder Squad,65,14,17,17,387,500
Get Loved Up with Koya Webb,1,0,0,0,24,25
Fiber Nation,0,0,0,0,50,50
Let's stay together: a Fruits Basket podcast,0,0,0,0,9,9
According Two,1,0,1,5,82,89
30 Animals That Made Us Smarter,0,1,1,2,50,54
James Bond & Friends,1,1,1,0,10,13
The Aaron Doughty Podcast,1,1,3,9,486,500
Hawaii's Best Vacation Travel and Business Guide to Hawaii,1,0,0,0,42,43
Thrive University,0,0,0,0,49,49
The Road to Self Love,0,0,1,1,48,50
Sage Parnassus,0,0,0,0,12,12
The Cosmic Savannah,0,0,0,0,2,2
The Mom Voice,2,0,1,0,47,50
Estate Planning Strategies,0,0,1,0,1,2
Shamangelic Healing Podcast with Anahata Ananda,0,0,0,1,45,46
The Secret Life of Dietitians,0,0,0,0,2,2
Roxy Talks Manifestation Podcast,1,0,0,0,12,13
X-2 Drop: A Yu-Gi-Oh! Discussion PODCAST,1,0,0,1,4,6
Squawk Box Europe Express,1,0,0,0,2,3
Sales Copywriting and Content Marketing Hacks Podcast with Jim Edwards,0,0,0,0,5,5
New Southern Garden,0,0,0,0,1,1
Survival,7,3,3,3,34,50
Amazon FBA Seller Round Table,0,1,0,0,17,18
Mathematical Objects,0,0,0,0,1,1
Holistic Health Radio,2,0,0,0,11,13
As For Me And My House,36,11,16,13,424,500
Locked On Giants – Daily Podcast On The San Francisco Giants,4,2,3,6,26,41
Ask The Masters Podcast,0,0,0,0,1,1
The Fasting Podcast; WOW (Wellness & Optimal Weight),1,1,0,1,8,11
The Staff & Graph Podcast,1,0,1,0,9,11
Boomer Living Senior Living Broadcast,0,0,0,0,11,11
The Organic Gardening Podcast,0,0,0,0,2,2
David Guetta,0,0,0,0,2,2
Get The Pancake: A Podcast For Volleyball Coaches,0,0,0,1,11,12
The Cannabis Investing Podcast,8,4,2,3,16,33
Grow My Salon Business Podcast,0,0,0,0,11,11
It's a Slate of Mind,0,0,0,1,9,10
Boarding Party's Pokemon DnD,1,0,1,0,6,8
Kings Pulse: A Sacramento Kings Podcast,1,0,1,0,31,33
Talking Feds,1,2,3,3,41,50
Behind The Bum,2,2,1,1,18,24
Write Your Legend,1,0,0,0,30,31
FromTheBackTees,0,0,0,0,57,57
Beginning Teacher Talk,0,0,0,0,50,50
Black Wealth Renaissance,1,0,0,3,70,74
TENDRIL: The Banshee Chronicles,0,0,0,0,30,30
NeedleDepth: Tattoo Podcast,0,0,0,0,2,2
Pursuit of Bliss,0,0,0,0,50,50
"#LikeAWoman: Mindset, Habits and Lifestyle for Women Entrepreneurs",1,0,0,1,41,43
One Rental At A Time,0,0,0,0,4,4
Seven Slot Society,0,0,0,0,30,30
"The Good, The Bad, and The Sequel",0,0,0,0,7,7
DevEd,0,0,0,0,1,1
Project Recovery,0,0,0,1,40,41
Unsolicited Advice with Ashley and Taryne,1,0,1,3,45,50
That's Hockey Talk,3,0,1,1,51,56
Hello Road,0,0,0,0,1,1
Real-Life Korean Conversations For Beginners,0,0,0,3,1,4
SpongeBob SquareCast,1,0,1,0,15,17
RV Small Talk Podcast,0,0,0,1,13,14
Wild For Life,0,0,0,0,3,3
The Kingsley Grant Show: Where Emotional Intelligence (EI/EQ) and Leadership Skills Intersect,0,0,0,0,11,11
The [P]Rehab Audio Experience,0,0,0,1,9,10
The Jay Situation,0,4,0,0,7,11
The Build Math Minds Podcast,0,0,1,0,29,30
Wax Museum: A Basketball Card Podcast,1,0,0,0,26,27
Hey Bitches,0,0,0,1,14,15
The Compound Show with Downtown Josh Brown,4,3,1,1,131,140
The Last Laugh,3,3,3,3,38,50
¡Coches Y Tacos!,0,0,0,0,3,3
The WAG Podcast,1,0,0,2,47,50
Not Overthinking,0,0,0,1,18,19
Called To Homeschool,0,0,1,0,40,41
Discovering Classical Music,0,0,0,0,2,2
The Gold Shaw Farm Podcast,0,0,0,1,36,37
The Imbalanced History of Rock and Roll,1,0,0,0,7,8
Awakening with Rabbi Ami Silver,0,0,0,0,4,4
The Food Truck Scholar,0,0,0,1,12,13
Otaku Summit,0,0,1,0,2,3
Lauren Conrad: Asking for a Friend,31,35,23,11,100,200
Locked On Indians - Daily Podcast On The Cleveland Indians,2,0,1,1,31,35
The School of Greatness Hall of Fame,0,0,0,1,49,50
Birdies Not BS. A Modern Approach To Golf,1,0,0,0,17,18
Daily Dose,5,1,2,1,5,14
Something Rhymes with Purple,0,2,11,16,174,203
Instagram Secrets,0,0,0,0,42,42
The Empath Podcast,1,0,0,0,44,45
Shake Up Learning Show,1,0,1,0,48,50
Halp's Dynasty Baseball Podcast from ImaginaryBrickWall.com,0,0,0,0,5,5
Locked On Red Sox - Daily Podcast On The Boston Red Sox,6,0,1,1,15,23
Graceful Atheist Podcast,0,0,0,0,12,12
Locked On Rangers - Daily Podcast On The Texas Rangers,8,2,0,0,14,24
The NFX Podcast,0,0,1,0,8,9
Graham Allen’s Dear America Podcast,49,4,8,11,428,500
The American English Podcast,0,0,0,0,7,7
This Is Your Brain With Dr. Phil Stieg,0,0,0,0,18,18
Locked On Astros - Daily Podcast On The Houston Astros,6,4,0,2,31,43
The Insomnia Project,0,0,0,1,1,2
Hole In None,0,0,0,0,11,11
Finance Regulation Technology,0,0,0,1,3,4
Under The Sticks Rugby,0,0,0,0,2,2
"Dave Hill: History Fluffer (with Dave Hill, Jim Biederman, Chris Gersbeck & Jodi Lennon)",0,2,0,0,25,27
Book More Clients Photography Podcast - Build a Five Figure+ Photography Business,1,0,0,0,53,54
The Biofriendly Podcast,0,0,0,0,10,10
The Braver Angels Podcast,1,3,0,1,7,12
Crime Salad Podcast,24,18,23,20,126,211
Locked On Dodgers – Daily Podcast On The Los Angeles Dodgers,7,3,6,2,109,127
Locked On Mets - Daily Podcast On The New York Mets,2,1,1,1,17,22
Moving Abroad,0,1,1,2,1,5
Become an IDOL,0,0,0,0,8,8
Fairway Tales: Stories of Women in Golf,0,0,0,0,2,2
My Mom's Basement,6,0,2,1,284,293
Expand,0,0,0,0,89,89
Academy Queens,1,1,0,2,12,16
Worst Firsts with Brittany Furlan,4,2,1,0,43,50
DISCovery with Eric Senich,0,0,0,0,11,11
Mommying While Muslim,0,0,0,0,21,21
Fifth & Mission,6,2,4,5,16,33
Encounter Party!,0,0,0,0,50,50
Health Is Hell,1,0,1,0,48,50
75 Hard Podcast,1,0,0,0,2,3
OT Potential Podcast | Occupational Therapy CEUs,0,0,0,0,8,8
Mommies Tell All,11,4,3,3,29,50
Built To Grow Fitness Business,0,0,0,0,32,32
Game Brain: A Board Game Podcast About Our Gaming Group,4,1,0,2,17,24
A Quick Timeout,0,0,0,2,72,74
Circle Sanctuary Network Podcasts,0,0,1,1,0,2
the only one in the room podcast,0,1,0,0,33,34
I Can’t Sleep Podcast,1,0,3,4,28,36
Rebel Weight Loss & Lifestyle,0,0,0,0,50,50
CINEMA JUDGE,0,0,0,0,2,2
Anti-Aging Hacks,0,0,0,0,50,50
Teaching With Jillian Starr Podcast,1,0,1,0,48,50
Plant-Based Diet,0,0,0,0,1,1
Espionage,46,2,0,0,2,50
Motherhood Sessions,3,1,3,1,42,50
Infertile AF,0,0,1,0,49,50
We Have Ways of Making You Talk,2,3,5,9,76,95
The West Wing Thing,19,3,3,8,66,99
Purple Panties,2,2,4,4,174,186
The Brown Girls Guide to Politics,10,3,1,0,64,78
Hello Movies,0,0,0,0,1,1
Locked On Phillies - Daily Podcast On The Philadelphia Phillies,3,0,2,0,7,12
KIC POD,20,8,4,4,54,90
Get Soft With Dr Snuggles,0,0,0,0,11,11
The Psilocybin Chronicles,0,0,0,0,6,6
George's Box - Yankees MLB Podcast,8,2,2,3,75,90
The SCamp Life Podcast,0,0,0,0,5,5
Cooper Stuff Podcast,0,2,2,1,190,195
Podcast But Outside,0,0,0,1,49,50
Swinging Outside the Lines,0,1,0,1,21,23
The Strong Mommas Podcast,0,0,0,0,50,50
OOMF,0,0,0,1,11,12
The Panty Selling Podcast,0,0,1,0,12,13
Elite Baseball Development Podcast,0,2,0,0,39,41
COPPERHEART: A RiggStories Audio Drama,3,1,1,0,23,28
The Bourbon Road,0,0,0,0,74,74
Fun Astrology with Thomas Miller,4,0,1,0,96,101
Independent Americans with Paul Rieckhoff,10,2,4,3,31,50
Beauty Tips and Bullsh*t,0,0,0,1,35,36
Champion's Mojo,0,0,0,0,21,21
Powerline Podcast,0,0,2,1,22,25
Life After Life Podcast - Our Soul's Experience in Life and Death,2,1,1,1,58,63
Speech Uncensored: A Speech Pathology Podcast,0,0,1,2,25,28
The John Ankerberg Show Podcast,0,0,0,0,1,1
The Drake and Jimmy Jew Show,0,0,0,1,14,15
On Deck : DFS MLB 2021 Podcast by LineStar App,0,0,0,0,12,12
Ask Aviator Livestream & Podcast,0,0,0,0,2,2
Movie Melt! Grindhouse and Exploitation Podcast,0,0,0,0,12,12
Locked On Rockies - Daily Podcast On The Colorado Rockies,1,0,0,1,5,7
A Single Serving Podcast,1,1,0,2,118,122
Bebop Banter: The Premiere Anime Podcast,0,0,0,0,2,2
UnBossed,1,2,1,1,13,18
Not Another Movie Pod,4,3,3,6,215,231
The Calligraphy Podcast,0,0,0,0,29,29
The Daily Gardener,2,0,0,0,4,6
The Gangster Chronicles,12,4,8,6,275,305
The Hall of Fame with Booker T & Brad Gilmore,2,0,0,0,18,20
The Nostalgic Front Podcast,0,0,0,0,22,22
Ad Age Marketer's Brief,0,0,0,0,2,2
Under The Shroud,0,0,0,1,42,43
Graffstars,0,0,0,0,12,12
No Planet B,0,0,1,0,4,5
LightCast,0,0,0,1,4,5
BallBlast Fantasy Football,3,1,0,1,115,120
How Do You Train That?,0,0,0,0,1,1
HandCut Radio,0,0,0,0,17,17
Enrique Santos Replay,1,0,0,0,2,3
Your 2 Dads w/ Sean & Julian,2,2,2,4,40,50
Stand-Up w/ Tom Thakkar,4,2,5,4,35,50
Whale Tales Podcast,0,2,0,0,5,7
Ad Age Ad Block,0,0,0,0,4,4
Dream Big Podcast with Bob Goff and Friends,2,0,0,1,86,89
Dance Studio 411,0,0,0,0,2,2
Dunk Tank,0,0,0,0,50,50
Middle Of Somewhere,2,2,1,0,45,50
How to Spanish Podcast,0,0,1,0,7,8
Pier 54 - A General Hospital Fan Podcast,0,0,0,0,5,5
The New Legend Podcast,0,0,0,0,6,6
Teaching Middle School ELA,1,1,0,2,46,50
Pastry Arts Podcast,0,0,0,0,3,3
Anamnesis: Medical Storytellers | from MedPage Today,0,0,0,0,3,3
NHL Draft Class,1,0,0,1,15,17
Forest 404,0,1,0,1,7,9
Bleav in Tiger Woods with Cam Rogers,0,0,1,0,1,2
Food 360 with Marc Murphy,1,1,0,3,43,48
Backyard Bounty,0,0,0,0,14,14
Crime Pays But Botany Doesn't,2,0,0,1,16,19
Decomposed with Jade Simmons,0,3,0,7,248,258
Anything Goes with Emma Chamberlain,12,6,8,12,954,992
Love Anyway,0,0,0,0,46,46
Dropping Gems with Devi Brown,0,0,0,0,50,50
The Label,0,0,0,0,17,17
Mishna Study,0,0,0,0,1,1
Chief Complaint Podcast,0,0,0,1,4,5
Pamela Des Barres' Pajama Party!,0,0,0,0,13,13
Oprah and Eckhart Tolle: A NEW EARTH,0,0,0,0,3,3
MUDA Talks,0,0,0,0,1,1
Catholic Economics,0,0,0,0,3,3
Thirty Minutes with The Perrys,2,1,0,5,452,460
The Cosmic Skeptic Podcast,0,0,0,0,84,84
Snail Trail 4x4,0,0,0,0,50,50
The Crumb - Bake from Scratch,0,2,1,1,16,20
Power Corrupts,8,10,5,4,102,129
PLANTSTRONG,5,0,0,1,44,50
Fantasy Impact Today,0,0,0,0,1,1
The GM Shuffle with Michael Lombardi and Adnan Virk,34,19,21,23,201,298
Daily Breath with Deepak Chopra,10,2,2,3,33,50
Ciao Bella,0,0,0,0,12,12
Two Jabronis With A Wrestling Podcast,2,1,0,1,17,21
Come Follow Me - Weekly,0,0,0,0,30,30
Down To Earth PCOS Nutrition Podcast,0,0,0,0,10,10
Sports Wars,32,10,19,19,170,250
Unapologetically Abundant,0,0,0,0,29,29
Thinking Crypto News & Interviews,0,0,0,0,6,6
The Atomic Library,0,0,0,0,4,4
Pods and Monsters: A Monster Movie Podcast,0,0,0,0,7,7
The Blonde Files Podcast,0,0,1,2,47,50
Let's Get It,0,0,0,0,20,20
The Real Life Caddie Podcast,0,0,0,0,49,49
Digging Deep with Robert Plant,1,0,2,1,46,50
For the Love of Dog,0,0,0,0,15,15
The Stakes,0,2,2,1,27,32
The Messy Truth - Conversations on Photography,0,0,0,0,9,9
Rock N Roll Librarian,1,2,0,2,3,8
Cosmic Body with Danielle Paige,4,0,0,0,46,50
Sales Made Simple,0,0,0,0,12,12
Halfway to Heroes - A D&D 5e Actual Play Podcast,0,0,0,1,38,39
Digital HR Leaders with David Green,0,0,0,0,7,7
The Build Guild Podcast : A Professionally Unprofessional Podcast for Makers,0,0,0,0,29,29
Hate That Podcast,0,0,0,0,17,17
Bad Bitches Losing Weight,0,1,1,0,48,50
Casey Aviation Podcast,0,0,0,0,2,2
Speak Chinese Naturally -Learn Chinese (Mandarin),0,0,0,0,4,4
For Your Reconsideration,0,0,0,0,5,5
Anime and Chill,0,1,0,0,5,6
Outrage + Optimism,1,0,2,1,35,39
The Chris Stigall Show,2,0,0,0,48,50
Little Girl Lost: The Case of Erica Parsons | Mystery and Murder: Analysis by Dr. Phil,78,48,66,65,243,500
Dear White Women,0,0,0,0,16,16
Balbaro Que Podcast,0,0,0,0,1,1
Le Batard & Friends Network,1,1,0,2,493,497
New Jump City,0,0,0,0,6,6
The Humble Hoof,0,0,0,0,10,10
Exactamundo with Eddie Della Siepe,0,0,0,0,18,18
The Level Up English Podcast,0,0,0,0,14,14
Hey Jessica,0,0,0,0,50,50
13 Minutes to the Moon,7,6,9,21,410,453
Broken Ground,1,0,0,0,20,21
Too Tired To Be Crazy with Violet Benson,5,0,0,1,44,50
Firearm Trainer's Podcast For American Firearm Instructors,0,0,0,0,11,11
The Melanated Social Work Podcast,1,0,0,1,24,26
The Chernobyl Podcast,24,3,8,14,370,419
Go For Production with Brandon Riley: A Filmmaking Podcast,0,0,0,0,7,7
Movie Night,0,0,0,1,1,2
So...What Do You Do Again?,0,0,0,0,12,12
Cream City Pacers,1,0,0,0,2,3
Going Racing with Adam Carolla,0,0,1,0,0,1
Bitcoin Magazine Podcast,0,0,0,0,7,7
The Shrink Next Door,38,40,31,34,357,500
Life is Short with Justin Long,3,2,5,7,33,50
Inside Star Wars,23,15,12,10,83,143
Private Aviation Insider,0,0,0,0,1,1
The Soul Awakening Podcast,0,0,0,1,36,37
"Eat, Pray, Britney",5,0,6,4,30,45
Ayurveda Life School Podcast,0,0,0,1,49,50
The Aloha Press - Golf Podcast,0,0,0,0,16,16
Couples Coaching with Natalie Clay,0,0,1,1,48,50
El Cuido Podcast,0,0,0,0,16,16
RNZ: The Detail,3,1,4,1,46,55
Value Investing with Legends,2,1,4,1,6,14
Fowl Mouths Podcast,1,0,0,0,12,13
Physiology by Physeo (An InsideTheBoards Podcast),0,0,0,0,5,5
Up All Night: An Are You Afraid of the Dark Podcast,0,1,0,1,26,28
From the Field,0,0,0,0,6,6
Simply Put,0,0,0,0,74,74
Your Undivided Attention,2,0,2,3,76,83
The Rexin Around Show: A Star Wars Podcast,1,1,0,0,322,324
Bavarian Football Works: For Bayern Munich fans,1,0,0,0,7,8
EnviroMENTAL,0,0,0,0,2,2
What Goes Up,0,0,1,2,30,33
BiggerPockets Business Podcast,4,3,6,5,118,136
DBT Weekly,0,0,0,0,17,17
Deep Background with Noah Feldman,5,4,2,4,35,50
The Event Safety Podcast,0,0,0,0,1,1
American Nightmare Podcast Presents...,0,0,0,0,9,9
The Dear Body Podcast,0,0,0,1,49,50
Unashamed with Phil & Jase Robertson,2,2,4,2,174,184
Wisdom From The Top,2,3,0,2,26,33
Mexican Fluency Podcast,0,0,0,0,9,9
Million Dollaz Worth Of Game,2,1,2,0,45,50
Inside Marvel: A WandaVision Aftershow,2,1,1,3,34,41
Girl CEO Podcast,1,0,1,2,46,50
MLVC: The Madonna Podcast,3,1,0,1,15,20
Outdoor News Radio,1,0,0,0,1,2
It's All Bad,0,1,0,2,47,50
Chirpin' DMV,0,0,0,0,11,11
Elderberry Tales,0,0,0,0,7,7
Hurry Up and Wait,0,0,0,0,15,15
The Iron Dice,0,0,0,0,42,42
Ringside Rant,0,0,0,0,12,12
Life Worth Chasing,0,0,0,0,66,66
Code source,0,0,0,0,1,1
Boston Harbor Horror Presents,0,1,5,0,12,18
What's the Score Podcast,0,0,0,0,1,1
Primetime,3,0,0,1,21,25
Dead Ass with Khadeen and Devale Ellis,5,4,6,5,480,500
The One Inside: An Internal Family Systems (IFS) podcast,0,0,0,0,12,12
185 Miles South,0,0,0,0,58,58
21.FIVE - Professional Pilots Podcast,0,0,0,0,50,50
Learn to Code in One Month,0,0,1,1,18,20
RC STUFF,0,0,0,0,2,2
IBM Blockchain Pulse,0,0,0,0,4,4
Wheeling Wine And Whiskey,0,0,0,0,50,50
L'italiano vero,0,0,0,0,7,7
Bar Exam Game Plan℠,0,0,0,0,6,6
Boom Boxxx,1,1,2,2,7,13
The DiscoverU Life Podcast,0,0,0,0,1,1
We Say Things - an esports and Dota podcast with SUNSfan & syndereN,0,1,0,2,83,86
We Gotta Believe,3,0,0,0,140,143
The Literary Life Podcast,3,0,0,2,65,70
The 21st Rewrite,0,0,0,0,3,3
Manifest It A.L.L. Podcast,0,0,0,0,31,31
Americana Podcast,0,0,0,0,30,30
Earth Break,7,6,3,6,28,50
The Charlie Kirk Show,14,0,0,4,168,186
The David Bach Show,0,0,1,0,64,65
Serve The People Podcast,0,0,0,0,3,3
The Cheese Room Podcast (THFC),0,0,0,0,4,4
The Infant Toddler Toolbox,0,0,0,0,5,5
Livin' the Suite Life Podcast,0,0,0,0,7,7
Committed to Us,0,0,3,1,43,47
La Story,0,0,0,0,2,2
This Family Tree Podcast,5,0,0,0,30,35
The Senior Golfer Advisor,0,0,0,0,2,2
The Collector Car Podcast,0,0,0,0,4,4
Science Rules! with Bill Nye,51,16,19,28,334,448
approachable.,4,5,6,5,180,200
The Underculture with James Adomian,0,0,0,0,50,50
The Visceral Voice Podcast,0,0,0,0,9,9
The Patdown with Ms. Pat,3,0,1,0,46,50
Panic with Friends - Howard Lindzon,0,0,0,0,3,3
That Witch Life,1,0,0,0,22,23
Explicitly Pro-Life,18,1,0,0,31,50
MLS: The Call Up,2,0,0,1,50,53
Bigfoot and Beyond with Cliff and Bobo,4,4,5,4,102,119
Maximized Minimalist Podcast,0,1,0,0,49,50
Real Bodybuilding Podcast,1,0,0,1,48,50
None of the Above,0,0,0,0,5,5
Anaya Ivy,1,2,1,1,157,162
You're Welcome with Hilary Rushford,3,0,0,0,147,150
My Digital Farmer | Marketing Strategies for Farmers,1,0,0,0,11,12
Win Daily Sports Show: WinDailySports.com,0,0,0,0,25,25
The ADHD Smarter Parenting's Podcast,1,0,0,0,5,6
The Road to Emmaus with Scott Hahn,2,0,0,0,28,30
The Oath with Chuck Rosenberg,7,3,3,6,481,500
Nights At The Round Table Pod,3,1,0,1,87,92
Health Anxiety Show,0,0,2,0,48,50
Pilot Protection Services Podcast- Aviation Podcast,0,0,0,1,0,1
Life Kit,6,3,6,5,30,50
Life Kit: Money,0,0,1,1,2,4
Life Kit: Health,2,1,0,1,6,10
"Incarceration, Inc. with Van Jones",2,0,1,0,11,14
Morning Tide with Ted Ramey,0,0,1,1,7,9
WTOP’s American Nightmare Series,8,18,18,16,120,180
The Zane Lowe Interview Series,3,0,0,2,32,37
Redesigning Life with Sabrina Soto,1,0,3,2,68,74
"The FitMind Podcast: Mental Health, Neuroscience & Mindfulness Meditation",1,0,2,0,45,48
The Force Fed Sci-Fi Movie Podcast,0,0,0,0,2,2
Mediocre Golf Podcast,0,0,0,0,8,8
The Anime Lately Podcast,0,0,0,0,4,4
"Freely Filtered, a NephJC Podcast",0,0,0,0,17,17
How Neal Feel,14,5,1,1,29,50
Estimation 180,0,0,1,0,19,20
"Cabot Cove Confidential: A ""Murder, She Wrote"" Podcast",0,0,1,0,23,24
The Homegrown Helpers,1,0,1,2,31,35
Sports Info Solutions Baseball Podcast,0,0,0,1,4,5
The Astroholic Explains,0,0,0,0,1,1
Magic Monday,2,0,0,1,113,116
Ten Very Big Books - A Malazan Readthrough Podcast,2,0,0,2,31,35
Bigfoot Terror in the Woods Sightings and Encounters,2,0,1,0,47,50
The Empowered Nurse Podcast,0,2,0,0,45,47
Paranormal Portal,3,0,5,4,33,45
The Living Force: A Star Wars Podcast by Youtini,0,0,0,1,19,20
The Training For Trekking Podcast,0,0,0,2,16,18
Talkin' Halos,2,0,1,1,52,56
The Girls Bathroom,22,3,16,13,236,290
Les Brown Archive's Podcast,2,0,0,0,2,4
The Graham Cochrane Show,0,0,0,0,164,164
Colors of the Dark,1,1,4,2,38,46
"Fundamental Health with Paul Saladino, MD",1,1,0,0,48,50
Lew Later,2,0,3,3,183,191
The Skillful Podcast,0,0,0,0,26,26
SURGE Strength - Dryland & Strength Training for Swimming,0,0,0,0,5,5
GMBN Presents The Mountain Bike Podcast,0,0,0,0,8,8
The TryPod,2,4,2,1,41,50
Big Life Kids Podcast,1,0,2,2,45,50
VAST Horizon,4,5,14,4,23,50
7am,5,7,5,7,73,97
Realtree Outpost,1,0,0,1,13,15
Wholesale To Millions,0,0,1,0,5,6
UI Narrative: UI/UX Design and Product Strategy,0,0,1,2,27,30
Cal's Week in Review,11,3,5,7,474,500
Harper Rose Trilogy,0,1,0,1,2,4
The Dungeon Run Podcast,0,0,0,0,50,50
Life Will Be the Death of Me with Chelsea Handler,12,0,2,0,36,50
How To Love Lit Podcast,0,0,0,0,20,20
Tales From The Rabbit Hole,0,0,0,0,6,6
Wheelin',0,0,1,0,5,6
The Rabbi Stark Podcast,0,0,0,0,4,4
My Funeral Home Stories,2,2,5,6,339,354
Fierce,0,0,1,0,19,20
The Rest of the Story™ Podcast,5,2,2,7,139,155
Creating Confidence with Heather Monahan,0,0,0,0,50,50
The Al Franken Podcast,5,0,2,0,43,50
Bankshot,0,0,0,0,3,3
WRAL News Daily,0,0,0,1,4,5
Teachers in America,1,0,0,0,4,5
Friend of a Friend,1,0,1,0,13,15
For Canon Sake,0,0,0,0,23,23
The Long View,5,1,1,2,30,39
Truth Be Told,5,1,1,1,96,104
Lesbians In Love - the LGBTQ show for women in relationship with women,0,0,0,1,18,19
Intuitive Eating for the Culture,0,0,0,0,12,12
Digging Deep: a boscia skincare podcast,0,0,0,0,2,2
Meraki Unboxed,0,0,0,0,2,2
The Hudson Valley Disc Golf Podcast,0,0,0,0,4,4
Teaching Autism and Special Education,0,0,0,0,5,5
Crickets to Cha-Chings,0,0,0,0,100,100
UnCommon Law,0,0,0,1,23,24
Nice Try!,29,15,5,11,140,200
Modern Renegades,1,0,0,0,15,16
The SLP Now Podcast,0,0,1,1,31,33
Kristen Welch,0,0,0,0,3,3
Sewing For The Weekend,2,0,0,1,16,19
In the Open,1,0,0,0,0,1
The Genetics Podcast,0,0,0,0,3,3
Houndsman XP - Sportsmen's Nation,1,1,3,3,105,113
The Corporate Director Podcast,1,0,1,0,12,14
Out Alive from BACKPACKER,2,0,3,6,73,84
The Pod and the Pendulum,0,2,0,1,24,27
Couldn't Help But Wonder: A Sex and the City Podcast with Jamie Lee and Rose Surnow,9,4,2,4,143,162
Being Earnest,0,1,0,0,23,24
Jacked Athlete Podcast,0,0,0,0,1,1
Self Evident: Asian America's Stories,0,0,0,0,30,30
Plastic Surgery Uncensored,1,0,0,2,27,30
Manifest with Tori DeSimone,11,12,6,2,19,50
Civilized,2,1,2,1,25,31
Leanne Ward Nutrition,0,0,1,0,49,50
The Apparel Entrepreneurship Podcast,0,0,0,0,6,6
The Poker Grid,0,0,0,1,30,31
Crawfordsville Connection,0,0,0,0,2,2
Ageless,0,0,0,3,145,148
The David McWilliams Podcast,0,0,0,0,7,7
White Lies,5,2,8,11,474,500
Seeking Witchcraft,3,1,4,1,37,46
One in Ten,0,0,0,0,4,4
LA LISTA: A Latinx Writers Podcast,0,0,0,0,6,6
The Closet Conservative Podcast,5,0,0,0,12,17
With Whit,12,7,11,5,15,50
Colorful Conversations: DIY & Home Design,0,0,1,2,41,44
Mushroom Revival Podcast,0,0,0,2,11,13
The Collecting Cars Podcast with Chris Harris,2,1,2,6,22,33
My Climate Journey,0,0,0,1,15,16
Casio's Cut,1,0,0,0,21,22
THE PAYOFF,4,2,1,0,30,37
Bleed Cubbie Blue: for Chicago Cubs fans,0,0,0,0,5,5
Sweet T: The Unofficial Southern Charm Podcast Podcast,4,2,2,1,277,286
Fresh From The Pod - Gardening Stories,0,0,0,0,3,3
Helping Couples Heal Podcast,0,0,0,2,25,27
K-Pod,0,0,0,0,4,4
Long Ash Podcast,0,0,1,0,3,4
13 Alibis,3,2,4,7,97,113
Anyone Can Run,0,0,0,0,9,9
The EMS Lighthouse Project,0,0,0,1,5,6
Paired,0,0,0,0,43,43
Skincare Secrets,0,0,2,2,50,54
The Intellectual Dollar Tree,5,0,0,0,1,6
Drawing Inspiration,0,0,0,0,6,6
AC/DC: Beyond The Thunder,0,0,0,0,2,2
OfflineTV Podcast,5,1,1,2,61,70
Three Gossip Girls - A Gossip Girl Podcast,0,0,0,0,19,19
The Thermal Podcast,0,0,0,0,5,5
The SimplyBe. Podcast,0,0,0,0,50,50
Melissa and Lori Love Literacy,0,0,0,0,4,4
Rise & Shine with Adrienne Gold Davis,0,0,0,0,11,11
Have It All,0,0,2,1,47,50
The Putting Couch Podcast presented by SeeMore Putter Company,0,0,0,0,7,7
Ghostrunners,0,0,0,0,50,50
SKYlights,0,0,0,0,14,14
Delving Into Islam,0,0,0,0,1,1
Erotica Bedtime Stories,0,0,0,0,2,2
Daily Star Trek News,0,1,0,1,19,21
Encore une histoire,0,0,0,1,9,10
Relationship Transformers,3,0,0,0,39,42
The River Radius Podcast,0,0,0,0,8,8
The Victor Marx Podcast,0,0,0,0,10,10
Deck of Friendship!,1,0,0,0,38,39
The Arch and Anth Podcast,0,0,0,0,1,1
Brown Girl Self-Care,0,0,1,0,31,32
Today is the Day,0,0,0,0,21,21
Speaking of Bitcoin (formerly Let's Talk Bitcoin!),0,0,0,0,1,1
Adulting,0,0,0,3,47,50
The Carlat Psychiatry Podcast,0,0,3,0,18,21
Bobby and Jens,1,0,0,0,10,11
Wall Street Oasis,1,0,1,6,192,200
Craft A Life You Love,1,0,0,1,48,50
Badass Digital Nomads,1,0,0,0,37,38
Horror Soup,5,0,1,4,71,81
Parenting Without Power Struggles,0,0,1,0,26,27
Faithless Brewing: MTG for the Rogue Deckbuilder,1,0,0,0,28,29
Queer The Table,0,0,0,0,11,11
Wildfire,4,7,6,3,14,34
Backstage Journal Podcast with Rhett Shull,0,2,6,0,19,27
The McIlwraith Statements,0,0,0,1,27,28
The Quickie - Interviews for Graphic Designers,0,0,0,1,82,83
The Engineers Collective,0,0,0,0,2,2
She’s Here for It,1,0,1,0,48,50
Bird Sh*t Podcast,0,0,0,1,12,13
Locked On Big 10 – Daily College Football & Basketball Podcast,0,3,1,1,12,17
Locked On SEC – Daily College Football & Basketball Podcast,3,2,0,0,13,18
We Like Theme Parks Podcast,0,0,0,1,19,20
Busted Open,11,4,7,9,75,106
SLOWMO,0,0,0,0,2,2
Just the Zoo of Us,0,0,1,0,37,38
Morbidology,12,17,11,4,164,208
Girl On Top: ShallonXO,13,1,0,2,83,99
Sound Investing,0,1,0,0,11,12
Quick Question with Soren and Daniel,0,0,2,2,46,50
Jewish History Soundbites,1,0,0,0,32,33
Culturally Relevant with David Chen,5,0,1,3,105,114
Tailgate Country,1,0,0,0,2,3
Sneaker Closet Podcast,4,0,0,0,46,50
Quiz Quiz Bang Bang Trivia,0,1,1,2,46,50
"Let's Go, Atsuko!",0,0,0,1,27,28
Bussin' With The Boys,6,0,2,5,484,497
Psychology After Dark,0,0,1,0,12,13
Charm Talk: A Consideration of Southern Charm,2,2,2,6,32,44
Adventure Bound,0,0,0,0,54,54
The Wolf's Den,4,4,2,2,92,104
Husband In Law,2,3,1,1,95,102
Digging Deep with Cody Janssen,0,0,0,0,6,6
All Things Testosterone,2,0,0,1,31,34
Street Parking Podcast,0,0,0,2,36,38
The PCOS Nutritionist Podcast,0,0,1,0,20,21
"Parental As Anything, with Maggie Dent",1,0,4,3,44,52
WHAT THE HELL DO I EAT?,1,0,0,1,6,8
Great British Quilter Podcast,0,0,0,0,5,5
The Kabbalah of You,0,0,0,0,1,1
The Pashmina Podcast,0,0,0,0,1,1
The Great One on 1,2,1,1,2,38,44
Encyclopedia Womannica,6,2,0,1,41,50
Menace 2 Sports with Zach Smith,23,9,4,11,144,191
Conversations in Close Protection,0,0,0,0,4,4
The Mindful Corner Podcast,0,0,0,0,34,34
Very Bad Therapy,3,1,3,0,28,35
The Official Average Boy Podcast,0,1,0,1,48,50
The Two Princes,1,1,0,5,43,50
Talking Records,0,0,0,0,7,7
Brawl Time- A Brawl Stars Podcast,3,0,0,1,46,50
Robert Cabral's Canine Conversations - Dog Training Podcast,1,0,1,0,31,33
First Move with Julia Chatterley,1,0,0,0,2,3
Podcasting Q&A,0,1,0,0,16,17
The Chasing Daylight Podcast,0,0,0,0,20,20
The Nitty Gritty Show,0,0,0,2,75,77
Locked On Brewers- Daily Podcast On The Milwaukee Brewers,5,1,0,0,7,13
The MomForce Podcast Hosted by Chatbooks,0,0,0,2,48,50
So You Want to Be a Marine Biologist,0,0,0,0,12,12
Best Friends with Nicole Byer and Sasheer Zamata,1,0,1,1,47,50
The WoMed,6,5,3,3,96,113
Dumb Dad Podcast,0,0,0,0,21,21
Cryptic,3,1,0,0,21,25
Dateline NBC,126,78,84,48,354,690
The Disney Vacation Club Show,1,2,2,2,14,21
Building Your Business with doTERRA-Empowered Success,0,0,0,0,6,6
ILLUMINATORS,0,0,0,0,12,12
Connected Families Podcast,0,0,0,0,38,38
DJ & PK in the Morning,2,0,0,0,3,5
This Land,24,13,19,23,389,468
The Everyday Style School,0,0,0,0,30,30
The Zone Sports Network - Utah Jazz,1,0,0,1,3,5
Was That Good For You? - Raya Carmona,2,0,0,1,23,26
Cereal Killers,0,0,0,0,50,50
DogSpeak: Redefining Dog Training,0,0,0,0,3,3
Current ECG Podcast,0,0,0,0,1,1
Pivot to the Future with Will.i.am and Omar Abbosh,2,0,0,1,4,7
BTS AF,0,1,1,1,12,15
Tennis Anyone with Michael Kosta,1,0,0,2,50,53
Real Estate Strategies with Ken McElroy,0,1,0,1,46,48
Draftsmen,0,1,3,0,46,50
Book to New Worlds (A D&D Audiobook): Narrated by Jack Voraces,1,0,0,0,7,8
Good Omens Podcast from TV Podcast Industries,0,0,1,0,2,3
The Never Rad Miscellany,0,0,0,0,5,5
Get Messy Podcast,0,0,0,0,6,6
Dumb Blonde,2,0,0,0,48,50
Ringer Dish,25,9,7,7,141,189
Elis James and John Robins,1,0,0,3,46,50
Behavior Bitches,2,0,0,0,230,232
Honeybee Kids - Bedtime Stories,8,0,3,3,36,50
Depression to Expression Podcast,0,0,1,0,23,24
Man In The Window: The Golden State Killer,41,40,44,43,332,500
Purpose Driven Mom Show,0,0,0,0,50,50
No Stylist Left Behind,0,0,0,0,30,30
The Crate 808 Podcast,0,0,0,0,7,7
The Devdutt Pattanaik Show | Mirchi,3,1,1,0,6,11
Poorly Read Podcast - Season One: Harry Potter,1,1,1,0,13,16
Dream of Italy,1,0,2,1,70,74
Locked On Rays- Daily Podcast On The Tampa Bay Rays,2,1,0,0,17,20
Fantasy Football Advice Podcast,1,0,0,0,45,46
Fab Fertility,1,0,0,0,45,46
SnapBack Sports Pod,1,1,0,2,493,497
The CouRage and Nadeshot Show,3,0,0,2,45,50
Land of the Giants,15,12,9,11,71,118
The Guerilla Cricket Podcast,0,0,0,0,1,1
Document,2,2,2,6,18,30
What Now? A JTS Podcast,0,0,0,0,6,6
The Suspendables,0,0,0,0,4,4
Runners Without Limits,0,1,1,0,48,50
What We Learned Today,0,0,0,1,0,1
Changes with Annie Macmanus,1,1,1,1,56,60
Two Drunk Moms,0,0,0,0,15,15
Unleash Your Strengths w/ Eddie Villa,0,0,0,0,95,95
Korean American Perspectives,0,0,0,0,1,1
Selfmade with Nadeshot,0,0,1,4,74,79
The GolfRules Questions Podcast,0,0,0,0,2,2
Let Us Eat Cake,0,0,0,0,13,13
SlabStox Sports Card Trading,0,1,0,1,7,9
The Stag's Stable,2,1,0,0,3,6
DJ PH,1,0,0,0,22,23
How Men Think with Brooks Laich & Gavin DeGraw,35,24,33,27,113,232
American Osteopathic College of Physical Medicine and Rehabilitation,0,0,0,0,1,1
Murder Room,0,0,0,0,1,1
Magik Vibes,0,0,0,0,79,79
Adventures Of The StarKeepers,0,0,1,0,30,31
Real Pod,0,0,0,0,50,50
Stadium and Gale: A Florida Gators Podcast,2,2,1,4,143,152
Gluten Free You & Me,0,1,1,2,46,50
Starting In Te Reo Maori Podcast,3,0,1,0,4,8
Clean Sport Collective,4,0,2,2,31,39
FreightWaves Insiders,0,0,0,0,1,1
That's Not My Age,0,0,0,1,6,7
"Sex, Love, and Addiction: Healing Conversations for Gay, Bisexual, and Transgender Men",0,0,0,0,2,2
Swinger University - An Educational Podcast About Swinging,0,0,0,0,5,5
The Spark Show,0,0,0,0,33,33
Spectacular Failures,15,10,6,8,161,200
Black Women Travel Podcast,0,0,0,0,12,12
The Balanced Life,1,0,0,1,48,50
Live To Eat with Candace Nelson,0,0,1,0,49,50
DIVINELY HUMAN,0,0,0,0,16,16
True Crime Chronicles,6,2,8,9,92,117
"What Goes On, BTS? - An ARMY Made BTS Podcast",0,0,0,0,5,5
Culpable,27,25,22,17,409,500
AWS Morning Brief,0,1,0,0,6,7
Consider Before Consuming,0,1,3,2,44,50
Around the Circle: An Enneagram Podcast,0,0,0,0,34,34
Come to Where I'm From,0,0,1,2,19,22
The Heavy-Duty Parts Report,0,0,0,0,3,3
What Magic Is This?,1,1,1,1,34,38
The Fiona Show,0,0,0,0,2,2
House Culture,0,0,0,0,3,3
PORTRAITS,0,0,0,0,6,6
Made For This with Jennie Allen,0,2,0,2,180,184
Let's Talk ETFs,1,0,0,1,9,11
Thoughts on the Market,0,2,2,3,33,40
Overheard at National Geographic,17,3,13,42,381,456
African Folktales Podcast,0,0,0,0,8,8
Chris and Dave’s Reality Cast: Bachelor & Temptation Island,1,0,1,1,28,31
Co-Parenting Past Chaos,0,0,0,1,17,18
The Conduct Science Podcast,0,0,0,0,1,1
Wild Animals,0,0,0,1,5,6
Juice Worlds Death Conspiracy Theories,3,0,2,1,14,20
Duolingo French Podcast,0,0,0,3,6,9
Theories of the Third Kind,43,17,20,19,401,500
Black History in Two Minutes (or so),0,0,0,0,11,11
Fintech Beat,0,0,0,0,11,11
BrandoCast with Brendan Smith,0,0,0,0,17,17
Weebology Podcast,0,0,0,0,10,10
The Soccer Soup Podcast,0,0,2,2,84,88
Monocle 24: The Monocle Minute,0,0,0,0,2,2
The PC Gamer Show,3,1,2,0,3,9
The Soulful Hunter Podcast,1,0,0,1,14,16
Beyond the Pink Cloud,0,0,0,0,9,9
Own Woman,0,0,0,0,7,7
The SwimSwam Podcast,0,0,0,0,3,3
Secret Sonics,0,0,0,0,13,13
Bob Stroud's One 45 of the Week,0,0,2,1,0,3
"Medical Myths, Legends & Fairytales",7,1,0,0,9,17
1865,7,0,1,5,37,50
Todd Durkin IMPACT Show,0,1,0,0,49,50
The SCP Foundation Database,0,0,0,0,10,10
Firsthand: Geniuses,0,0,0,0,9,9
Extremities,2,2,2,6,139,151
Hacks on Tap with David Axelrod and Mike Murphy,5,1,2,1,41,50
Broken Silicon,0,0,0,0,27,27
Ranger Danger: Archives,0,0,0,0,2,2
Casual Watch Talk,0,0,0,0,4,4
ColdFusion,0,0,0,0,18,18
The Zen of Everything,0,0,0,0,3,3
The Full-Time FBA Show - Amazon Reseller Strategies & Stories,2,0,1,0,54,57
Nurse Educator Tips for Teaching,0,0,0,0,1,1
Illini Inquirer Podcast,0,1,0,0,31,32
ADV Podcasts,0,0,3,2,15,20
Star Wars Theory,3,2,2,12,239,258
Up is Down Podcast,2,0,0,0,19,21
The Origins Podcast with Lawrence Krauss,3,5,1,2,7,18
Your First Million,0,0,0,1,80,81
Bob Thurman Podcast: Buddhas Have More Fun!,1,0,0,1,8,10
Community Influencer® Show,1,0,1,0,16,18
Emma’s Diary from the Road,0,0,0,0,40,40
People's Party with Talib Kweli,140,0,1,10,218,369
Buddahood Podcasting,0,0,0,0,1,1
The All Things Overlanding Podcast,0,0,0,1,4,5
Cut Through Nutrition,0,0,1,2,42,45
The Illustration Department Podcast,0,0,1,2,57,60
Face 2 Face,0,0,0,0,1,1
Kingdom Hairstylist's show,0,0,0,0,9,9
Waldorfy,0,0,0,0,15,15
At The Bridge Pod: A Chelsea FC Podcast,0,0,0,1,5,6
Real Personal Finance,0,0,0,0,30,30
High Vibin’ It,0,1,0,0,27,28
Juna Women Podcast,0,0,0,0,15,15
The Kids Get Rich Podcast,1,0,0,0,4,5
laborvision,0,0,0,0,2,2
The Enduring Gifts of MARVIN GAYE Podcast,0,0,0,1,1,2
Awesome Movie Year,0,0,0,0,3,3
The Four Jack Podcast - A Global Golf Podcast,1,0,0,0,1,2
2 Bears 1 Cave with Tom Segura & Bert Kreischer,18,8,10,18,134,188
The DMT Xperience Podcast,1,1,0,0,16,18
Knights of the Rolled Table | a Dungeons & Dragons podcast,0,0,1,0,21,22
She's On The Money,92,22,34,20,28,196
Oculus Quest Cast,0,3,0,1,7,11
The Boy Mom Podcast with Monica Swanson and Friends,1,0,0,0,49,50
Blended Life - A Blended Family Podcast,4,0,1,2,10,17
Chica Travel with Lelo,0,1,0,2,54,57
The Widowed Mom Podcast,0,0,0,1,49,50
Bark Talk with Bonnie,0,0,0,0,2,2
Wookieeleaks: A Mandalorian Aftershow | A New Rockstars Podcast,1,1,0,0,18,20
"Plantbased, Not Perfect",0,0,0,0,50,50
Starting Point with Casey Jennings,0,0,0,0,7,7
Noble Blood,31,15,11,24,416,497
Fat Murder Podcast,1,0,1,0,12,14
Inside Out Health with Coach Tara Garrison,0,0,0,0,11,11
Upland Nation,4,1,0,2,30,37
Let The Darkness Take Control,1,0,1,0,9,11
Grow Your Own Food,0,0,1,0,9,10
Fanboys,0,0,0,0,5,5
Burnin' Daylight,0,0,0,0,2,2
Tests and the Rest: College Admissions Industry Podcast,0,0,0,0,7,7
No Dunks,6,1,3,5,485,500
iRacing Downshift,1,0,0,0,5,6
Present Company,0,0,0,0,9,9
Watts Up,1,0,0,0,3,4
All Rabbi Yaakov Wolbe Podcasts,0,0,0,0,2,2
The Three Questions with Andy Richter,1,7,1,2,39,50
The Biblical Mind,0,0,0,1,20,21
Inside the Birds: A Philadelphia Eagles Podcast,6,6,6,6,199,223
The Withering Effect - Minecraft Podcast,2,0,2,3,17,24
Sara Carter Show,5,2,2,4,223,236
Cracking the Code of Spy Movies!,0,0,0,0,5,5
Fruitbowl,0,0,0,0,15,15
The True Tunes Podcast,0,0,0,1,8,9
Good Kids,9,5,0,1,34,49
The Alarmist,5,2,4,1,38,50
Intentional Leader with Cal Walters,0,0,0,1,24,25
The Babylon Bee,14,6,4,13,275,312
E se ... podcast,0,0,0,0,7,7
Sense of Soul Podcast,1,0,0,1,22,24
Wrestling Perspective Podcast,0,0,0,0,8,8
Bad Heroes,0,0,0,1,12,13
Por el Placer de Vivir con el Dr. Cesar Lozano,1,0,0,0,16,17
Road to the Trials,0,0,0,0,37,37
Last Day,10,9,8,17,315,359
The Moral Imagination,0,0,0,0,13,13
Housewives Tonight!,0,0,0,0,27,27
Manifest Mad Money,0,0,1,0,26,27
Insight with Chris Van Vliet,2,1,1,3,492,499
The Turn On,0,0,0,0,7,7
Carrier,2,4,8,6,30,50
Dreamnasium sci-fi audio drama anthology,0,0,0,0,2,2
Archive Seasons 1-6 – Writing Excuses,0,0,0,0,1,1
New York Daily News,0,0,0,2,1,3
What We're Drinking with Dan Dunn,3,1,1,0,15,20
Slimming World Podcast,2,2,1,5,137,147
Lost Art,0,0,0,0,1,1
"Mixing Music | Music Production, Audio Engineering, & Music Business",1,0,0,0,57,58
Drone to 1K Podcast by Drone Launch Academy,0,0,0,2,124,126
Game of Roses,24,7,11,14,444,500
Couch and The Rube,1,0,0,0,7,8
Moonrise,2,2,7,5,34,50
Ghoul Friends Podcast,0,0,0,0,14,14
"Ford Mustang The First Generation, The Early Years Podcast",1,0,0,0,14,15
True Crime Conversations,13,7,9,9,54,92
Strict Scrutiny,6,5,2,6,31,50
Ladybug Podcast,2,0,0,1,22,25
The Hylian Gamescast,0,0,0,0,22,22
The Climate Pod,0,0,0,1,24,25
Dermasphere - The Dermatology Podcast,0,0,0,0,9,9
Disgusting Hawk with Jessica Kirson,2,1,2,0,45,50
Kitces and Carl - Real Talk for Real Financial Advisors,1,0,0,1,9,11
Frequent Miler on the Air,1,0,0,1,25,27
Voices for Justice,4,8,7,5,476,500
The Bludd Heart - Diablo & Gaming News,0,0,0,0,10,10
The Journal.,117,45,18,9,93,282
Wrasslin' With Sports Entertainment Presented By Pat McAfee Inc.,0,0,0,1,16,17
Junkyard Dawgcast,3,0,0,4,87,94
The Scale of Wisdom,0,0,0,0,1,1
The Bare Performance Podcast,1,0,0,1,48,50
The Red Resistance: A Handmaid's Tale Podcast,0,0,0,2,28,30
College Admissions Decoded,0,0,0,0,2,2
Where The Scary Things Are,0,0,0,0,2,2
The Papaya Podcast,4,4,6,3,33,50
Foodtrainers,1,0,0,0,49,50
How To!,3,1,3,5,38,50
The Nacho Kids Podcast: Blended Family Lifesaver,1,1,1,0,47,50
Absolutely Not,10,3,1,3,33,50
Neuroscience Meets Social and Emotional Learning,0,0,0,0,3,3
True Crime South Africa,0,2,5,2,54,63
The Functional Tennis Podcast,0,0,0,0,9,9
Cobwebs: A Gothic Cinema Podcast,0,0,0,0,3,3
My First Million,5,1,6,4,184,200
Worm Audiobook,1,1,3,0,5,10
Telehell,0,0,0,0,7,7
Yes Way with Daniel Weingarten,0,0,0,0,13,13
Fight Bananas,0,0,0,0,14,14
Franco's World,0,0,0,0,8,8
The Killing of JonBenet: The Final Suspects,133,80,58,21,66,358
Think Like A CEO with Gary Keller & Jay Papasan,0,0,2,4,77,83
Blog & Mablog,2,0,0,0,95,97
Trapital,0,0,0,0,9,9
Network Marketing Ninja Podcast With Frazer Brookes,0,0,0,0,100,100
StressLess Camping podcast,0,1,0,0,19,20
Charlie & Ben Podcast,1,0,0,3,46,50
Where Is My Mind?,3,2,0,5,44,54
"Pili, Raul & La Musica",0,0,0,0,21,21
Fitness for the Fairways,0,0,0,1,24,25
Mixing with Mani,3,1,3,4,124,135
The Dead To Me Podcast,1,0,0,0,3,4
The Roys Report,3,1,0,2,13,19
The Van Life Podcast,5,1,1,0,3,10
SOMM TV,0,2,0,5,17,24
Billboard News Now,0,0,0,0,1,1
DayLuna Human Design Podcast,0,0,1,0,36,37
Behind The Scenes | Animation,1,1,0,2,54,58
APEX Live Anesthesia,0,0,0,3,33,36
Liminal Apocalypse,6,2,2,5,8,23
Growing Cubs: A Chicago Prospect Podcast,0,0,0,0,6,6
The Fantastic History Of Food,0,0,0,0,18,18
Living Fully with Mallory Ervin,10,1,4,4,481,500
Joyce Meyer's Talk It Out Podcast,0,0,0,7,113,120
The Woj Pod,15,3,6,2,20,46
The Fantasy Points Podcast,1,1,0,2,31,35
Dilemma Podcast,2,0,0,0,4,6
Scary Stories & Rain,1,0,0,2,58,61
Farm4Profit Podcast,0,0,0,0,7,7
Eastern Current Saltwater Fishing Podcast,0,0,0,0,58,58
EMS World Podcasts,0,0,0,0,1,1
TwoOhSix Podcast,0,0,0,0,1,1
The Jim Rutt Show,0,0,0,2,9,11
CE5 Podcast,0,0,0,0,2,2
The Fiona Show: Hot Off the Press,0,0,0,0,1,1
The Pilots' Lounge,0,0,0,0,8,8
Inside the Lion's Den: A Business and Leadership Podcast,0,0,0,0,36,36
Underunderstood,2,1,1,2,58,64
Sierra Unfiltered,4,0,2,1,93,100
Not The Worst Marriage,1,0,2,1,86,90
Storytime With Teta,0,0,0,0,2,2
Suggestible,1,1,3,1,194,200
History in Five Songs with Martin Popoff,0,0,0,0,7,7
Plat Chat,0,0,1,0,23,24
The Keto Kamp Podcast With Ben Azadi,0,0,0,1,49,50
The Forbidden Apple,0,0,0,0,18,18
Find Your Aha Moment,0,0,0,0,2,2
The Scalpel With Dr. Keith Rose,0,0,0,0,15,15
Larger Than Life,4,3,2,3,73,85
PaddyTalks Golf,0,0,0,0,5,5
Towards Data Science,0,0,0,0,3,3
Vacation Rental Machine,0,0,0,0,13,13
Another Level,0,0,0,0,10,10
Deeper Than Money,0,0,0,0,150,150
The Sister Diary,0,0,2,3,85,90
Black History Year,3,0,0,3,44,50
Shut Up I Love It,0,0,0,0,12,12
Con Artists,14,6,7,4,121,152
UnAborted,1,0,0,0,49,50
El Show De Chiquibaby,0,0,0,0,3,3
The Travel Diaries,2,0,1,1,87,91
The Long Hallway,0,5,4,1,16,26
Popular Volcanics,0,0,0,0,3,3
The Moment,15,10,24,27,139,215
Dog Lovers Unleashed™ - Fetching Your Dog's Best Life,0,0,0,0,9,9
MORNING KOMBAT WITH LUKE THOMAS AND BRIAN CAMPBELL,6,1,5,5,141,158
The Cold War: What We Saw,0,2,0,1,47,50
Flow with Berrion Berry,0,0,0,0,18,18
The Endless Honeymoon Podcast,4,1,1,1,43,50
Pod Don't Lie,3,2,0,1,236,242
Gloss Angeles,4,1,2,2,148,157
State of Mind with host Debra Sloss,0,0,0,0,8,8
Green Eggs and Dan,0,0,0,0,21,21
D3 Glory Days Podcast,0,0,0,0,18,18
Kickback Anime Discussion Podcast,0,0,0,0,1,1
Lights Out Bedtime Stories for Boys and Girls,0,0,0,0,1,1
American Thought Leaders,0,0,1,0,29,30
The Secret Lives of Black Women,5,0,4,5,137,151
The Clearing,26,29,46,55,318,474
BeEzrat HaShem with Rabbi Yaron Reuven,0,0,0,0,1,1
NORTH IDAHO NOW,0,0,0,1,3,4
Waterpeople Podcast,1,1,1,2,155,160
Japanese podcast for beginners (Nihongo con Teppei),1,0,0,0,14,15
All The Right Movies: A Movie Podcast,0,0,0,0,8,8
Harmony in the Home,0,0,0,0,50,50
The Rough Cut,0,0,0,0,3,3
Native Lights: Where Indigenous Voices Shine,0,0,0,0,2,2
Bret Weinstein | DarkHorse Podcast,29,7,15,7,173,231
The Homecoming Podcast with Dr. Thema,0,0,0,0,50,50
Context,0,0,1,1,0,2
Bizarre Albums,0,0,0,0,50,50
FIVE MINUTE NEWS,0,0,0,1,7,8
Pregnancy & Birth Made Easy,0,0,0,1,49,50
Drinking And Screaming - A Horror Movie Review Podcast,0,0,0,0,21,21
Starting Sustainability: Sustainable Living: eco-friendly: environment: green: recycle: zero-waste,0,0,0,1,5,6
The Bob Rivers Show,1,2,0,2,40,45
Film Fam: Inspired By True Events,0,0,0,0,7,7
Fish the Moment Podcast,0,0,0,0,53,53
Echange,0,0,0,0,5,5
Nice Try,1,0,0,1,10,12
Mississippi Golfer Podcast,0,0,0,0,1,1
True Sex & Wild Love,8,3,6,4,29,50
Tad DeLay,0,0,0,0,2,2
Spirit Speakers,0,0,0,0,37,37
The Frenemies Podcast,0,0,0,0,18,18
Meditative Story,0,0,0,0,2,2
Another Kind of Mind: A Different Kind of Beatles Podcast,3,2,0,1,20,26
Compromised,0,1,0,0,2,3
Life Uncut,1,1,2,3,80,87
The Beauty Closet,20,14,12,7,32,85
Yeshiva of Newark Podcast,0,0,0,0,1,1
Parklandia,4,7,1,2,46,60
Chemistry For Your Life,2,0,0,0,30,32
Podcasting After Dark,0,0,0,0,37,37
TB UNICORN POD,0,0,0,0,4,4
Manifestations,1,0,0,1,3,5
Psychology In Hindi,1,0,0,0,3,4
Filmtrepreneur™ - The Entrepreneurial Filmmaking Podcast with Alex Ferrari,0,0,0,0,16,16
"A Second Opinion with Senator Bill Frist, M.D.",0,1,1,0,48,50
Passenger List,0,1,2,7,78,88
Over the Road,2,3,3,5,129,142
Disney Magic of Storytelling,0,1,0,1,9,11
The Game EXPOSED: Relationship and Dating Advice,1,0,1,1,16,19
THE UPSIDE with Callie and Jeff Dauler,40,13,3,4,440,500
LowCarbUSA Podcast,0,0,0,0,4,4
Past Lives & the Divine,2,0,0,0,74,76
In The Landscape®,0,0,0,0,9,9
Cynema,0,0,0,0,7,7
Creative Processing with Joseph Gordon-Levitt,1,1,1,3,55,61
Jeepin Bubba,0,0,0,0,1,1
Curiosidades de la Historia National Geographic,0,0,0,0,3,3
Covering the Spread,0,0,0,1,11,12
Dropping In,0,0,0,1,15,16
Graining In,0,0,0,1,56,57
Not What You Thought You Knew,0,2,1,2,6,11
BarBend Podcast,1,0,1,1,47,50
Advantage Connors,0,0,1,0,29,30
Listen To Sleep - Quiet Stories,0,0,0,0,17,17
Animal Training Fundamentals with Barbara Heidenreich,0,0,0,0,5,5
Brain Jail,0,0,2,1,47,50
Talkin' Baseball (MLB Podcast),10,6,4,12,387,419
Addicted to Sets Tennis Podcast,0,0,0,0,5,5
Two Gay Matts,1,0,0,0,16,17
The Stick and Hack Show,0,0,0,0,2,2
The Secret Teachings Archives,3,0,0,0,8,11
Comedy Rewind,0,0,0,0,1,1
"The Practical Prepper: A modern conversation about preparedness, survival and being self reliant",0,1,1,0,2,4
Establish The Run,7,1,2,1,110,121
Dish On Ditching Diets,0,0,0,1,0,1
Raising Good Humans,2,0,1,2,45,50
Candid Confidence,0,0,0,1,18,19
The Bougie Show,0,0,0,0,1,1
Old Dirty Boston,0,0,0,0,10,10
CitySpeak,0,0,0,0,2,2
Tim May Podcast - Ohio State Football,1,1,2,3,15,22
Truck N' Hustle,0,0,0,0,13,13
Engadget News,1,0,0,0,0,1
Shark Tales,0,0,0,0,2,2
Dynasty’s Child,0,0,0,2,19,21
Americast,12,4,6,7,65,94
Normal to Nomad,0,0,0,1,59,60
Room 20,101,43,38,32,195,409
El Camino de Santiago Pilgrims' Podcast,0,0,0,0,5,5
The 200 Level with Mike Carpenter,4,1,2,3,48,58
F.I.R.E.D UP with Krista Mashore,0,0,0,0,50,50
The Tea on Tap: A Hair & Beauty Podcast,0,0,0,0,2,2
Plant Daddy Podcast,3,0,1,1,45,50
Sounds From The Abyss,0,0,0,0,13,13
Run the List,0,1,0,1,12,14
Clash Of The Titles,0,0,0,0,7,7
DERELICT,2,0,0,4,44,50
The Nurse Practitioner - The Nurse Practitioner Podcast,0,0,0,2,1,3
The Lost Ogle Show,0,1,1,0,1,3
The HYPE Report,0,0,0,0,16,16
Patient Zero,9,5,4,5,67,90
The Boston Terrier Society,0,2,0,0,2,4
The Spill,13,12,9,5,56,95
Inside Eyes,0,0,0,0,14,14
Brigit's Erotic Bedtime Stories,0,0,0,0,4,4
The Adam Ferrara Podcast,0,0,0,0,50,50
F*ck Weddings Podcast,0,0,0,0,12,12
InsureTech Geek Podcast,0,0,0,0,1,1
The Plough-Share,0,0,0,1,0,1
Forward Press Podcast from Golfweek.com,0,0,1,0,0,1
Orchid Chat With Dr. Connors,0,0,0,0,1,1
Guided Sleep Meditation & Sleep Hypnosis from Sleep Cove,3,0,4,1,52,60
Empath To Power Podcast,0,0,0,1,32,33
Bachelor Happy Hour,50,9,11,9,420,499
Medical Mysteries,30,20,24,18,79,171
Chicks on The Right Podcast w Mock & Daisy,1,0,0,0,49,50
The Narcissists' Code,0,0,0,0,1,1
That's What I'm Tolkien About,0,0,1,0,29,30
Sports Card Investor,4,0,3,2,27,36
Wind's Howling: A Witcher Netflix Show Podcast,1,1,3,2,21,28
Heros For Sale Podcast | Sports Card News & Info,4,1,1,0,20,26
The Battle of Gettysburg Podcast,0,0,0,0,50,50
Talkin' Yanks Pre-Game Show,0,0,0,0,14,14
The Daily Beans,19,7,20,8,228,282
Soccer 101,0,1,1,1,124,127
The Mechanics of Storytelling,0,0,0,0,2,2
Real Arabic,1,0,1,1,3,6
Eric Roberts Fitness,0,0,0,0,43,43
In Search of Portland,0,0,0,1,3,4
Apple Events,6,1,4,3,33,47
Marcus & Sandy's Second Date Update,3,6,0,0,1,10
Cassie Stephens,0,0,0,0,48,48
Apple News Today,68,19,22,28,161,298
CommissionED: The Air Force Officer Podcast,0,0,0,0,12,12
Point Shot,1,0,0,0,1,2
Unscripted Podcast – Islam21c Media,0,0,0,0,1,1
Kente Korner,0,0,0,2,8,10
TrueAnon,20,8,8,7,165,208
The Art and Science of Running,0,0,1,0,5,6
Weed Wonks,0,0,0,0,4,4
MNmaxed Podcast,0,0,0,0,7,7
"Brain Health and Beyond with Team Sherzai, MD",0,0,0,1,77,78
Just the Gist,5,7,4,5,71,92
Weeknight Kitchen with Melissa Clark,1,1,1,2,38,43
Healthy Widow Healthy Woman,0,0,0,0,2,2
Memory Card,0,0,0,0,3,3
Fala Gringo! | Intermediate Brazilian Portuguese,0,0,0,0,19,19
88 Days: The Jayme Closs Story,38,41,21,10,56,166
At The Table with Patrick Lencioni,0,0,2,4,109,115
The Sweet Smell of Succession,2,5,3,2,29,41
The Happiness Lab with Dr. Laurie Santos,16,12,16,16,324,384
RadioActive Dads,0,0,0,0,9,9
Daily Comedy News: a podcast about comedians,0,0,0,1,6,7
Unofficial Titans Podcast: Tennessee Titans,0,0,0,0,1,1
11 Personnel,0,0,0,1,24,25
The Tablo Podcast,0,0,0,6,494,500
State of Emergence,0,0,1,0,1,2
Narcissistic Abuse No More,1,0,1,2,6,10
Your Parenting Long Game,0,0,0,1,34,35
Through the Smoke: A Miami Hurricanes football podcast,4,2,1,2,124,133
Alfacast,0,0,0,0,4,4
Waveform: The MKBHD Podcast,2,0,2,5,54,63
Piece of Cake Podcast: A Detailed Guide to Wedding Planning,0,0,0,0,7,7
16 Minutes News by a16z,0,0,0,0,2,2
Tenn and Two,2,1,1,1,32,37
Strategic Sensibility,0,0,0,0,6,6
First Name Basis Podcast,0,0,0,0,50,50
Biddy Bedtime Stories Podcast,0,0,0,0,16,16
Once It's Begun,0,0,1,0,7,8
Collected Talks of David Solomon,0,0,0,0,5,5
The Champions Playbook,0,0,0,0,8,8
Amazing Wildlife,0,0,0,0,8,8
El Club de las 4AM,0,0,0,0,1,1
The Reconnection Club Podcast,0,1,0,0,6,7
Hustle Humbly,0,1,0,0,49,50
The Storage Papers,0,1,3,2,23,29
FUT IN REVIEW,0,0,0,0,7,7
TWC Show,0,0,0,0,2,2
Grief is a Sneaky Bitch,0,0,0,0,26,26
A Tale of Two Rivals: A Fantasy Football Podcast,0,0,0,0,4,4
You Cannot Be Serious,13,4,7,9,66,99
Cowboy Boys Podcast,0,0,1,1,48,50
Keto Life Support,0,0,0,1,49,50
The Hannity Monologues,3,0,0,0,2,5
Business Blooming Podcast,0,0,0,0,35,35
The Realignment,8,2,4,4,365,383
Gutsy Health | Nutrition and Medicine,1,1,2,2,44,50
GG Over EZ,0,0,0,1,49,50
Soil Sense,0,0,0,0,3,3
The Melanie Avalon Biohacking Podcast,0,0,1,2,47,50
The Garden Girls,0,0,0,0,8,8
"Good Together: Ethical, Eco-Friendly, Sustainable Living",1,4,1,3,41,50
Clothes Minded Podcast,0,0,0,0,6,6
The Boys of 161st Street - Yankees MLB Podcast,0,0,0,2,82,84
A Quilter's Life,0,0,0,2,6,8
True Crime Astrology with Shawn Engel | True Crime | Astro | Astrology | Zodiac | Horoscope | Creepy...,1,0,0,0,18,19
Storyberries Radio,0,0,0,0,1,1
On The Green Fence,0,0,0,0,3,3
Nightly Bedtime Story Podcast,0,0,1,0,1,2
Martes De Misterio,0,0,0,0,4,4
The Frank Caliendo Cast,7,0,0,3,38,48
Keno-Talk Podcast,0,0,0,0,1,1
The Zone,1,1,0,0,1,3
The American Story,0,0,0,1,49,50
Cutting The Distance with Remi Warren,3,0,1,6,490,500
Today in True Crime,57,35,36,17,125,270
The Week Junior Show,0,0,0,0,8,8
The Stadio Podcast,0,0,0,0,61,61
Heartwood,0,0,0,0,2,2
Spanish Lessons With Pablo - Learn Spanish.,0,0,0,0,1,1
The Level Up Latina Podcast,0,0,0,0,12,12
My Solo Road,2,1,1,4,115,123
KETO AFTER DARK,1,0,0,0,17,18
The Mind Of Dom,0,0,0,0,15,15
Meanspiration with Annie Lederman,2,0,0,0,48,50
Former Action Guys Podcast,0,0,0,0,33,33
The India Hicks Podcast,1,1,0,1,55,58
The Spitfire Series,0,0,0,0,1,1
The NASM-CPT Podcast With Rick Richey,0,0,2,1,30,33
Locked On Mariners - Daily Podcast On the Seattle Mariners,0,0,0,0,4,4
Squawk on the Street,10,1,4,3,13,31
Tech News Now,1,0,0,2,3,6
Sacred & Profane,0,0,0,0,12,12
Child of the Redwoods: Montessori Parenting,0,0,0,1,49,50
Team LoCoFit Round Table,0,0,0,1,19,20
Collider Podcast,4,2,0,0,27,33
Covert Castaway Liveaboard Sailing,0,0,0,0,6,6
Mental Health Remix,0,0,0,0,27,27
Food Biz Wiz,0,0,0,0,50,50
Wisdom of Crowds,0,2,0,1,6,9
Endocrine Disruptors,0,0,0,0,16,16
American Institute for Economic Research,0,1,0,1,0,2
Carmen Johnston Gardens,0,0,0,0,4,4
Solar Disruption Theory,0,0,0,0,2,2
Mike & Max's Offroad Podcast,1,0,0,0,30,31
Just Listen to Yourself with Kira Davis,0,0,0,1,49,50
The Former Lawyer Podcast,0,0,0,0,3,3
"Cyberpunk Lorecast: The Lore, News & Gameplay Podcast for Cyberpunk 2077",1,0,1,2,29,33
Five Nights At Freddy's: Let's Pod!,1,0,2,2,17,22
CHIC Happens,4,0,1,1,44,50
Living The New Science with Lynne McTaggart,1,1,0,3,77,82
Omar Hisham Al Arabi,0,0,0,0,2,2
BASCHAMANIA,0,0,0,0,47,47
She Plays Games Podcast,0,0,0,0,2,2
Argus Media,0,0,1,0,0,1
Someday is Here,0,0,0,0,22,22
The Lipstick Files,3,0,1,0,112,116
Kickback with Nedum,0,0,0,0,9,9
The Intersection with Jason Page,2,0,0,0,2,4
GOONS,0,0,0,0,50,50
GQ Talk,0,1,0,1,2,4
Ellie and The Wave,0,0,1,0,20,21
Wellness that Works,0,0,1,0,8,9
Behind The Baller Podcast with Ben Baller,9,0,0,1,190,200
Veronica Mars Investigations,7,7,0,2,40,56
Marine Mammal Science,1,0,0,0,1,2
Environmental Studies and Sciences,0,0,0,0,1,1
A Reseller's Life by Daily Refinement,0,0,0,0,50,50
rSlash,1,0,0,0,49,50
Saxo Market Call,0,0,0,1,6,7
Teacher Hustle Podcast,0,0,0,0,45,45
Magnus Podcast,0,0,0,0,13,13
Pulling Curls Podcast: Pregnancy & Parenting Untangled,0,0,0,0,17,17
Conservative Daily Podcast,13,3,3,3,181,203
Point of Origin,2,0,2,2,40,46
Tales of a Gearhead,0,0,0,0,2,2
The Drive with Lon Tay & Derek Piper,0,0,0,0,8,8
Old Fashioned On Purpose,2,1,2,0,45,50
RuffStuff Podcast,0,0,0,0,3,3
The Viridian Wild,0,0,0,0,3,3
Life As We Know it,0,0,0,0,1,1
Talk Tennis,0,0,1,3,40,44
Wild Plant Culture,0,0,0,0,6,6
STEMpod,0,0,0,0,3,3
Nick Bahe Podcast,2,0,1,1,110,114
Premier League on NBC,2,0,1,0,2,5
The Quilters Circle Podcast,0,0,0,0,1,1
We Ain't Got No History: for Chelsea FC fans,0,0,2,0,1,3
The Cigar Pulpit,0,0,0,0,17,17
ReReading Wolfe,0,0,1,0,18,19
Dreamful Bedtime Stories,1,2,3,3,26,35
Dungeons of Drakkenheim,0,0,0,1,17,18
1 Insight,0,0,0,0,7,7
The Jewish Lives Podcast,0,0,1,0,13,14
GameSpot After Dark,0,1,1,0,14,16
Matt McCall's Moneyline,0,0,0,0,2,2
All About The Jersey: for New Jersey Devils fans,1,0,0,0,2,3
Conta Pra Mim?,0,0,0,0,6,6
The Lawyer's Escape Pod,0,0,0,0,2,2
Useful Idiots with Matt Taibbi and Katie Halper,42,23,25,22,388,500
George's Random Astronomical Object,0,0,0,0,1,1
A Legitimate Salvage (The Expanse),1,0,1,0,2,4
A Voice From Darkness,1,0,1,0,48,50
The Hayseed Scholar Podcast,0,0,0,0,1,1
Jujutsu Kaisen Podcast ~Positive JuJu~,0,0,0,0,3,3
You're Buying A Home With Silas Lindenstein,1,0,1,1,20,23
Cosplay Gems,0,0,0,0,1,1
The Dollop - England & UK,2,0,2,2,44,50
Miles to Memories Podcast,3,1,1,1,41,47
The Eat for Endurance Podcast,0,0,0,0,7,7
The St. Canard Files: A Darkwing Duck Podcast,0,0,0,0,5,5
Peace and Parenting,0,0,0,0,50,50
The Devy Delight,1,0,0,0,4,5
Interpreting India,0,0,0,0,3,3
Bardstown,50,59,42,38,197,386
Perreo 101,0,0,0,0,11,11
Huddle Up with Gus,0,0,0,0,1,1
Being Unlimited,0,0,1,0,7,8
JMO Podcast,1,0,1,1,1,4
The Lensrentals Podcast,0,0,0,0,9,9
Mindhunter,0,0,0,1,3,4
That Song From That Movie,0,0,0,0,16,16
The Imperfects,0,1,1,2,74,78
Disaster Girls: A Podcast About Disaster Movies,2,0,0,0,31,33
TLP Podcast For Dentists,0,0,0,0,43,43
Too Scary; Didn't Watch,3,0,3,4,69,79
The Thistle Scottish Rugby Podcast,0,0,0,0,1,1
Make Climate Cool Again,0,0,0,0,14,14
PorscheCooled Podcast,0,0,0,0,16,16
Stories of The Prophets,0,0,0,0,1,1
Jewish Inspiration Podcast · Rabbi Aryeh Wolbe,0,0,0,0,1,1
House Party Protocol,1,0,0,0,11,12
fit4life | fitgirl weekly chat,0,0,0,0,2,2
Wake Up America! Opening Monologues,0,0,0,0,12,12
Talking with the dogs!™,0,0,0,0,17,17
Dating Straight,2,2,1,3,461,469
talkSPORT Daily,1,0,0,0,1,2
Why Dad Drinks,0,1,0,0,2,3
The Bake Down - Bake Off Reviewed,1,0,0,0,30,31
The Soap Box with Austin Malleolo,0,0,0,0,2,2
By Order Of The: Peaky Blinders,5,2,2,3,19,31
LOST: Down the Hatch - A Spoiler Filled LOST Re-Watch,2,1,0,1,61,65
The Power Scaling Podcast,0,0,0,0,1,1
Happy Days Rested Nights,0,0,0,0,50,50
Plant Medicine Podcast with Dr. Lynn Marie Morski,0,0,0,0,17,17
Disney For Scores,0,1,0,0,29,30
The BBC Good Food podcast - Rookie & Nice,0,1,0,2,2,5
"Spill it, Sister! Reality TV recaps with Ally & Leah",0,0,0,1,27,28
GOLF's Fully Equipped,2,1,3,4,11,21
Shankcast - A Tennis Banter Podcast,0,2,2,17,106,127
Nashville Podcast,0,2,0,1,19,22
Fit Girl Magic | Healthy Living For Women Over 40,0,0,0,0,17,17
Heaux in the Kneaux,0,0,0,0,24,24
1619,16,0,0,3,31,50
The SwordCast,0,0,0,0,8,8
Petri Dish,0,0,0,0,13,13
CBS Radio Mystery Theater | Old Time Radio,0,0,0,0,10,10
Swiping Up,13,4,1,2,136,156
The Skorpion Show Podcast,1,0,2,0,47,50
The Subjective Truth,1,0,1,4,34,40
Bitcoin Rapid-Fire,0,0,0,0,22,22
Strong Runner Chick Radio,0,0,0,0,6,6
The Rich Redmond Show,0,0,0,0,53,53
Fantasy Football Factory,25,8,6,9,370,418
ALAB Series,2,0,2,0,84,88
The Freedom Friends,0,0,0,0,8,8
Fun City,0,0,0,0,10,10
Business Coaching Secrets,0,0,0,0,38,38
Preach,1,0,0,0,89,90
Trucking for Millennials,0,0,0,0,17,17
The Not So Straight and Level Podcast,0,0,0,0,2,2
Know Your Aura with Mystic Michaela,0,0,2,4,494,500
About Them Cowboys: a show about the Dallas Cowboys,1,1,1,0,11,14
Can't Wait: A show about the New York Jets,3,1,1,3,37,45
Hear That Podcast Growlin': A show about the Cincinnati Bengals,0,0,3,0,20,23
Five For Fighting Podcast,1,0,0,1,13,15
Class 1A: A My Hero Academia Podcast,0,0,3,0,7,10
Better Golf Academy: Strategy to Awesome Golf,0,0,0,0,11,11
From The Shadows,1,3,2,1,13,20
The Talent Tank,1,0,0,1,48,50
Journey Through Sci-Fi,0,0,0,0,5,5
Laughter for All Podcast with Comedian Nazareth,0,0,0,0,3,3
The Journey,0,0,0,0,1,1
Dead Sirius,0,0,0,0,6,6
The Women's Rugby League Podcast,0,0,0,0,11,11
D23 Inside Disney,2,2,6,2,28,40
The Morning Mess,1,0,0,3,13,17
Geoff Schwartz Is Smarter Than You,3,0,2,3,21,29
Maked Up Stories: Imaginative Kids Stories,1,1,0,0,48,50
The Tennis Tragic,0,0,0,0,3,3
Saved By The Pod,0,1,0,0,26,27
Finding Fred,57,14,14,16,361,462
Scared To Death,2,1,1,1,45,50
Millennial Investing - The Investor’s Podcast Network,0,0,1,2,60,63
Job Interview Coaching,0,0,0,0,4,4
Monster: The Zodiac Killer,8,11,7,6,16,48
The Kevin Sheehan Show,1,1,1,2,21,26
BMitch & Finlay,0,1,0,1,7,9
Family Road Trip Trivia Podcast,0,0,1,4,30,35
All Ages of Geek Podcasts,0,0,0,0,1,1
Spielman and Hooley,7,1,1,0,41,50
Haunted Hell House of Horror,0,1,0,0,5,6
The Chain: Protein Engineering Podcast,0,0,0,0,1,1
Cheaper than therapy,0,0,0,0,7,7
The Bikini and the Brain,1,0,2,1,38,42
Loam Listen,0,0,0,0,13,13
A Duchess Like Us,0,0,1,0,29,30
Broncos Country Tonight,25,0,0,0,10,35
The Fashionpreneur Diaries,0,0,0,0,18,18
The World of Intelligence,1,0,0,0,0,1
11 Personnel: A show about the Los Angeles Rams,2,0,0,1,29,32
The Andy Staples Show & Friends: A show about college football,9,3,7,3,27,49
The Athletic Fantasy Football Podcast,1,1,0,0,14,16
Rhythms for Life,0,1,2,2,182,187
Reality Gays: Trash TV and GayDD with Mattie and Poodle,27,5,1,1,456,490
Exposed: The Series,0,0,0,0,1,1
Fantasy Hour On Tap,0,0,0,0,4,4
Five Dirty Bikers,0,0,0,0,9,9
TWS with Angi B,0,0,0,0,3,3
Stitch Please,0,1,0,0,49,50
Beauty Marketing Simplified podcast,0,0,0,0,38,38
The Snatchelor,96,25,21,14,344,500
Dish City,1,1,1,0,22,25
That's What People Do,0,0,0,0,4,4
Latinx Intelligentsia,0,0,0,0,4,4
Prospects To Pros with Dane Brugler & Lance Zierlein,1,0,0,0,16,17
"Creativity, Spirituality & Making a Buck with David Nichtern",0,0,0,0,8,8
Flight Safety Detectives,4,3,1,1,29,38
Classical Breakdown,0,0,0,0,6,6
Breaking Up With Binge Eating,0,0,0,0,12,12
Steelers Blitz (Pittsburgh Steelers),1,0,0,0,20,21
The Football GM: a show about the NFL,1,1,0,0,2,4
Wicca Level 1: Witchcraft for Beginners,0,0,0,1,0,1
godless longganisa,0,0,0,0,1,1
Talkin’ Shiz,0,0,0,0,47,47
Surviving Narcissism - Narcissist Rehab,1,2,1,1,32,37
Cinema Recall,0,0,0,0,4,4
Real Hauntings Real Ghost Stories,0,0,0,2,30,32
Your Space Journey,0,0,0,0,2,2
Master Your Health Podcast,2,1,0,0,47,50
The Duck Farmer,0,0,0,0,5,5
Hygge Girls Podcast,0,0,0,0,8,8
Fright Night Minute,0,0,0,0,2,2
Big Mad True Crime,24,13,11,16,436,500
The Hunting Photographer,0,0,0,0,16,16
Functional Relations,0,0,0,0,4,4
The Kat Scan Podcast,0,0,0,0,27,27
The Vault: Classic Music Reviews Podcast,0,0,0,0,6,6
Unwasted: The Podcast,0,0,0,0,28,28
All Over Overland,1,0,0,0,5,6
Three Big Points,0,0,0,0,6,6
School of Manifestation,0,0,0,0,1,1
Fck This Place: The Jobs Podcast,0,0,0,1,7,8
I’ve Got a Secret! with Robin McGraw,10,1,4,1,39,55
Thriving Dog Pawcast,0,0,0,0,2,2
Minding Scripture,0,0,0,0,2,2
Sew-organised-style,0,0,1,0,0,1
Simplexity with Alyson Stoner,1,0,1,1,103,106
Things That Are Blank - Game Show,0,0,1,0,2,3
This Teacher Life,0,0,0,0,32,32
Watts Your Safeword,0,0,1,1,48,50
Front Nine Golf Podcast,0,0,0,0,1,1
Harmless Phosphorescence,0,0,0,0,1,1
"Knight Falls, CA",2,1,1,1,9,14
Trapped Under Plastic,0,0,0,3,25,28
Something for Nothing: A RUSH Fancast,0,0,0,0,29,29
Aquinas 101 - Course 1: Why Aquinas?,0,0,1,0,5,6
Neon Jezebel,0,0,0,0,3,3
Mysteries Of The Unexplained | Paranormal Podcast,0,1,0,0,17,18
WashingtonWise Investor,2,0,1,0,23,26
Let's Talk - Cobra Kai,0,0,3,0,14,17
Cincy Slangin’ Bearcat Sports Podcast,0,0,0,0,14,14
Winner Take All,0,0,0,0,13,13
Were You Raised By Wolves?,1,3,4,1,225,234
Kelly and Murray,6,5,0,10,162,183
The It's Time for Bed's Podcast,0,0,0,1,2,3
Murder in Oregon,22,19,25,31,182,279
The Fifth Hour with Ben Maller,4,0,1,0,90,95
The Bible for Kids Podcast,0,0,0,1,7,8
Spiced Chaos,0,0,1,2,12,15
The Fleabag Situation: A Fleabag Fan Podcast,2,1,0,1,38,42
Beauty IQ Uncensored,12,8,10,2,156,188
Backyard Gardens - Gardening for everyone,0,0,0,1,3,4
GRABS Podcast,0,0,0,0,6,6
Sources Say Podcast,2,2,1,1,31,37
Weeping Cedars,1,0,1,1,24,27
Blue face baby,1,1,0,0,0,2
"Norman's Rare Guitars, The Podcast",1,0,0,4,208,213
Home Space and Reason,0,0,0,0,15,15
United Stand Podcast,1,0,0,0,33,34
Bred to Perfection,0,0,0,0,2,2
Conversations with Kevin,0,0,0,0,2,2
The Woo Woo 'Verse,0,0,0,0,5,5
The Offside Rule: WSL Edition,0,0,0,0,14,14
Jared Dillian Podcasts,0,0,0,0,11,11
Crypto Marketing with Ty Daniel Smith | A Coinbound Podcast,0,0,0,0,4,4
The Two Onions podcast with Dani Daniels,1,2,1,0,16,20
BROKEN: Seeking Justice,0,2,8,2,14,26
The WindUp Podcast,0,0,0,0,7,7
The Ortho Show,0,0,0,0,2,2
MS Living Well: Key Info from Multiple Sclerosis Experts,0,0,0,0,8,8
Dry Powder: The Private Equity Podcast,0,0,0,0,9,9
Homebrewing DIY,0,0,1,0,2,3
Cult of the Clocktower,0,0,0,1,3,4
Breakfast with Vinnie!,0,0,0,0,21,21
The Vine Podcast,0,0,0,0,8,8
The Witch Daily Show,0,0,1,1,40,42
Talking Backwards: A Twin Peaks Podcast,0,0,0,1,6,7
Two Dollar Late Fee,0,0,0,0,25,25
The Leadership Locker,0,0,0,0,50,50
The Spark File with Susan Blackwell and Laura Camien,0,0,0,0,32,32
Cartoon Logic,1,0,0,0,9,10
Manage Mold,0,0,0,0,22,22
DEADLOCK: A Pro Wrestling Podcast,3,1,0,5,379,388
Energy Sense,0,0,0,0,2,2
Points South,0,2,0,0,6,8
The Social Kick Podcast,0,0,0,0,1,1
BunnyRanch Podcast,0,0,0,0,17,17
The Pitmaster's Podcast,0,0,0,0,35,35
Curious Kids Podcast,0,0,0,0,2,2
Occupy Me,0,0,0,0,1,1
Zane and Heath: Unfiltered,24,15,22,20,419,500
Diggin' Oak Island,0,0,0,0,53,53
PWC Connections: The Podcast,0,0,0,0,1,1
Home School'd Podcast,0,0,0,0,7,7
Focus on This,9,9,6,8,91,123
Gist Healthcare Daily,0,0,0,1,11,12
Worst Year Ever,65,25,32,20,160,302
The Coordinate: An Attack on Titan Podcast,0,0,0,0,3,3
Pack de Potes Rugby Podcast,0,0,0,0,1,1
The Adam Schein Podcast,0,0,0,0,8,8
The Folly Coffee Podcast,0,0,0,0,4,4
The Situation with Michael Brown,1,0,0,0,4,5
Monster Madness,1,1,0,1,10,13
Ten to the Fifteenth: The Official Podcast of the National Neuroscience Curriculum Initiative (NNCI),0,0,0,0,1,1
The Lost Drive-In,1,0,0,0,65,66
Brooklyn Zen Center Audio Dharma Podcast,0,0,0,0,2,2
Optophobia,0,0,0,0,4,4
Yoga from the Source,0,0,0,0,3,3
BIN Radio,0,0,1,0,24,25
Talkin' Trader Joes,0,0,0,0,12,12
She's Just Getting Started™ - Tips for starting a business & making money doing what you love,1,0,0,0,41,42
Listen Hunnay with Jeannie Mai,3,1,8,6,163,181
Today in PA | A PennLive daily news briefing with Claudia Dimuro,0,0,1,0,19,20
Of Course You Realize THIS Means Podcast - A Looney Tunes Discussion,0,0,0,0,3,3
Steroids Podcast - Real Bodybuilding Training Diet and Supplementation Science for Muscle Building,3,0,0,0,47,50
Evolve 2 Pagan Podcast,1,0,0,1,7,9
Brave New World,0,0,0,0,1,1
The Dan John Podcast,0,0,0,0,23,23
Watchmen Watch,1,0,0,3,8,12
Peak Endurance,0,1,0,0,1,2
Network Marketing Breakthroughs with Rob Sperry,0,0,0,0,19,19
Penguin Magic Podcast,0,0,0,0,6,6
Over 40 & Faded,0,1,0,0,14,15
PMP Exam Success Secrets with Scott,3,0,0,0,25,28
Better with Dr. Stephanie,1,0,0,0,43,44
Visible,0,0,0,0,3,3
MOONFACE,0,2,0,0,48,50
The Hank Haney Podcast,9,0,2,4,57,72
The Andy Pollin Hour Podcast,1,0,0,0,1,2
Recode Daily,11,8,6,6,117,148
Super Carlin Brothers,0,0,0,1,46,47
5 Second Rule,0,0,1,1,0,2
Long May They Run,0,1,3,2,44,50
Demolisten,0,0,0,2,25,27
Friends From Work,0,0,0,1,64,65
Excuse Me: The Vickie Guerrero Show,0,0,1,0,10,11
The Daily Space,0,1,0,0,8,9
KINGS OF THE PODCAST ™️,1,0,2,2,16,21
See America,0,0,0,0,19,19
Onto Waveland: A show about the Chicago Cubs,1,0,2,2,6,11
755 Is Real: A show about the Atlanta Braves,1,1,2,2,21,27
Keep 'em Nude: The story of the 99ers,0,0,0,0,1,1
Not Neurotypical w/ Laura Zdan,0,0,0,0,20,20
Flip The Script,0,0,0,0,61,61
BallTalkers Podcast,0,0,0,0,1,1
Ben Rimalower's Broken Records,0,0,0,0,11,11
Camp Monsters,0,0,1,3,46,50
The Thing About Pam,6,2,20,10,146,184
Correct Opinions with Trey Kennedy,1,1,1,1,46,50
Cryptids,0,1,0,4,42,47
Ryzzun Energy,0,0,0,0,5,5
Making Sense of Pets,0,0,0,0,2,2
Pharmacy to Dose: The Critical Care Podcast,0,1,0,2,8,11
The Things We Do,2,0,0,0,92,94
Eat Your Spanish: A Spanish Learning Podcast for Kids and Families!,2,0,0,1,47,50
"It's Fine, I'm Fine",7,0,1,0,42,50
City Ballet The Podcast,0,0,1,0,6,7
The Book of Life and Living with Reb Mimi Feigelson,0,0,0,0,1,1
Storybound,5,4,6,5,30,50
The Q & A with Rabbi Breitowitz Podcast,0,0,0,0,2,2
Kosmographia,0,0,1,3,50,54
What The HR! TCSHRM HR Podcast,0,0,0,0,13,13
The Universe Speaks in Numbers,0,0,0,0,2,2
Inspire Health Podcast,0,0,0,1,4,5
The Continuing Adventures of John Blade: Super Spy,0,0,0,2,0,2
The Edge of Sleep,2,1,2,4,41,50
NinosCorner™ Podcast,0,0,0,0,1,1
Scam Goddess,0,1,3,1,45,50
Law X.0,0,0,0,0,1,1
Past Gas by Donut Media,0,1,3,3,43,50
Dr. Finlayson-Fife's Podcast Archive,1,0,2,0,29,32
Listed,0,0,1,0,6,7
Sean Oliver's Kayfabe Podcast,1,0,2,1,15,19
Monsters Vs Men,0,0,0,0,17,17
Formula 1 Grid Talk Podcast,0,0,2,0,1,3
NHL @TheRink,1,1,0,1,13,16
Gap Time,0,0,1,2,6,9
And Now The Hard Part,1,1,1,0,7,10
The Best Little Horror House in Philly,0,0,0,0,23,23
Those Who Were There: Voices from the Holocaust,0,0,0,0,9,9
Puppy Training Principles,0,0,0,0,2,2
Babel: Translating the Middle East,0,0,0,0,5,5
The Razor's Edge,1,0,1,0,8,10
Another Marvel Podcast,1,0,0,0,3,4
The Jasmine Star Show,0,0,0,4,196,200
Dingers - The only fantasy baseball podcast for smart people,1,0,0,0,8,9
The Pharm So Hard Podcast: An Emergency Medicine and Hospital Pharmacy Podcast,0,0,0,0,2,2
Harbor,0,0,0,0,14,14
The Influential Personal Brand Podcast,0,0,0,3,127,130
Jetlagged ✈️,0,0,0,0,1,1
A Psychic's Story,0,0,0,1,12,13
"""The Dirt"" Trailrunning Podcast",0,0,0,2,22,24
The AMA Podcast,0,0,0,1,8,9
The Creeping Hour,2,4,3,6,35,50
War & Peace,0,0,0,0,2,2
The Culling,0,1,0,0,4,5
The Gemini Scorpio Podcast,0,0,0,0,3,3
Good Talk with Anthony Jeselnik,1,0,0,1,16,18
meteorologyIRL,0,0,0,0,1,1
Grand Master Level Podcast,0,0,0,0,2,2
Unleashed,0,0,0,0,2,2
Mohammed Hijab,0,0,0,0,3,3
The Thorne Podcast,0,0,0,0,1,1
My Life of Crime with Erin Moriarty,6,3,5,8,34,56
Brad & Will Made a Tech Pod.,3,2,1,2,68,76
Recovery Dharma Audiobook,0,0,0,0,1,1
Jay and Dave's Sports Bar,0,0,0,0,4,4
Creative Therapy Umbrella,0,0,0,1,16,17
All Through a Lens: A Podcast About Film Photography,0,1,1,0,9,11
A Moment In Crime,1,2,1,0,2,6
None But The Brave,0,0,0,0,16,16
Hey It's Enrico Pallazzo Fantasy Baseball,0,0,0,1,19,20
You're Dead To Me,0,3,3,9,177,192
“The Horror Cast” Intelligent Horror Movie Discussion,0,1,0,0,12,13
The Aquarium Guys,2,1,1,1,14,19
2 for 1 Drafts,1,0,1,1,497,500
Central Synagogue Podcast,1,0,0,0,0,1
Rick & Bubba University Podcast,2,0,2,0,68,72
Notes from the Backpack: A PTA Podcast,1,0,0,0,26,27
The Mysterious Mr. Epstein,64,39,49,47,208,407
Business Casual,31,19,23,12,115,200
A Date With The Bake,3,1,2,1,143,150
Encouraged with Celebrate Kids,0,0,0,0,16,16
Youre The Man Now Dog,0,0,0,0,44,44
Goddess Confessions,0,0,0,2,47,49
The Construction Life,0,0,0,0,11,11
Growing Microgreens Podcast,0,0,0,0,1,1
The Cut,2,0,0,1,25,28
Pali audio,0,0,0,0,2,2
The Mr. Bill Podcast,0,2,0,1,46,49
LIFE WITH AN ESTHETICIAN,0,1,0,0,0,1
Songbirding,0,0,0,0,7,7
The Kaiju Apostle Podcast,0,0,0,0,12,12
Bible Stories for Heathen Children,0,0,0,0,4,4
Used Car Dealer Podcast,0,0,0,0,1,1
Sample Excavator,0,0,0,0,15,15
What's in the Basket,0,0,0,0,4,4
Kosher Queers,0,0,0,0,7,7
Classic Ghost Stories,0,0,0,0,27,27
The World Rugby Podcast,0,0,0,0,1,1
God for Grownups,0,0,0,0,3,3
The IcePod,0,0,0,0,2,2
The Ray & Dregs Hockey Podcast,1,2,0,1,16,20
The Great Women Artists,0,0,0,2,27,29
Handyman Pros Radio Show,0,0,0,0,4,4
Your Own Backyard,3,8,9,12,468,500
Hunting Warhead,1,1,6,9,273,290
VMP Anthology,0,0,0,0,1,1
Inevitable Change✨,0,0,0,0,1,1
Today in Digital Marketing,0,0,0,0,21,21
"Fight Hustle, End Hurry",0,3,4,7,74,88
Facing Fate,1,0,0,0,4,5
Bigger Than Us,0,0,0,0,5,5
Sin Llorar,0,0,1,0,17,18
Office Ladies,35,63,105,56,1008,1267
Taking Sides with The Dashleys,0,0,1,3,406,410
Lone Star Outdoor Show,0,0,0,0,7,7
90 Day Fiance Mmkay,1,0,2,3,10,16
Aquinas 101 - Course 2: Introduction to Thomistic Philosophy,0,0,0,0,4,4
The Ever Evolving Truth,9,4,13,5,18,49
Inside College Soccer,0,0,0,0,4,4
Mija Podcast (French),0,0,0,0,2,2
Mija Podcast (Spanish),0,0,0,0,5,5
Mija Podcast (English),0,0,0,0,9,9
Badass Women at Any Age,0,0,1,0,1,2
Cursed Podcast,0,0,0,0,34,34
Comedians with Ghost Stories,0,0,0,1,20,21
The Leader | Evening Standard daily,0,0,0,1,0,1
Elon Musk Pod,1,0,0,0,1,2
The Adventures of Ben Squared,0,0,0,0,4,4
On The Brink with Castle Island,0,0,0,0,36,36
Women Rocking Real Estate Podcast,0,0,0,0,16,16
Football & Grits: A daily podcast about SEC football,2,0,0,1,8,11
Shelf Love: Romance Novels Unpacked with Love,0,0,0,0,16,16
Financially Free Journey,0,0,0,0,30,30
Rude Tales of Magic,0,0,0,2,48,50
She Reads Truth Podcast,2,1,2,5,201,211
Andrea Savage: A Grown-Up Woman #buttholes,0,0,0,0,50,50
Bowmar Show,4,0,0,0,46,50
Learn to Paint Podcast,0,0,0,0,6,6
POLITICO Energy,2,0,0,3,5,10
Locked On Bruins - Daily Podcast On The Boston Bruins,3,1,1,1,19,25
The Vicious Circle Podcast,0,0,0,0,5,5
Cry Power Podcast with Hozier and Global Citizen,0,0,0,0,25,25
Three of Seven Podcast,0,0,0,0,50,50
The Life Boss Podcast,1,1,0,1,21,24
Breaching Extinction,0,0,0,0,2,2
The Naughty Dog Podcast,0,0,0,0,2,2
Pro-Fit Golf Conditioning Podcast,0,0,1,0,4,5
Lisa A Romano Breakdown to Breakthroughs,0,0,0,0,20,20
RIDE AND TALK - THE BMW MOTORRAD PODCAST,0,0,0,0,2,2
Strength Training For Cyclists - Dialed Health,0,0,0,0,48,48
Urgency of Change - The Krishnamurti Podcast,0,0,0,0,9,9
Deep Dive with the Institute for Justice,0,0,0,0,2,2
ARN,10,6,7,6,161,190
Protect Your Noggin,0,0,0,0,12,12
Joyful Marketing,1,0,0,0,41,42
SKinFolk,0,0,0,0,6,6
Chasing Giants with Don Higgins,3,0,0,1,50,54
Iron-On Wrestling with Gregory Iron,0,0,0,1,21,22
Raw Truth: Stories of Female Infidelity,0,0,0,0,11,11
What Would Jamie Do?,0,1,0,2,233,236
Soul Soil: Where Agriculture and Spirit Intersect with Brooke Kornegay,0,0,0,0,9,9
Locked On Blackhawks - Daily Podcast On The Chicago Blackhawks,1,3,2,3,24,33
Inside the Admissions Office: Advice from Former Admissions Officers,0,0,0,0,15,15
Finding Your Purpose,0,1,0,1,19,21
Sundays With Cate,0,0,2,1,7,10
Happy as a Mother,0,0,0,0,50,50
Squawk Pod,4,3,1,2,28,38
The Anxious Achiever,1,0,1,0,25,27
Reppin,0,0,0,0,11,11
The Strange Harbors Podcast,0,0,0,0,18,18
"HELLO HOLLY – the podcast about interior, trends and friends",0,0,0,0,9,9
BodhiHeart Podcast with Khenpo Sherab Sangpo,0,0,0,0,1,1
Stamp With Us,0,0,0,0,2,2
Theory & Philosophy,0,1,0,0,10,11
The Good-Good Golf Podcast,0,0,0,0,2,2
Six Figure Authors,0,0,1,1,45,47
Clearstory,0,0,4,2,44,50
Lecture Breakers,1,0,0,0,2,3
Listen To This While You Shit,0,0,0,0,5,5
The Tower,1,0,0,2,10,13
The Uncensored Podcast with Tumbo & Black Moses,0,0,1,0,10,11
Legends Only - A Pop Culture Podcast,2,0,1,1,81,85
Curator on the Go Podcast,0,0,0,0,3,3
Blerdy Talk,0,0,0,0,3,3
Following The Leftovers,1,0,0,0,4,5
Friends Watching Friends Podcast,5,0,1,1,17,24
Locked On Canadiens - Daily Podcast on the Montreal Canadiens,0,0,0,0,3,3
Demystifying Gay Porn,0,1,0,0,3,4
Historias de cama,0,0,0,0,5,5
Mommy Labor Nurse,0,3,1,0,35,39
The Breaks – KUTX,0,0,0,0,5,5
Telemundo Deportes,0,0,0,0,5,5
From Scratch with Michael Ruhlman,0,1,0,1,14,16
The Hacker Next Door,0,0,0,0,3,3
Hacking Your ADHD,0,1,0,1,28,30
John Oliver Podcast,11,1,2,0,2,16
Posse de Bola,0,0,0,0,4,4
Mythical Monsters,4,3,6,3,34,50
Creepy Pasta Myths,4,0,0,0,28,32
Volunteer Plain Talk,0,0,0,0,1,1
Sue Perkins: An hour or so with...,7,2,2,2,87,100
LEAVE YOUR MARK,0,0,0,0,83,83
15 Hour Sound Machines (no loops or fades),1,1,3,0,11,16
Graced Health,0,0,0,0,13,13
Locked On Sharks - Daily Podcast On The San Jose Sharks,2,0,0,1,10,13
Locked On Ducks - Daily Podcast On The Anaheim Ducks,0,1,0,0,4,5
Go Rangers Radio,0,1,0,0,13,14
American Elections: Wicked Game,16,4,1,3,26,50
Locked On Golden Knights - Daily Podcast On the Vegas Golden Knights,1,1,0,0,6,8
Thrillist Explorers,3,0,1,0,45,49
Who Is?,35,9,8,4,45,101
Proverbial,0,0,0,2,15,17
The Jerry Lawler Show,0,0,0,0,25,25
The Weekly Knightly Podcast - by Vegas Golden Knights Fans,2,0,0,1,2,5
Steministas,0,0,0,0,2,2
Serious Angler - Bass Fishing Podcast,0,0,0,0,6,6
Better: The Brand Designer Podcast,0,0,0,0,17,17
Sissy That Pod,0,0,0,0,2,2
Comedians on South High,0,0,0,0,4,4
Locked On Kings - Daily Podcast On The Los Angeles Kings,1,0,1,0,1,3
Climate Changers,0,0,0,0,3,3
clean. simple. free,1,0,2,1,25,29
Dolly Parton's America,10,4,10,2,118,144
Among the Jungle Podcast,0,0,0,0,14,14
Laz and Powers: A show about the Chicago Blackhawks,0,0,0,0,4,4
Wings for Breakfast: A show about the Detroit Red Wings,0,0,2,0,8,10
No Sleep Til Belmont: A show about the New York Islanders,1,0,0,0,6,7
Straight From The Source with Michael Russo: A show about the Minnesota Wild,0,0,2,1,4,7
Austin Headline News Express,0,1,2,2,3,8
The Property Academy Podcast,0,0,1,1,39,41
The Graham Stephan Show,1,1,0,0,10,12
The Profitable Website: Digital Marketing Secrets For Small Business Success,0,0,0,0,27,27
Scarred For Life,0,0,0,2,50,52
Anime Trap House,0,0,0,0,2,2
Conversations with Charlie,0,0,0,0,2,2
Cam & Strick Podcast,2,1,2,3,32,40
Chemist Confessions,1,1,2,2,6,12
AoS Coach,0,0,0,0,1,1
Locked On Penguins - Daily Podcast On The Pittsburgh Penguins,0,0,0,0,4,4
The Baseball Prospectus Podcast Network,0,0,2,0,2,4
HawgBeat Pods,0,0,1,0,3,4
Sexduction Academy (SEX TABLE TALK),0,0,0,0,7,7
The Lion’s Roar Podcast,1,0,0,0,8,9
Not Lukewarm Podcast with Deanna Bartalini,0,0,0,0,4,4
Talking Stuff: Ohio State Recruiting Podcast,0,0,1,0,18,19
Wu-Tang: The Saga Continues,0,0,0,0,4,4
Smart Tech Today (Audio),0,0,1,0,6,7
Talking Home Renovations with the House Maven,0,0,0,0,6,6
Brave Knitting,0,0,0,0,1,1
Alpha Trader,1,1,1,3,3,9
TRIVIA TIME,2,1,1,1,39,44
Paul Graham's Essays by Listle,1,0,0,0,0,1
The Leo & Danny Show,4,1,0,0,37,42
The Fangirl Business,0,0,0,0,4,4
Grits and Grinds: Memphis Grizzlies,1,1,1,0,5,8
This is The Goods,0,0,0,0,2,2
The Top 100 Games Podcast,0,1,0,1,28,30
The Living Easy Podcast,0,1,0,5,445,451
Behind the Horns,0,0,0,0,3,3
Air Force Handbook 1,0,0,1,1,0,2
I'd Buy That For A Dollar,0,0,0,0,7,7
DIESEL SHOP TALK PODCAST,0,0,0,0,1,1
Catch The Fever Fishing Podcast,0,0,0,0,1,1
Red Carpet Rendezvous,0,0,1,0,24,25
Football Today,0,0,0,0,9,9
Locked On Sabres - Daily Podcast On The Buffalo Sabres,1,0,2,0,3,6
Primary Care Pod,0,0,0,0,4,4
I Did Not Sign Up For This,0,0,0,0,3,3
Tales from the Moosiverse,0,0,0,0,11,11
Talking Scripture,1,1,4,0,79,85
Rice To Meet You,1,0,2,1,46,50
The Secret Life of Prisons podcast,0,0,0,0,1,1
Fault Lines,1,0,0,0,3,4
Mockery Manor,0,1,0,2,16,19
The Engineering Leadership Podcast,0,0,0,0,3,3
Castaway,1,1,1,0,58,61
Planthropology,0,0,0,0,23,23
Locked On Fantasy Hockey,0,0,0,0,13,13
Running the 615,0,0,0,0,12,12
Full Story,9,2,10,8,65,94
The Shape of Care,0,0,0,0,3,3
The Next Big Idea,9,6,11,7,51,84
Crypto News Alerts | Daily Bitcoin (BTC) & Cryptocurrency News,2,3,2,4,96,107
The Well Grand Rapids,0,0,0,0,1,1
Why It Matters,9,0,1,3,44,57
"Me, My Demon, and I",0,0,0,0,13,13
Ovinology,0,0,0,0,1,1
Little Steven's Underground Garage - Coolest Conversations,0,0,0,0,1,1
Questionable Material with Jack & Brian,0,0,0,2,39,41
Teen Talk!,1,0,1,1,8,11
Honey Sex Talk,0,0,0,0,2,2
Beg to Differ with Mona Charen,4,1,5,4,36,50
Tour Stories,0,0,0,0,2,2
Bobby Approved - The FlavCity Shopping Experience,0,0,1,0,26,27
Transformations Through Running,0,0,0,0,12,12
The History of American Slavery,7,7,4,2,9,29
Culture Gabfest,4,0,1,3,6,14
Ted & Tempany Talk Sex,0,0,0,0,4,4
Scouting The Refs Podcast,0,0,0,0,1,1
Extra Napkins Podcast,0,0,0,0,37,37
The Music Podcast for Kids!,0,0,0,0,4,4
Crypto Ballers : NBA Top Shot Podcast,3,0,0,0,140,143
Spilling the G&T: Rupauls Drag Race,0,0,0,1,5,6
The Second Oil Age,1,4,8,5,24,42
On The Gold   Prospecting 2 Mining with Kevin Hoagland,0,0,0,0,3,3
Back In The Closet - Two Crazy Cat Ladies,0,0,0,0,2,2
The Streaming Wars,0,1,0,1,0,2
I Spy,6,6,2,8,136,158
Brian Lehrer: A Daily Politics Podcast,6,1,2,2,17,28
Hands-On Photography (Video),0,0,0,0,18,18
Talk Dead To Me,2,1,1,1,13,18
GeeGo Live,0,0,0,2,5,7
The Attaway Appeal,2,0,2,2,16,22
Tackle Talk - Bass Fishing Podcast,1,0,0,0,21,22
Tomorrowland Friendship Mix,0,0,0,1,1,2
Margaritas & Donuts,0,0,0,1,13,14
Divine Destiny with Latoya,0,0,0,0,4,4
QuizzleMania: A Wrestling Comedy Quiz Show!,0,0,0,0,1,1
Locked On Flyers - Daily Podcast On The Philadelphia Flyers,2,0,0,0,3,5
The Record Store Day Podcast with Paul Myers,0,1,1,0,14,16
Culture First,0,0,0,0,8,8
Inside a Sinister Mind,0,1,0,1,30,32
Voices In Validation,0,0,0,0,1,1
We Don't Deserve Dogs,0,0,1,1,48,50
The Vets Unleashed,0,0,0,0,17,17
With Caulk and Candles,0,0,0,0,2,2
The SoccerWire Podcast,1,0,0,0,1,2
Beyond The Beat,0,0,0,0,1,1
On the Ground with Samaritan's Purse,0,0,0,0,26,26
DailyTekk AfterParty,0,0,0,0,9,9
Defiance,0,0,0,1,29,30
Squawk Ident - An Aviation Podcast,0,0,0,0,5,5
Gutting the Sacred Cow,1,0,0,4,138,143
The Todd Starnes Show,5,1,2,0,30,38
Gen Z Girl,1,0,0,0,49,50
Minecraft explained: the mobsters,9,2,4,2,8,25
FULCRUM News - USA and Global Top News Updates,6,0,0,0,25,31
The Utah UAP Podcast,0,0,0,0,1,1
Short Wave,10,4,14,6,164,198
Third Eye Awakening,0,0,0,0,15,15
Making The Impact - A Dance Competition Podcast,0,0,1,0,49,50
CBG Radio,0,0,1,0,0,1
Jimmy Eat Pod,1,0,1,0,8,10
The Batwoman Podcast,1,0,1,0,3,5
"UNEWS, Top stories for U.S. Latinos in English",0,0,0,0,1,1
Kim Komando Daily Tech Update,0,0,0,0,1,1
6 Feet Above with Megan Armstrong,0,0,0,0,9,9
Locked On Capitals - Daily Podcast On The Washington Capitals,4,2,0,0,13,19
The Basketball&Barbells Podcast,0,0,0,1,2,3
The VSiN Market Insights Podcast with Josh Appelbaum,3,0,0,0,22,25
The Human Risk Podcast,0,0,0,0,3,3
DUST,0,1,2,5,42,50
ESPN Daily,43,12,13,24,364,456
Our Line Starts,1,1,0,1,6,9
Shamayim: Jewish Animal Advocacy,0,0,0,0,1,1
Straighten Your Crown,0,0,0,1,8,9
The Stationery Cafe,0,0,3,0,15,18
Academy Football Network Podcast,0,0,0,0,1,1
A to Z Running,0,0,0,0,20,20
Fait main,0,0,0,0,1,1
Waddle & Silvy,2,1,1,0,10,14
Kap & J. Hood,10,3,0,1,8,22
Carmen and Jurko,0,1,0,0,2,3
Bleck & Abdalla,0,0,0,0,7,7
John Jastremski,0,1,0,1,0,2
Motivational Speakers,0,0,0,0,1,1
So Bad It's Good with Ryan Bailey,17,1,5,6,276,305
A Las Carreras,0,0,0,0,1,1
Bad Batch,37,38,61,45,232,413
REACH - A Podcast for Executive Assistants,1,0,0,2,18,21
Run The Riot Podcast,0,0,0,0,17,17
Former Adventist,2,1,0,0,21,24
Bryan Air,0,0,0,0,2,2
Chasing Poker Greatness,0,0,0,0,29,29
EstheticianOnTheEdge,0,0,0,0,63,63
The Animatics Podcast,0,0,0,0,1,1
Humanity's Team Podcast with Steve Farrell,0,0,0,0,4,4
11:11,0,0,0,0,3,3
COMPLEXITY,0,0,1,0,15,16
Scrub Caps & Sippy Cups,0,0,0,0,27,27
STORIES FOR KIDS,0,0,0,0,2,2
Tag Team Pokemon TCG Podcast,0,0,0,0,6,6
Nothing Personal with David Samson,15,5,1,5,402,428
Are UFO Real?,2,2,1,0,13,18
Following Harriet,0,0,0,1,44,45
Unstuck | Mindset • Energy • Business • Life,1,0,0,0,40,41
Guy Kawasaki's Remarkable People,3,2,3,0,133,141
The Godly Dating 101 Podcast,2,1,1,6,490,500
Consider This,0,0,0,0,3,3
Beat Check with The Oregonian,0,0,0,0,6,6
Just Get Fit with Nikki,0,0,0,2,48,50
The Perspectives Podcast,0,0,0,0,10,10
PCOS Fighters - Weight Loss Method,0,0,0,0,1,1
BTS Happy Hour,0,0,0,0,1,1
Animation Happy Hour,0,0,0,0,20,20
Play No Games Podcast,0,0,0,0,6,6
Dublin Murders,6,0,0,0,2,8
Greeking Out from National Geographic Kids,1,0,0,6,43,50
WWE After The Bell with Corey Graves,24,8,8,10,293,343
Locked On NHL - Daily Podcast On The National Hockey League,1,0,0,1,4,6
PMU School: A Podcast For Artists by Artists,0,0,0,0,15,15
The SXS Guys Offroad Podcast,0,0,0,0,3,3
Zero Hours,6,5,1,1,37,50
Full Body Chills,2,1,2,2,43,50
The Melt Podcast,0,0,0,0,6,6
ShrinkChicks,0,0,0,3,30,33
Business of Tech,0,0,1,0,1,2
Hollinger & Duncan NBA Show - NBA Basketball Podcast,12,4,5,5,91,117
Game Notes: A Show About The Utah Jazz,0,0,0,0,11,11
Good Morning From Hell,2,3,0,1,44,50
Radio Rental,5,7,10,23,455,500
It was a Thing on TV:  An Anthology on Forgotten Television,0,0,0,0,3,3
Bewitched Crafts with Tracy Miller,0,0,0,0,2,2
That's in the Bible,0,0,0,0,5,5
» Divine Intervention Podcasts,1,0,0,0,15,16
Setting the Tone: An ER Retrospective,0,0,0,1,4,5
Storytime with Tula Jane and her Mother In The Wild,0,0,0,0,3,3
Science Rehashed,0,0,0,0,25,25
Onsite!,2,0,0,0,1,3
A Cricketing View,0,0,0,0,1,1
The Brandon Adams Podcast,1,0,0,0,10,11
SONDHI TALK,0,0,0,0,2,2
Shooters Gotta Shoot,0,1,1,3,226,231
Learning Bayesian Statistics,0,0,0,0,1,1
Anything is Poddable: A Podcast about the Boston Celtics,2,1,1,1,19,24
Gaslight,12,14,11,5,8,50
The Forum Club: A Show About The Los Angeles Lakers,0,2,2,0,3,7
The Stack Overflow Podcast,1,1,0,1,0,3
Science of Reading: The Podcast,1,0,1,1,11,14
Nordic Mythology Podcast,0,1,0,0,26,27
Book of Basketball 2.0,34,11,15,21,383,464
Cannabis Science Today,0,0,0,0,7,7
Affirmation Meditation Podcast with Bob Baker,0,1,0,0,9,10
The Modern Homesteading Podcast,0,0,0,0,10,10
Keeping-Track,0,0,1,1,36,38
Sleeved Believe The Hype Podcast,0,0,0,0,9,9
Demon Slayer Podcast,0,0,0,1,0,1
No F'n Regrets with Robb Flynn,0,1,0,1,23,25
Internal Medicine For Vet Techs Podcast,0,0,0,0,28,28
All The Smoke,56,0,5,7,360,428
"Hoops, Adjacent with David Aldridge and BIG Wos",1,0,0,1,15,17
The Boys & Girl Podcast,2,0,3,1,25,31
Drake Hall Memphis,0,0,0,0,6,6
Wild,1,0,2,0,6,9
ASHPOfficial,0,0,0,0,1,1
What A Day,7,5,1,3,34,50
Criterion Channel Surfing,0,1,1,0,2,4
The Stream Scheme,0,0,0,1,5,6
The Greatest Game with Jamie Carragher,0,0,0,1,20,21
The Christian Single Moms Podcast,0,0,0,0,11,11
Basic Physics 101,1,0,0,0,0,1
Mid-Atlantic Championship Podcast,0,0,0,0,20,20
The Perfect Pup,0,0,1,0,2,3
RunChats with @RonRunsNYC,1,0,0,0,31,32
Ask Ronna,0,0,1,1,48,50
Hard Landings,0,0,1,0,4,5
Midwest Flyways Podcast,0,0,0,0,37,37
Locked On Devils - Daily Podcast On The New Jersey Devils,1,2,0,0,8,11
Me lo dijo Adela,0,0,0,0,1,1
Because I Can Life,0,0,0,0,50,50
Conversations With Abraham Hicks,1,0,2,1,5,9
FreightWaves LIVE: An Events Podcast,0,0,0,0,1,1
The Vibe,0,0,0,0,1,1
dj maphorisa's Podcast,0,0,1,4,27,32
Blxxk Anime,0,0,0,0,3,3
Driven Young,0,0,0,0,6,6
Full Chat - With MrJWW,0,0,1,0,5,6
Fandible: Warhammer 40k Actual Play,0,0,0,0,1,1
Locked On Rangers - Daily Podcast On The New York Rangers,0,1,2,0,3,6
Ledlow & Parker,1,0,0,1,32,34
Restaurant Hoppen,0,0,1,0,10,11
Spiritual Shit,0,0,0,0,43,43
The E3Rehab Podcast,0,0,0,0,3,3
Yo soy un Gamer,0,0,0,0,1,1
Now You Listen Podcast,1,0,0,0,2,3
Blood Ties,2,2,5,2,39,50
"Bye, Pumkin",0,0,0,0,50,50
Fox and Faust | LA Kings,0,0,0,0,4,4
Home Inspection Whisperer's Podcast,0,0,0,0,6,6
Mom Genes The Podcast,0,0,0,0,26,26
MOOD with Lauren Elizabeth,119,33,23,23,247,445
Knight Light: A Horror Movie Podcast,3,1,0,0,26,30
The Financial Confessions,5,7,8,5,28,53
American Roots Outdoors w/ Alex Rutledge,0,0,0,0,41,41
The Q Files,0,0,0,0,19,19
Welcome to the Uncharted Territories,0,0,0,0,1,1
That's Incredible,0,0,0,0,3,3
Did I Stutter?? with Drew Lynch,3,0,2,2,43,50
Out of Touchstone,0,0,0,0,2,2
Kids Short Stories,0,0,2,1,47,50
Sam Miller Science,0,0,0,0,50,50
Books Unbound,0,1,4,0,27,32
Weekly Spooky - Scary Stories to Keep You Up at Night,0,0,0,2,8,10
14 Days with Felicity,5,1,2,0,31,39
How to Get Over Your Ex,1,0,3,1,66,71
The Fraudcast: A 90 Day Fiance Podcast,91,40,19,10,215,375
Quantitude,0,0,0,0,7,7
Activist #MMT - podcast,0,0,0,0,2,2
Boomtown,8,10,16,23,312,369
Daily Pop,11,2,4,3,17,37
Nightly Pop,1,0,0,0,13,14
Crying at the Bar,0,0,0,0,1,1
Hunted,3,5,8,3,31,50
The Block Party with Seth Kushner,4,0,0,2,70,76
Political Scandals,13,5,7,4,21,50
The Art Angle,0,0,1,1,13,15
The Product Agent: Hurry Up and Wait,0,0,0,0,2,2
Coexistence,0,0,0,0,6,6
Inside the Musician's Brain,0,0,1,0,22,23
Multiclass Theater,0,0,0,0,8,8
Playmaker's Corner,0,0,0,0,3,3
Cautionary Tales,28,42,35,21,742,868
Crazy Over Easy,1,0,0,0,49,50
The Back Porch,4,0,0,0,7,11
Uncovered by WDRB News,1,0,0,0,2,3
Big Apple Buckets: A NY Knicks Basketball Podcast from New York Post Sports,1,0,1,1,15,18
Just The Sip,3,0,0,2,45,50
Dear Alice | Interior Design,3,4,5,6,182,200
Home Team with Sophie Julia,7,0,1,0,32,40
Urge to Kill,13,10,18,14,142,197
The Bat Boys: A Valencia CF Podcast,0,0,0,0,5,5
Lunch Club Podcast,2,0,1,3,43,49
The MinnMax Show,1,0,1,2,46,50
Sermon Spotlight,0,0,0,1,1,2
Digital Marketing Daily,1,0,0,0,1,2
Body by Being Podcast by JoaFitness,0,0,0,0,23,23
Angler's Happy Hour,0,0,0,1,67,68
True Consequences,0,1,3,0,59,63
Get Started Investing,0,0,0,0,32,32
Listen Now with Matt and Sam,0,0,0,0,7,7
Susan Nethercote Studio Insider Art Podcast,0,0,0,0,4,4
Live Your Life Kween Podcast,0,0,0,0,36,36
Rebel Performance Radio,0,0,0,0,2,2
Preds Insiders,0,0,0,0,1,1
Politics War Room with James Carville & Al Hunt,6,5,6,14,199,230
Relaxing Literature,0,0,0,0,2,2
Columbia House Party,0,0,0,0,2,2
xoNecole's Happy Hour,1,0,0,3,78,82
The XC Podcast,0,0,0,0,2,2
Ghost Stories: A Podcast By Hinge,4,6,3,8,43,64
Ones Ready,0,0,0,0,50,50
The Bill Bert Podcast,15,5,5,0,25,50
The Spouse Angle,2,0,0,0,8,10
Stupid Fat Hobbits,0,0,0,0,17,17
Beyond The Bump,0,0,1,0,89,90
The Official Manchester United Podcast,0,1,0,1,22,24
La pelota al que sabe,0,0,0,0,1,1
IS: Off the Page,0,0,0,0,2,2
The Mighty Metahumans,0,0,0,1,21,22
How’s My Hand Path?,0,0,0,0,13,13
The Reason Interview With Nick Gillespie,1,0,1,2,23,27
The Soho Forum Debates,0,0,0,2,7,9
The Fed and Fearless Podcast,0,0,0,0,5,5
Variant: The Podcast,1,1,3,0,20,25
The Official Watchmen Podcast,6,1,4,1,67,79
The Healthy Rebellion Radio,2,0,2,1,45,50
Rubicon: The First Hundred Days of the Biden Presidency,12,2,4,9,35,62
The Old Soul Movie Podcast,0,0,0,0,9,9
This Week in Neuroscience,0,1,0,0,0,1
Women and Crime,17,5,13,15,181,231
FreightCasts,0,0,0,0,8,8
Simple Homeschool,0,0,0,0,21,21
Bow Down: Women in Art,0,0,0,0,6,6
6 Minute Siddur Snippets,0,0,0,0,1,1
The Ed Bassmaster Podcast,2,0,1,0,46,49
Pink Milk,0,0,0,0,15,15
Talking Mopars,1,1,0,0,16,18
Georgie Romero Is Done For,0,0,0,0,10,10
BatChat,0,0,0,0,1,1
4biddenknowledge Podcast,1,0,0,0,6,7
The HomeGirls,0,0,0,0,2,2
THE AUTISM ADHD PODCAST,0,0,0,0,11,11
Two Guys Garage Podcast,0,0,0,0,5,5
Litocast,0,0,0,0,3,3
Green Light with Chris Long,11,3,5,8,335,362
After Midnight: Phish's Big Cypress Festival,0,0,1,0,28,29
Locked On Islanders - Daily Podcast On The New York Islanders,0,0,0,0,4,4
Feminist Survival Project 2020,0,0,0,0,29,29
Irish Breakdown,9,1,1,4,18,33
The Vet Tech Cafe's Podcast,0,0,0,0,3,3
Dimension 20,0,0,0,0,27,27
Titus & Tate,7,5,3,8,475,498
Talkin' Nets,1,1,0,0,33,35
People Pleaser with Austin Archer,0,0,1,0,17,18
"Tomorrow, the Void",0,0,0,1,10,11
Bannon's War Room,30,4,8,6,144,192
Science and Saucery,2,1,1,2,19,25
Be Your Best Horsemanship,0,0,0,0,50,50
Ladies & Tangents,0,1,0,0,53,54
Old Gods of Appalachia,0,1,0,2,47,50
Broker-to-Broker,0,0,0,0,8,8
Locked On Hurricanes - Daily Podcast On The Carolina Hurricanes,1,0,0,0,0,1
Superman & Lois: The New Adventures,1,0,0,0,4,5
Hollywood Remixed,0,0,0,0,1,1
The Culture Project Podcast,0,0,0,0,13,13
A Beautiful Mess Podcast,1,2,1,0,46,50
Wannabe Minimalist Show,0,0,0,0,4,4
Greatest Story Never Told,0,0,0,0,10,10
Letters to a Dead Friend About Zen,1,0,0,0,3,4
Beauty is a Bitch,0,0,0,0,1,1
Chelsea Mike'd Up,3,1,5,4,248,261
The Homestead Journey,0,0,0,1,10,11
The Rugby Bricks Podcast,0,0,0,0,10,10
Mother Flipping Awesome,0,0,1,2,35,38
Good For You,14,8,7,8,13,50
A Zero To A Hero: Learn Spanish!,1,0,3,0,13,17
I AM BIO,0,0,0,0,3,3
Business of Bouffe,0,0,0,0,3,3
The White Witch Podcast,0,0,0,0,18,18
Military Murder,7,2,0,3,292,304
420 Day Fiance,3,2,2,3,263,273
Mile High Hockey: for Colorado Avalanche fans,1,0,0,0,2,3
Young and Corporate,11,1,1,1,36,50
History Uncovered,2,3,0,0,0,5
Recording Artists,0,0,0,0,10,10
Rock And Roll Confessional,1,1,0,0,41,43
Nightmare Tonight,0,0,0,0,2,2
Detective Trapp,24,20,22,27,350,443
Giants Brawl,0,0,0,1,9,10
Journey through Classical Piano,0,0,0,0,11,11
INTO THE ABISCUIT,0,0,0,1,43,44
Backyard Time Machine,0,0,0,0,32,32
Couple Things with Shawn and Andrew,1,2,2,7,488,500
Highly Entertaining,0,0,0,0,3,3
The Commander's Quarters,0,0,0,2,35,37
"The Fit Farming Food Mom, Connie Nightingale",0,0,0,0,46,46
"Alan Watts - Way Beyond the West - Modern Philosophy, Zen Buddhism & Eastern Philosophy Podcast",0,0,0,1,4,5
The Crown: The Official Podcast,1,1,2,6,26,36
Trace Material,0,0,0,0,8,8
Cozy Cryptid,2,0,0,0,13,15
The Landscape Photography Show,0,0,0,1,20,21
Inside Frozen 2,15,3,9,18,102,147
Sibling Revelry with Kate Hudson and Oliver Hudson,41,15,31,40,373,500
On the Mic with Mike Peters,0,0,0,0,2,2
Spooky Psychology,0,0,0,0,6,6
GUNS Magazine Podcast,1,1,0,0,7,9
The Late Kick with Josh Pate,6,2,1,3,488,500
The Fitness Insider,0,0,1,0,18,19
Bitcoin In Asia - Bitcoin Magazine,0,0,0,0,5,5
Scry Me a River,0,0,0,0,3,3
Let's Talk About Water,0,0,0,0,2,2
Against The Stream,0,1,0,0,3,4
The David J. Harris Jr Show,3,2,0,1,44,50
Hollywood Unscripted,0,0,0,0,21,21
Long Lost: An Investigative History Series,2,1,1,1,25,30
Thinking in Japanese Podcast,0,0,0,0,2,2
Agriculture Adapts by ClimateAi,0,0,0,0,5,5
astro[sound]bites,0,0,0,0,1,1
METALLIGEEK: Metallica Podcast w/ Andriy Vasylenko,0,0,0,0,13,13
The Secret Life of Death Podcast,0,0,0,0,3,3
Translating ADHD,0,0,1,1,28,30
The FliteCast,0,0,0,0,5,5
The Golf Gals,0,0,0,0,3,3
The Nasty Galz,2,0,0,0,5,7
Hair Metal Memories,0,0,1,0,2,3
Cinephobe,1,0,0,0,49,50
The Open Mic Podcast with Brett Allan,0,0,0,0,14,14
FPL Family,0,0,0,0,1,1
Across The Movieverse,0,0,0,0,17,17
RP Strength Podcast,3,0,3,3,33,42
Hodgetwins,13,2,0,0,179,194
The Emily Show,2,0,0,0,44,46
Parsha Perspectives,0,0,0,0,1,1
Crypto Like A Boss - Adryenn Ashley & Heather Havenwood,0,0,1,0,0,1
Linchpin Conversations,0,0,0,0,6,6
The Scotchy Bourbon Boys,0,0,0,0,1,1
It’s a Vet(Tech)’s Life,0,0,0,1,0,1
"Ready, Set, Fetch!",0,0,0,0,3,3
Vital Dawn,0,0,0,0,2,2
The Morning Show Podcast,1,0,0,0,2,3
I Hear You,0,0,0,0,15,15
Four Million Years Later,0,0,0,0,4,4
"Roots, Wings and Other Things",0,0,0,0,8,8
In Culture,0,1,0,0,0,1
The Dating After Divorce Survival Guide,0,0,1,0,13,14
Limited Level-Ups,0,0,0,0,8,8
Don't Miss This Study,2,3,2,5,159,171
For All Mankind After Show Podcast,0,1,0,0,3,4
Magnificat Ministry Podcast,0,0,0,0,1,1
Battleline Podcast,1,0,0,0,48,49
Faithful Conversations,0,0,0,0,4,4
Reveal: The Revenue Intelligence Podcast,0,0,0,0,25,25
Academia de Conspiraciones,2,0,0,1,0,3
History of FMW,0,0,0,0,1,1
Garbage Days,0,0,0,0,37,37
Locker Room Access,0,0,0,0,18,18
The Witcher Recap,0,0,0,1,2,3
Jabba the Pod: A Podcast About Star Wars,0,1,6,12,223,242
Nightdrive,0,0,0,0,12,12
Y'all-itics,3,0,1,2,23,29
Rates & Barrels: A show about baseball,4,2,3,2,53,64
Major League Djz,3,0,4,6,17,30
Peak Northwest,0,0,1,1,5,7
Locked On White Sox - Daily Podcast On The Chicago White Sox,3,0,1,2,24,30
Is This What You Want?,0,0,0,0,2,2
EXFIL - An Escape From Tarkov Podcast,0,1,3,1,69,74
Something Isn't Right Podcast,0,0,1,0,10,11
Sustaining Keto with Maggie Sterling,1,0,2,0,47,50
The Economist Morning Briefing,4,2,1,0,13,20
Live Yes! with Arthritis,1,1,0,0,4,6
Mid Mod Remodel,0,0,0,0,6,6
WildFed Podcast — Hunt Fish Forage Food,1,0,0,0,134,135
CBS This Morning - News on the Go,4,1,0,0,5,10
Surveyor Says!  The NSPS Podcast,0,0,0,0,4,4
Motherhacker,0,0,5,3,42,50
FRAMES Photography Podcast,0,0,0,0,5,5
High Stakes,0,0,0,0,5,5
Messy Mom Magic,0,0,0,0,4,4
BIG GAY SEX SHOW: THE DADDY YEARS,0,0,0,1,4,5
The Heart & Hustle Podcast,0,0,0,1,49,50
This Planet Needs a Name,0,0,0,0,9,9
Depression and Anxiety in real life,0,0,0,1,7,8
Blood Podcast,0,0,3,0,1,4
KonKon's Cantina,0,0,0,0,18,18
Life of the Record,0,0,0,0,3,3
Push the Donut - A Journey Into Music Theory,0,0,0,1,0,1
Dave Fox Home Remodeling Show,0,0,0,0,2,2
Red Ball,193,68,33,24,182,500
The Mindalorian,1,0,0,0,11,12
The Program audio series,0,1,0,0,17,18
Private Talk With Alexis Texas,2,0,2,1,8,13
Star Wars Untold Stories,11,0,0,1,2,14
"Raise Your Game Show with Alan Stein, Jr.",0,0,0,0,165,165
Get Sleepy: Sleep meditation and stories,35,35,28,35,1008,1141
First Contact with Laurie Segall,1,1,2,1,24,29
Rock N Roll Bedtime Stories,1,2,0,0,1,4
In Bed with Nick and Megan,34,26,18,11,200,289
Speeding Bullitt: The Life and Films of Steve McQueen,0,0,0,0,2,2
Apology,0,1,0,0,12,13
The Complex Sports Podcast,4,1,0,1,46,52
The Complex Sneakers Podcast,7,0,4,0,149,160
Tawanda's Live Request,0,0,0,0,2,2
The AD Aesthete,0,0,1,0,6,7
The Catch and Kill Podcast with Ronan Farrow,13,5,6,11,457,492
"Drink Beer, Think Beer With John Holl",0,0,0,1,23,24
Kalami Q/A,0,0,0,0,1,1
Dirty Rotten Church Kids,0,0,1,0,87,88
Well There's Your Problem,3,2,1,1,37,44
Butcher BBQ Podcast,0,0,0,0,5,5
Behind The Screams,0,0,1,0,18,19
The Office ASMR - A Podcast to Sleep To,1,1,1,1,46,50
After The Buzzer,0,0,0,2,8,10
The KC Morning Show,0,0,1,0,8,9
I Think You're Dope w/ Eric Nam,0,0,0,0,50,50
The Pentertainment Podcast,1,0,0,0,12,13
Sorry Bout It,0,0,0,0,18,18
Real Simple Tips,0,0,0,0,2,2
Max & Ivan: Fugitives,0,0,0,1,12,13
The Oddcast Ft. The Odd Man Out,0,0,0,0,5,5
Solve,68,41,44,24,175,352
Sweet Grace For Your Journey,0,0,0,0,23,23
Making Polyamory Work,0,0,0,0,16,16
Lamplighter Kids Stories,1,0,0,0,29,30
Let's think Earth: Season 12; Season of the Brain,1,0,0,0,0,1
Office Horror Stories: True Workplace Nightmares,6,1,4,0,39,50
Living Lean,0,0,0,0,14,14
Jeranism Podcast,1,1,1,1,3,7
Beyond The Beauty with Bobbi Brown,2,1,2,2,8,15
Bad Decisions,1,1,1,2,83,88
Abide Bible Sleep Meditation,20,9,8,8,15,60
National Day Calendar,0,0,0,0,1,1
The Science Revolution with Thom Hartmann,0,0,0,0,2,2
Star Signs: Go Stargazing!,0,0,0,0,4,4
Real Estate 101 - The Investor's Podcast Network,0,0,1,1,26,28
LeaderSwift Podcast,0,0,0,0,11,11
Sleep Tight Relax - Helping busy minds become calm at bedtime,0,0,0,1,20,21
Alienating the Audience,0,0,0,0,42,42
A Musical Theatre Podcast,0,0,0,1,16,17
Prince | Official Podcast,4,3,1,5,37,50
Perilous Storytelling,0,0,0,0,11,11
IELTS Speaking for Success,0,0,0,1,7,8
The Pigeon Whole Motorcycle Podcast,0,0,0,1,15,16
AeroNewsGermany,0,0,0,0,1,1
Kids Meditation & Sleep Stories,3,1,3,6,37,50
Career Quest with Sydney,0,0,0,0,7,7
You Need Therapy,0,0,0,3,36,39
The Instinctive Australian Shepherd,0,0,0,0,1,1
Very Good Show,0,0,0,0,7,7
How to be a Minimalist,0,0,0,1,22,23
Nani Ki Kahaniya,1,2,1,1,10,15
Princess Stories With Aneira,0,0,0,0,1,1
The New Day: Feel the Power,3,1,5,5,486,500
The Ticket Daily Dump,1,1,1,1,1,5
The Don Cherry's Grapevine Podcast,3,0,0,1,62,66
Real Life Weight Loss,0,0,1,0,49,50
Behind The Irishman,1,2,1,0,17,21
Joke Quest 200,0,0,0,0,4,4
Cross Thread Off Road,0,0,0,0,6,6
The TriDot Triathlon Podcast,0,0,0,0,50,50
"The Best Movies, with Richard Roeper and Roe Conn",0,0,0,0,3,3
The Phil Hay Show - A show about Leeds United,0,0,0,0,3,3
Straight Outta Cobham - A show about Chelsea,0,0,0,0,8,8
The Red Agenda - A show about Liverpool FC,0,0,1,0,4,5
Gwlad Tidings - A show about Everton,0,0,0,1,1,2
Coffee At New Jersey Audubon,0,0,0,0,15,15
The Bookmarked Podcast,0,0,0,1,27,28
Manage My Wedding Podcast,0,0,0,0,6,6
Hot Take,4,3,2,0,66,75
The Broadway Husbands Podcast,0,0,0,0,10,10
"SYSTEMIZE YOUR LIFE | Work From Home Mom Tips, Task Management, Time Blocking, Business Systems, Hom...",0,0,1,0,48,49
Optimal Living Advice,1,0,0,0,14,15
Female Startup Club,0,0,0,0,55,55
Black in the Garden,0,0,0,0,27,27
"Hunt, Gather, Talk with Hank Shaw",0,0,0,1,13,14
"The Chefs Without Restaurants Podcast – Stories and Advice From Personal Chefs, Food Truck Owners an...",0,0,0,0,22,22
The Evolution of Torah: a history of rabbinic literature,0,0,0,0,7,7
"Sleep Meditation Music - Relaxing Music for Sleep, Meditation & Relaxation",0,0,2,1,9,12
The Ornstein & Chapman Podcast,1,1,0,0,5,7
Handbrake Off - A show about Arsenal,1,0,1,2,9,13
Pod On The Tyne - A show about Newcastle United,0,0,0,0,2,2
The Avian Behavior Podcast,0,0,0,0,5,5
Zonal Marking - A show about football tactics,0,0,0,1,7,8
The View From The Lane - A show about Tottenham,2,1,0,0,8,11
The Jann Arden Podcast,0,0,0,0,3,3
The Rake,0,0,0,1,4,5
Settle the Stars: The Science of Space Exploration,0,0,1,1,20,22
RSL Soapbox: for Real Salt Lake fans,0,0,0,0,2,2
Brave New Work,0,0,0,0,16,16
Inside Tri Show,0,0,0,0,1,1
Starting Greatness,1,0,0,1,48,50
The TXG Podcast,0,0,0,1,8,9
Locked On Stars - Daily Podcast On The Dallas Stars,2,0,0,0,19,21
The KLN Podcast,2,0,0,1,39,42
The Actual Stretch and Bobbito Show,0,0,0,0,5,5
Today By The Way,0,0,0,0,50,50
The Lost Art Of Conversation - A Pink Floyd Podcast,0,0,0,0,11,11
Meal Prep Monday  Podcast™,0,0,0,0,7,7
Gina Bianca Podcast,0,0,0,1,36,37
"Gee Thanks, Just Bought It",4,1,3,2,40,50
The Antigen,1,1,2,0,19,23
The WinAtLife Podcast,0,0,0,0,1,1
ThePrint,0,1,0,1,9,11
News Cycle,1,0,2,0,4,7
The All American Dream,0,0,0,0,6,6
Best And The Other One,0,0,0,0,8,8
Arena Craft Podcast,0,0,0,0,19,19
UFO Chronicles Podcast,2,1,1,2,76,82
The Boundaries.me Podcast,2,0,0,1,43,46
Songs of Note,0,0,0,0,8,8
Good Company,0,0,0,0,1,1
Intertidal Talks,0,0,0,0,1,1
Moon Rabbit,0,0,0,0,1,1
Up In The Blue Seats: A NY Rangers Hockey Podcast from NY Post Sports,1,2,0,0,30,33
The Stripe Show,1,0,0,0,6,7
The Republican Nation,11,1,0,2,9,23
MySwimPro Swimming Technique & Training Podcast,0,0,0,0,6,6
The A.V. Club Presents Film Club,1,0,1,1,12,15
The Call Sheet with Kris Tapley,0,0,0,0,5,5
Panties In The Mouth,0,0,0,0,9,9
The Panic Pod,0,0,0,0,9,9
Straight Up with Trent Shelton,0,0,0,0,50,50
Change Church Podcast,0,0,0,0,6,6
The Kinky Pineapple,2,0,1,0,2,5
Mismo with Mick Torres & Ashley Argota,0,0,0,0,4,4
The Muckrake Political Podcast,4,0,1,2,43,50
The Nick Woolley Podcast,0,0,0,0,1,1
Dietitian Table Talks,0,0,0,0,15,15
24/7 FLAT EARTH DISCORD LIVESTREAM,1,0,2,0,2,5
"Jeffrey Epstein, The Prince and the Pervert Podcast",4,3,1,1,30,39
Subscription Box Basics with Julie Ball,0,0,0,0,32,32
Knot Zen,1,0,0,0,2,3
Weeb Nation Podcast,1,0,0,0,35,36
Movement Made Better Podcast,0,0,0,0,3,3
Infinite Loops,0,0,0,0,10,10
Art Affairs,0,0,0,0,5,5
This Week At The Box Office,0,0,0,0,3,3
F*** Hut Music School for Teens,1,1,0,1,18,21
El Washington Post,0,1,0,2,15,18
#HerStory,0,0,0,0,9,9
The Dirt: the gardening podcast from Grow Your Own magazine,0,0,0,0,3,3
Conversations With Coleman,4,1,3,5,79,92
Swim Coach in Transit,0,0,0,0,1,1
PopRoast,0,0,0,2,24,26
Markets Daily Crypto Roundup,1,0,0,0,3,4
The Frightmare Theatre Podcast,0,0,0,0,10,10
Write in 10 Podcast,0,0,0,0,11,11
FASTer Way Podcast,2,0,0,1,15,18
CCERP Podcast,0,0,0,0,1,1
Fashion Victims Podcast,0,0,0,0,22,22
Artie Lange's Podcast Channel,5,0,1,3,41,50
Brimstone Valley Mall,0,0,0,0,32,32
CounterClock,38,31,34,22,375,500
KoopCast,2,1,3,1,75,82
Ask Dr. Drew,6,1,1,0,6,14
Wellness While Walking,0,0,0,0,18,18
Golf Better Podcast,0,0,1,0,10,11
TechFirst with John Koetsier,0,0,0,0,7,7
Popcorn Culture,3,0,6,2,248,259
Locked On Predators - Daily Podcast On The Nashville Predators,1,1,1,0,18,21
The Tao Te Ching for Everyday Living,0,0,0,0,7,7
Paleo Bites,0,0,0,0,6,6
Equine Bodytalks,0,0,0,0,1,1
A Cyster & Her Mister: A PCOS Lifestyle Podcast,0,0,0,1,49,50
The Carmudgeon Show,1,0,0,1,15,17
Confessions of a Stenographer,0,0,0,0,5,5
Parlez Away,1,0,0,2,12,15
La bottega di Babbel,0,0,0,0,3,3
Soul and Wit,2,1,1,2,44,50
The Hospitality Podcast with Katherine Sasser,0,0,0,0,2,2
Speaking Spanish for Beginners | Learn Spanish with Latin ELE,0,0,0,0,19,19
"Meditation music. Peaceful calm music 528, 432 Hz",0,0,1,1,26,28
Sex Therapy with Dr. Jones,0,0,0,1,48,49
Anime Academy93,0,0,0,0,1,1
The Backpacking Experience,0,0,0,0,28,28
Feed Your Brain - Podcasts,0,0,0,0,1,1
HERself,0,0,0,1,49,50
Good Bottle,0,0,0,0,2,2
The Devon Kershaw Show by FasterSkier,0,0,0,0,6,6
Forensic Psychology,0,0,2,4,2,8
Valley of the Nerds,0,0,0,0,7,7
Superhumans At Work by Mindvalley,0,0,1,11,122,134
The Wire - Fantasy Football Podcast,0,0,1,0,7,8
Whiskey Lore,0,0,1,0,11,12
A Certain Point of View: A Star Wars Podcast,0,0,0,0,9,9
Tales with TR: A Hockey Podcast,1,0,0,0,1,2
The Daily Dad,3,0,1,0,29,33
The Only Podcast Left - Daybreak,0,0,0,0,8,8
The Mom Break Podcast ©,0,0,0,0,18,18
The Phone Booth,1,0,1,0,26,28
The Best of 3 CoD Esports Podcast,2,0,0,0,67,69
The Next Trip - An Aviation and Travel Podcast,0,0,0,0,13,13
BRAND PARTY Podcast,0,0,0,0,10,10
Feeding The Mouth That Bites You,0,0,0,0,23,23
Creator Club | Social Media Marketing & Content Creation,0,0,0,0,38,38
Dungeon Dads,0,0,0,0,21,21
Trail-Cast,0,1,0,0,1,2
Enjoy The Walk Golf Podcast,0,0,0,1,15,16
Big Question,0,0,0,1,13,14
Filthy F*****g Casuals,0,0,0,0,4,4
Worldwide Engineering with Leon Abboud,0,0,0,0,2,2
Marvel Squadcast,0,0,0,0,4,4
Make It Shine? The Victorious Podcast,3,0,0,1,6,10
Modern Electrician,1,0,0,0,9,10
The Daily Podcast,0,0,1,1,4,6
Magnify Your Miracles Podcast,0,0,0,0,9,9
WoW Killer: A World of Warcraft Podcast,2,1,0,1,24,28
Tailosive Tech Twitch,0,0,0,0,1,1
Conduct Detrimental: THE Sports Law Podcast,0,0,0,0,13,13
Boys Shooting Club,0,0,0,0,10,10
The Daily Show Podcast Universe,13,1,0,4,32,50
Social Media Influencer,1,0,0,0,49,50
Rumble with Michael Moore,56,10,21,15,398,500
The Maine Fly Fishing Podcast,0,0,0,0,8,8
OBS Talk,0,0,0,0,50,50
DialogueBox,0,0,0,0,16,16
Tailosive EV,0,0,1,0,10,11
Murder Mystery,1,1,0,1,0,3
Getting High With Plants,0,0,0,0,1,1
Astral Projection Podcast from AstralHQ,0,0,0,0,1,1
Tomahawk Nation: for Florida State Seminoles fans,1,1,1,0,17,20
WeCrochet Podcast,0,0,0,0,9,9
Stu Does America,5,1,0,7,474,487
"Food, We Need To Talk",4,1,2,1,42,50
The Beautifully Enough Podcast - a Christian women devotional,0,0,0,0,40,40
Schitt's and Giggles: A Schitt's Creek Podcast,1,2,0,0,3,6
Valley Boys Podcast,1,0,0,0,12,13
Don't Shit On The Bus,0,0,0,0,18,18
The Long Island Volleyball Podcast,0,0,0,0,3,3
The Dark Web Unmasked,1,0,2,0,15,18
Garden Plots with Skeletor,0,0,0,0,8,8
The LoudCasa Talks,5,0,3,4,7,19
The Keyboard Chronicles,0,0,0,0,2,2
The Pope's Point of View,0,0,0,0,8,8
"Palace Intrigue: Meghan Markle, Harry and the rest of the Royal Family",3,2,1,3,4,13
The Junior Classics,0,0,0,1,11,12
Barks from the Bookshelf,0,1,0,0,2,3
Kes & Juice Podcast,0,0,0,1,17,18
Movie Mike's Movie Podcast,3,2,5,10,272,292
The Roblox PodCast,21,3,2,0,11,37
The Well Managed Hive's Podcast,0,0,1,0,1,2
stampingonthebackporch,0,0,0,0,2,2
No Balls: The Cricket Podcast,0,0,0,0,1,1
"The Divorce and Beyond Podcast with Susan Guthrie, Esq.",0,0,0,0,16,16
The Ranveer Show,0,0,0,2,32,34
Elite Physique University,0,0,0,0,50,50
Monster: DC Sniper,22,15,26,36,200,299
Anime Uproar Audio (AnimeUproar),0,0,0,0,5,5
You Can Heal Your Life®,11,12,10,5,62,100
The Steam Room,14,0,4,4,172,194
Mythgard's Exploring The Lord of the Rings,0,0,1,0,4,5
American Glutton,0,0,1,1,48,50
Tomahawk Take Podcast on the Atlanta Braves,1,0,1,0,1,3
The Gerry Callahan Podcast,128,9,12,17,334,500
"Ew, David: A Schitt’s Creek Giggle Fest",1,0,0,1,2,4
Advisory Opinions,13,3,11,8,260,295
Personal Genomics - A Podcast from the Center for Cancer Genomics,0,0,0,0,1,1
G Talk Garden Podcast,0,0,0,0,1,1
PUCKS IN DEEP,0,0,0,0,3,3
Empathy Always Wins with Ally Salama,0,0,0,0,4,4
Latter-day Ain'ts,0,0,0,0,1,1
Meet Cute,5,2,4,2,23,36
Giving With Impact,0,1,0,0,0,1
Narativ Live with Zev Shalev,1,1,3,5,11,21
McKinsey Talks Talent,0,0,0,0,1,1
Payday With Rayray,0,0,0,0,100,100
De Man en de Maan,0,0,0,0,3,3
Your Broccoli Weekly,0,0,0,0,1,1
Modern American Diplomacy,0,0,0,0,12,12
The Way of the Runner - conversations on running with Adharanand Finn,0,0,0,0,2,2
Success Habits of Super Achievers,0,0,0,0,26,26
Locked On Blues - Daily Podcast On The St. Louis Blues,4,1,1,1,3,10
"Dandelion, The Witcher and The Wardrobe",0,0,2,0,4,6
"Coffee, Pods & Wods",0,0,0,0,3,3
Servant After Show Podcast,1,1,1,1,3,7
The Training Tails,0,0,0,0,1,1
BotaniCal,0,0,0,0,1,1
Fake Heiress,12,2,7,6,14,41
Early Work with Rhys James,0,0,0,0,5,5
Cardionerds: A Cardiology Podcast,1,0,0,0,23,24
Latter-day Saint Women Podcast,0,0,0,0,44,44
The Home Of Horror Podcast,0,0,1,0,3,4
Everything is Fine,1,1,2,3,69,76
The Disney+ Princess Podcast,0,0,0,0,4,4
LA PLATICA,0,2,1,2,67,72
Bleav in the Slapdick Podcast,3,1,1,1,38,44
REALationships Podcast,0,0,1,1,48,50
VALENCE,1,3,0,2,12,18
Freak Flag Flying,2,1,0,1,18,22
The Shine Online Podcast,0,0,0,0,20,20
Critical Care Scenarios,0,0,0,0,13,13
friends on FIRE,2,0,0,0,34,36
Black Ramen Podcast,0,0,0,0,3,3
Ceremonial Weigh-In,0,0,0,0,3,3
The Pro-Pilot Playbook Podcast,0,1,0,0,1,2
Down,2,1,1,4,9,17
"Boobs, Blood & BadAsses",1,1,1,0,2,5
Dugout Chatter Podcast Powered by Stick & Ball TV,0,0,0,0,38,38
RNZ: The Aotearoa History Show,0,0,0,1,21,22
The Running Grind,0,0,0,0,2,2
On the Move,0,0,0,0,3,3
Hada de Fresa,0,0,0,1,4,5
Alix Turoff Nutrition Podcast,2,0,0,0,30,32
Auto Amateur,0,0,0,0,3,3
Locked On Royals - Daily Podcast On The Kansas City Royals,3,0,0,0,6,9
Broncos Brawl,1,0,0,0,42,43
Locked On A's - Daily Podcast On The Oakland Athletics,0,0,0,0,4,4
Sunbeam,1,0,0,0,38,39
Jewish Bedtime Stories,0,0,0,0,1,1
WaxPackHero Sports Card Minute,0,0,0,0,41,41
Josh Tolley Show,0,0,0,0,1,1
All Things Latina Podcast,0,0,0,0,12,12
Credit Repair Business Secrets,0,0,0,1,23,24
Postcards From Midlife,0,0,1,0,5,6
TBD: Technology By Design,0,0,0,0,3,3
Two Lives with Olivier,1,0,0,0,9,10
Draws N Fades,0,0,0,0,31,31
Trot Talk,1,0,0,1,5,7
PokeDads: A Pokemon TCG Podcast,0,0,0,0,31,31
The Brain Architects,0,0,0,0,3,3
Cadillac Jack - My Second Act,1,1,0,1,47,50
ROOTLESS LIVING,0,0,0,0,9,9
Saints Podcast,0,0,0,0,9,9
The First Vision: A Joseph Smith Papers Podcast,11,1,3,3,56,74
Totally 80s,0,1,0,0,5,6
CreepsMcPasta Creepypasta Radio,0,0,2,3,45,50
The Leadership Antidote Podcast,0,0,0,0,1,1
Boys' Bible Study,0,0,0,0,20,20
Tik Tok,1,0,0,3,5,9
Must Love Food,0,0,0,0,1,1
Naughty But Nice with Rob Shuter,4,1,1,2,86,94
27 Club,18,10,15,5,239,287
The Overland Journal Podcast,1,0,0,1,20,22
Effective Compassion,0,0,2,0,35,37
My Year in Mensa,9,9,9,10,180,217
Erskine Radio,1,1,0,0,0,2
Total Offroad Podcast,0,0,0,1,42,43
Thrifters Villa,0,0,0,0,25,25
The Gabby Reece Show,3,2,6,3,36,50
Built To Go! A #Vanlife Podcast,0,0,0,1,6,7
The Good Dirt,0,0,0,0,11,11
"Nature calm music, sounds. Relaxation, background music",3,0,0,5,67,75
The Punk Rock MBA,1,1,0,1,40,43
The Pyllars Podcast with Dylan Bowman,0,0,0,1,46,47
Ordinary Equality,6,0,1,0,43,50
1023 Diesel Shop Talk,0,0,0,0,5,5
Get a Grip with Max Homa & Shane Bacon,4,2,0,3,249,258
"Play, Watch, Listen",5,2,1,3,39,50
"Low Tide Boyz, a Swimrun Podcast",0,0,0,0,24,24
Dog & Puppy Training | Savvy City Dog,0,0,0,0,7,7
The Practice Brave Podcast,0,0,0,0,17,17
The Book Show & Rough Note by RJ Ananthi,0,0,0,0,4,4
Section Hiking the Appalachian Trail,0,0,0,0,2,2
Shawn Ryan Show,1,0,0,2,493,496
Jonathan Wier & Ayla Brown Podcast,0,0,1,0,8,9
The Game Within The Game,0,0,0,0,1,1
Secret Societies,21,20,10,7,30,88
The Think Marketing Podcast,0,0,0,0,50,50
The Double Shadow,0,0,0,1,0,1
The Rebel Capitalist Show,2,2,1,0,23,28
"MegAnne is NOT a parent, but...",0,0,0,0,28,28
Verified Vibes,0,0,0,0,7,7
Unlock the Sugar Shackles Podcast,1,1,0,1,27,30
The Unfiltered Podcast: The Bachelor Recap Podcast,11,2,2,0,43,58
Six Seasons & a Podcast,0,0,1,0,9,10
EW On Set: Schitt's Creek,0,2,1,0,6,9
Locked On Wild - Daily Podcast On The Minnesota Wild,0,0,0,0,1,1
Fartmouth,0,0,0,0,5,5
The Food Code,0,0,0,0,28,28
Jungle Prince,10,3,6,7,116,142
Surely You Can't Be Serious Podcast,0,0,0,0,19,19
Affirmation to Manifestation Podcast,0,0,0,0,32,32
Running Lean,0,2,0,0,18,20
The Dimension Door Podcast,0,0,0,1,12,13
Fascinating? - A Star Trek Podcast,1,0,0,0,9,10
The 80/20 BASEBALL MASTERCLASS,0,0,0,0,4,4
GroSeries: An MCAT Review Podcast,0,0,0,0,26,26
Industry Seating,1,1,0,0,20,22
Sex from A to Z,0,0,0,0,3,3
Poetry Unbound,1,0,0,1,198,200
In the life of a teenage mind,0,0,0,0,3,3
Propulsion Swimming Podcast,0,0,0,0,1,1
The Paper Outpost - The Joy of Junk Journals!,0,0,0,0,10,10
KaisaFit // More Than My Body,0,0,0,0,37,37
The InFluency Podcast,0,0,0,0,22,22
Let's Gather Podcast,0,0,0,0,2,2
Roam,0,0,0,0,3,3
Be Well By Kelly,1,1,1,1,46,50
The Spa Strong Podcast,0,0,0,0,61,61
Dave Lee on Investing,0,1,0,0,4,5
Dose Makes The Poison: The Toxcast,1,0,0,0,17,18
The Analytics of Dynasty Podcast,0,0,0,0,2,2
Wisdom of the Sages,0,2,0,4,170,176
The Southern Cannibal Podcast: The Dinner Table,1,0,0,0,2,3
The Quarterback Q&A Podcast,0,0,0,0,3,3
Elvis The Ultimate Fan Channel,0,0,0,0,4,4
Conversations About Art,0,0,0,0,5,5
Dante Elephante Podcast,0,0,0,0,1,1
Wake Up With Weslie,0,0,0,1,49,50
Teaching to the TOP,0,0,2,1,47,50
Junk Monk Podcast,0,0,0,0,8,8
Reham Podcast with Reham Al-Rashidi,0,1,0,2,28,31
Rum Ham and Wild Cards,0,0,0,0,9,9
Down to Birth,0,0,0,0,50,50
Carpool Critics - a movie podcast!,0,0,2,1,40,43
Grada 305,0,0,0,0,2,2
Enneagram and Marriage,1,1,3,0,22,27
"It’s Not You, It’s Your Trauma - Trauma, PTSD, Abuse, Anxiety & Recovery - Joe Ryan",0,0,0,0,22,22
Only One Shot Golf,0,0,0,0,6,6
Bardown Beauties,0,0,0,0,15,15
The Line with Ashley Wood,5,1,1,0,376,383
Honest To Dog Podcast,0,0,0,0,4,4
The Officer's Wife,8,3,14,21,107,153
Bible Stories,0,0,0,0,1,1
Truth and Basketball with George Karl,1,0,0,0,23,24
The Homeschool Project Podcast,0,0,0,0,7,7
The Dispatch Podcast,21,14,16,15,179,245
Queen Of Your Castle,0,0,0,0,14,14
SP Streamer Fantasy Baseball Podcast,0,0,0,0,57,57
Party Card,0,0,0,0,1,1
My Year With Dolly,0,1,0,1,41,43
Chihuahua Love,0,0,0,0,1,1
Grow Your Self,0,0,0,2,36,38
The Hitchcock Minute Podcast,1,0,0,0,0,1
The Senior Pet Podcast,0,0,0,0,5,5
The Call of the Void,1,1,3,4,31,40
"Wake Me Up: Morning mindfulness, meditation, and motivation",2,0,2,2,44,50
The Curious Climber Podcast: Chatting with Hazel and Mina,0,0,0,0,8,8
36 From the Vault,8,6,9,9,47,79
Your Chakra Coach,0,0,0,0,8,8
Honest AF Show,0,0,0,1,14,15
Tilth Talk Radio,0,0,0,0,1,1
Shadowless Podcast: A Pokemon Podcast,0,0,0,5,45,50
Lifestyle Overland: Campfire Confessions,0,0,0,0,17,17
Cellfie Life,0,0,0,0,9,9
BIG FACTS with Big Bank & DJ Scream,0,0,1,0,22,23
Like You: Mindfulness for Kids,1,0,0,0,22,23
AnthroBiology Podcast,1,0,0,0,11,12
Untold Italy travel podcast,1,0,0,0,18,19
Money Meets Medicine,0,0,1,0,28,29
Talking Heads - a Gardening Podcast,0,0,1,0,2,3
And for Off the Block,0,0,0,0,1,1
Daf Yomi for Women - Hadran,0,0,0,1,5,6
One Hit Thunder,0,0,0,0,13,13
The B List with Petshopboy,2,3,1,1,40,47
Your Haunted Holiday,0,0,1,1,35,37
Troubled,0,0,0,0,10,10
We Are History,1,0,3,2,48,54
Torat Imecha Nach Yomi,0,0,0,0,2,2
The Baron of Botox,35,32,23,14,50,154
Bold and Blunt,3,0,1,0,6,10
Give Theory A Chance,0,0,0,0,1,1
HISTORY This Week,34,7,14,14,146,215
"Children's Stories with Grandma: for Bedtime, Quiet Time & Car Rides",2,0,1,1,2,6
Rescue Swimmer Mindset Podcast,0,0,2,0,18,20
"Betty Life: Behind the Scenes, stories and life lessons",0,0,0,0,1,1
Chasing Cosby,6,4,14,12,192,228
Complete Human,0,1,0,0,4,5
The Chairish Podcast,1,0,0,0,28,29
Walk Run Soar with Shawn & Dorina Gilmore Young,0,0,1,0,19,20
The NPTE Podcast,0,0,0,0,6,6
Coffee and Bible Time's Podcast,0,0,2,2,70,74
What's The Juice,2,0,1,1,46,50
Let's Talk Global Warming,0,0,0,0,1,1
Toxic To Triumph With Matthew Phifer,0,0,0,2,4,6
Swamp Stories,0,0,0,0,28,28
The Blockchain Debate Podcast,0,0,0,0,2,2
Fasting For Life,2,1,1,1,38,43
The Cookie Jar Golf Podcast,0,0,0,0,3,3
S****y Song of the Week,0,0,0,0,3,3
Journal of Special Operations Medicine,0,0,0,0,3,3
The LDN Radio Show About Low Dose Naltrexone,0,0,0,1,0,1
What Things are What Things,0,0,0,0,5,5
Calling Old Hollywood,1,0,0,0,3,4
Bagels and Blessings,0,0,0,0,2,2
The Quad with Chris Young,1,0,1,2,46,50
The Well Told Tale,0,0,0,0,18,18
Monte & The Pharaoh,0,0,0,0,1,1
The Dr. Axe Show,0,2,0,2,46,50
Dingers: A Chicago Cubs Podcast,0,0,0,0,3,3
Perfectly Framed | A Fantasy Baseball Podcast,0,0,0,0,2,2
The Steve Cortes Show Podcast,1,0,0,0,7,8
Inside The Show,0,0,0,0,6,6
Talking Talmud,0,0,1,1,7,9
Neurology Exam Prep Podcast,0,0,0,1,5,6
Big Hormone Enneagram,0,0,0,0,18,18
Take One Daf Yomi,1,1,2,7,70,81
Mindfulness For Beginners,0,0,0,0,9,9
Trucking After Hours,0,0,0,0,1,1
Simply Country,0,0,0,0,2,2
Empowering Women in Real Estate - The Podcast with Karen Cooper,0,0,0,0,6,6
Solidarity Works,0,0,0,0,3,3
The Dan Proft Show Podcast,1,0,1,0,11,13
RDN Good Roller Pod,0,0,0,0,3,3
The Outsider,0,0,3,3,32,38
The EveryCalorieCounts Podcast,0,0,0,0,18,18
The hood politics with prop's Podcast,1,0,1,0,22,24
The S****y Movie Podcast,0,0,0,0,3,3
ADVICE FROM AN ARCHITECT,0,0,0,1,18,19
The Run Ohana Podcast,0,0,0,0,9,9
Pnwild Podcast,0,1,0,1,118,120
The Mile You're In,0,0,0,0,31,31
Be Better Bettors,0,0,0,0,12,12
Positively Positive Podcast,0,0,0,0,8,8
Justin Takes The Bach - A Bachelor Recap Podcast,0,0,0,0,17,17
The Juice Boxx Podcast,0,0,0,0,4,4
4's Up Podcast,0,1,0,0,18,19
The Community Rewatch Podcast,0,0,0,2,8,10
Hardball Podcast,0,0,0,1,103,104
Latina Hotwife Adventures: An Ethical Non-Monogamy Podcast,1,0,0,0,7,8
Movies I Love That No One Talks About,0,0,0,0,20,20
The DOPE Muslim Woman Podcast,0,0,0,0,3,3
BYLATINMEN The Podcast,4,1,1,2,42,50
Two Bees in a Podcast,0,1,0,0,12,13
Smart Tech Today (Video),1,0,2,0,4,7
Checks and Balance,4,1,1,2,42,50
Peace of Chaos: a podcast by Matt Neal,0,0,0,0,3,3
Turning to The Mystics with James Finley,0,2,1,1,93,97
Dictators,32,9,11,11,61,124
Nice Shot Pods,1,0,0,0,14,15
Straight Outta Footwork,0,0,0,0,2,2
Blue Angel Phantoms,0,0,0,0,1,1
Midst,0,0,0,0,45,45
The Triple R,0,0,0,0,20,20
Tea Time UNFILTERED With Lovelyti,0,1,1,1,185,188
THE EXPERTS podcast,5,1,0,0,38,44
The Schitt's Creek After Show Podcast,0,0,0,0,2,2
Life Insurance Academy Podcast,1,0,0,0,15,16
Grain Markets and Other Stuff,0,0,0,0,34,34
Zima Red,0,0,0,0,1,1
More Than Enough,0,0,0,0,8,8
Fuorisoglia,0,0,0,0,2,2
Making Speed Podcast,0,0,0,0,1,1
Guided By A New Podcast,0,0,0,0,3,3
The Grawlix Saves The World,0,0,0,0,39,39
A 3-Bean Salad,0,0,0,0,1,1
Blood Time,0,0,0,0,6,6
Impact the World with Lee Harris,0,0,0,2,105,107
Dirt Talk by BuildWitt,0,0,0,0,50,50
Minnesota Wild Hockey PONDcast,0,0,1,0,1,2
The Jacked Up Review Show Podcast,0,0,0,1,0,1
Strictly Stalking,72,51,79,48,179,429
Fancy Plans & Things Radio,0,0,0,0,7,7
The Brandon McMillan Podcast,2,2,2,0,32,38
SVPod,5,2,1,0,149,157
Kingslingers | A Dark Tower Podcast,0,0,0,0,77,77
Dear Jessamyn,0,1,0,0,8,9
Simple Farmhouse Life,0,0,0,0,50,50
Pillow Talk with Emma Austin,0,1,1,0,3,5
Rivals: Music's Greatest Feuds,8,10,4,9,75,106
Sober As A Mother,2,1,0,0,6,9
Bigger Ten,6,1,1,0,12,20
Unlocking Us with Brené Brown,147,42,14,56,1015,1274
"Next Level Leaders with Dr. Joseph Walker, III",0,0,0,0,15,15
Certified Personal Trainer Podcast,0,0,0,0,1,1
Odadaki Fil,0,0,0,0,1,1
That's So Hindu,0,0,0,1,0,1
Sunstorm with Alicia Garza & Ai-jen Poo,0,0,0,0,31,31
Talk to the Internet,0,1,0,2,17,20
Permaculture for the Future,0,0,0,0,8,8
FearShop.com Horror Podcast,0,0,0,0,7,7
In Focus by The Hindu,0,1,2,1,4,8
Strong Sense of Place,1,0,1,0,90,92
Slime & EXTRAordinary Jobs with Nichole Jacklyne,2,1,0,1,19,23
Factual America,0,0,0,0,1,1
PPG Grandpa’s Paramotor Podcast,0,0,0,0,3,3
The Students' Podcast,0,0,0,1,4,5
Girl Flower Podcast,0,0,0,0,2,2
TOTs,0,0,0,0,2,2
Throwing Fits,2,0,3,0,195,200
Esther Club with Esther Povitsky,2,1,0,2,45,50
The Medicin,0,0,0,0,45,45
Black Goddess Healing and Manifestation,0,0,0,0,7,7
Ain't Slayed Nobody | Call of Cthulhu Podcast,0,0,0,0,50,50
"Newcomers: The Lord of the Rings, with Lauren Lapkus and Nicole Byer",15,9,10,10,456,500
Dead Eyes,5,3,5,2,137,152
Naturally Thin for Life,0,0,0,0,26,26
Thinking Nutrition,0,0,0,0,5,5
Dear Young Married Couple,1,0,0,0,111,112
Draft Champions Podcast,0,2,0,2,10,14
Rupert Spira Podcast,1,0,0,0,2,3
Call Me Candid,8,5,8,10,119,150
The Amazing Maine Podcast,0,0,0,0,12,12
Powerful Motivational Speech,0,0,0,0,1,1
Off The Gram,1,0,0,1,27,29
Water Women,0,0,0,0,1,1
Risky or Not?,0,0,0,1,4,5
Zero Gapped,0,0,0,1,6,7
The Rig Biz Podcast,0,0,0,0,2,2
Big Conversations with Haley Hoffman Smith,0,0,0,0,50,50
The Naked Truth With K&J,0,0,0,0,1,1
ShopNotes Podcast,2,1,3,1,11,18
Cockpits & Cocktails,0,0,0,0,1,1
Locked On Nationals - Daily Podcast On The Washington Nationals,1,1,1,0,16,19
Give Them Lala ... with Randall,79,24,22,33,342,500
Surviving Sister Wives,1,2,3,7,184,197
Love Letters to Kellie... The Podcast,3,1,0,1,41,46
Movie Geeks United,0,0,0,0,1,1
What You Should Know about Cockatiels,0,0,0,0,1,1
Real Coffee with Scott Adams,4,1,1,1,13,20
Review Revue,1,0,2,3,44,50
Deadly Misadventures,6,7,9,7,95,124
Kids Money and More,0,0,0,0,1,1
The Run Smarter Podcast,0,0,0,0,21,21
WeCrashed: The Rise and Fall of WeWork,36,43,44,20,57,200
Locked On Red Wings - Daily Podcast On The Detroit Red Wings,1,0,0,0,12,13
Partners,0,0,0,1,31,32
Out of Left Field,0,0,0,1,19,20
TrainRight Podcast,1,0,1,1,1,4
Triple Knot,0,0,0,0,4,4
On The Land,0,0,0,0,1,1
I've Got A Theory,0,0,0,0,3,3
"Porn, Betrayal, Sex and the Experts — PBSE",1,0,0,0,3,4
Coffee Break Swedish,0,0,0,0,6,6
Forum,0,0,0,0,1,1
Real Legitimate Anthology,0,0,0,0,1,1
Start The World,1,0,0,1,5,7
"Moms Moving On: Navigating Divorce, Single Motherhood & Co-Parenting.",0,0,0,0,28,28
"Social Workers, Rise!",0,0,0,0,7,7
A Dog's Life with Anna Webb,0,0,0,0,1,1
The Wrestling Inc. Daily,7,2,5,0,42,56
Otaku Melancholy,0,0,0,0,4,4
The Feedfeed,0,0,0,0,50,50
Cuda Confidential,0,0,0,0,1,1
Afrobeats Dancehall & Hip Hop Mixes,0,0,0,0,1,1
The Naked Truth With Claire Jefford,0,0,0,0,7,7
Off The Road Again,0,0,0,0,3,3
The Backpacking Podcast,0,2,1,0,15,18
Honest Money,0,0,0,0,6,6
The Naked Leadership Podcast,0,0,0,0,3,3
The Joy of x,0,0,0,0,2,2
Mama Docs POWR podcast,0,0,0,0,3,3
The Esthetician Club,0,0,0,0,1,1
Talk of the Devils - A show about Manchester United,0,1,0,0,5,6
The Molineux View - A show about Wolves,0,0,0,0,6,6
Steilcast - A show about the Bundesliga & German football,0,1,0,1,3,5
Why Always Us? - A show about Manchester City,1,0,0,0,5,6
Torque Factor,0,0,0,0,1,1
Football Cliches - A show about the language of football,0,0,1,0,3,4
Casual Magic with Shivam Bhatt,0,0,0,0,4,4
Everybody is Awful (Except You) with Jim Florentine,11,0,0,1,38,50
The Green Horizon,0,0,0,0,5,5
The Convergence - An Army Mad Scientist Podcast,0,0,0,0,2,2
Armchair Explorer,0,0,0,0,9,9
DNVR Rugby Podcast,0,0,0,0,1,1
Claima Stories with Bimma,0,0,0,0,36,36
Too Busy to Flush,0,0,0,0,7,7
The Hockey Betting Podcast,0,0,0,1,11,12
Talking Hockey,0,0,0,0,6,6
Mary's Cup of Tea Podcast: the Self-Love Podcast for Women,0,0,0,0,50,50
The Lab Report,0,0,0,0,28,28
Verity by Phylicia Masonheimer,1,1,0,0,50,52
The Rugby Player,0,0,0,0,3,3
Wish I'd Known Then . . . For Writers,0,0,0,0,18,18
Dear Bob and Sue: A National Parks Podcast,1,0,0,4,246,251
John Solomon Reports,11,1,7,8,226,253
Take Command: A Dale Carnegie Podcast,0,0,0,0,6,6
The Water Cooler with David Brody,2,0,0,1,16,19
Cars with Cocktails,0,0,0,0,5,5
Locker Room Talk,0,0,0,0,1,1
The Supermassive Podcast,2,0,0,1,1,4
Dying For Sex,12,2,1,4,481,500
More Than One Thing with Athena Calderone,1,0,3,3,39,46
Rebel Eaters Club,3,3,1,1,42,50
Cutthroat Inc.,10,5,8,10,52,85
Strides Forward: Stories of Women Marathon and Ultramarathon Runners,0,0,0,0,5,5
The Running Public,0,0,1,1,220,222
Automotive Diagnostic Podcast,0,0,0,0,6,6
Unshaming,8,3,3,6,35,55
2 Wheeled Rider Podcast,0,0,0,0,4,4
Off Course Agility,0,0,0,0,2,2
Lore OlymPOD,0,0,0,0,50,50
The Venus Cuckoldress Podcast,4,0,0,0,10,14
Insight Myanmar,0,2,0,0,1,3
The North Lot Podcast,0,0,0,0,1,1
Notizie a colazione,0,0,0,0,1,1
The Reclaimers,1,0,0,0,12,13
Devil's Advocate with Rosebud Baker,1,0,0,2,47,50
Verdict with Ted Cruz,140,2,2,2,52,198
Salmon Trout Steelheader Podcast,1,0,0,0,6,7
The Sota Pod,1,0,0,0,9,10
Fnaf talk,0,0,1,2,6,9
No Dogs in Space,5,3,2,8,175,193
70mm,0,1,0,0,36,37
The Dropshot - A Call of Duty Podcast,1,1,1,1,46,50
Complicated-ish,0,0,0,1,9,10
Fun Fables: Bedtime Stories for Kids,1,0,1,0,4,6
Folxlore,0,0,0,0,4,4
Big Boy Brunch,0,0,0,0,3,3
Practice of the Practice: Faith in Practice Podcast,0,0,0,0,76,76
"SeaBros Fishing Podcast - Fishing Stories, Tactics, and Interviews from Top Captains, Mates, and Out...",0,0,0,0,21,21
Zen Mind,0,0,0,0,5,5
Bogey Free,0,0,0,0,1,1
You Are Not Broken,0,0,0,0,28,28
MeatRx,0,0,0,0,9,9
"Activist, You!",0,0,0,0,5,5
Little Cabin Knits,0,0,0,0,3,3
Locked On Marlins - Daily Podcast On The Miami Marlins,0,0,0,0,30,30
FAR AIM | Aviation Regs | Aeronautical Info,0,1,1,0,25,27
So All Over The Place Podcast,0,0,0,0,6,6
FROM THE NOSEBLEEDS,0,0,0,0,1,1
Raising Marriage Podcast,0,0,0,0,9,9
Can I Steal You For a Second?,1,0,0,1,7,9
The Passive Income MD Podcast,2,0,0,0,11,13
The Empowered Wife Podcast,1,1,0,3,45,50
Constructional Approach to Animal Welfare and Training,0,0,0,1,2,3
"Real Talk For Teens and Young Adults- School, Life, and Relationship Success Strategies For Tweens, ...",0,0,0,0,40,40
"Love After Lockup, mmkay",7,3,2,0,7,19
Stories with Sapphire,3,1,0,2,92,98
Fisherman's Post Fishing Podcast,0,0,0,0,3,3
LuAnna: The Podcast,38,2,2,2,50,94
Smart Money Mamas Show,0,0,1,0,53,54
Let’s Get Vulnerable: Relationship and Dating Advice,0,0,1,0,49,50
Stream(H)er,0,0,0,0,120,120
Blue Collar Boardroom,0,0,0,0,1,1
The NonProphet Podcast,0,0,2,0,7,9
Biz Buds,0,0,0,0,37,37
The Ask Coach Parry Podcast,0,0,0,0,2,2
Raising Fame: Sports Edition,0,0,0,2,45,47
Flyers Daily with Jason Myrtetus,0,1,0,5,79,85
Sunday Red,0,0,0,0,2,2
The Politics of Everything,1,0,0,0,8,9
Vegas Revealed,0,0,0,0,12,12
Find Your Voice: How to Write When You're Not a Writer,0,0,0,0,50,50
Bad Friends,4,0,0,2,44,50
The Portrait System Podcast,0,0,0,0,66,66
The Modern House Podcast,0,0,0,0,7,7
Dynasty Builders | Dynasty Fantasy Football,0,0,1,0,12,13
Conspiracy Theories,1,0,1,1,0,3
Tuesday Club,0,0,0,2,36,38
Sonic Renegades: Exploring Revolutionary Guitar Effects Pedals,0,0,0,0,3,3
Not Another Politics Podcast,2,3,0,0,23,28
The Pat Thurston Show Podcast,0,0,0,0,2,2
The Jeanne Oliver Podcast,0,0,0,0,26,26
The Mushroom Hour Podcast,1,0,0,1,20,22
The Afterburn Podcast,0,0,0,1,49,50
Getting Ethics to Work,1,0,0,0,1,2
Mastermind Discussions Podcast,1,0,0,2,29,32
One Take Podcast,0,0,0,0,12,12
Illini Basketball Podcast,0,0,0,0,1,1
ART + MAGIC,0,0,0,0,16,16
The US Foxes Podcast- Leicester City from an American perspective,0,0,0,0,4,4
Hablemos Ecommerce,0,0,0,0,33,33
The Funny Don't Stop Show,0,0,0,0,1,1
Candela: Photography & Cinematography Masters,0,1,0,0,10,11
Get Out N Drive Podcast,0,0,0,0,6,6
Essential Korean,0,0,0,1,2,3
Ruck It!,0,0,0,0,1,1
BEHIND THE VELVET ROPE,20,10,16,15,438,499
Sexier Than A Squirrel: Dog Training That Gets Real Life Results,5,2,7,1,23,38
Ladies Who Law School,1,0,0,0,61,62
YUTORAH: R' Aryeh Lebowitz -- Recent Shiurim,0,0,0,0,2,2
"YUTORAH: R' Aryeh Lebowitz, Daf Yomi -- Recent Shiurim",0,0,0,0,1,1
Coast to Coast AM Back in Time,0,0,0,0,7,7
The Athletic Fantasy Baseball Podcast,2,1,2,1,33,39
Getting Schooled Podcast,3,1,0,0,12,16
Modern Day Sniper Podcast,0,0,0,0,13,13
Brooklyn Nine-Nine: The Podcast,0,0,1,2,51,54
The Rustage Anime Cast,0,0,0,0,14,14
Weight Watchers Dad,0,0,0,0,1,1
Amy Tenney Yoga + Meditation,0,0,0,0,16,16
Final Take,0,0,0,0,7,7
The Way Of Will John,0,0,0,0,8,8
To The Point - Homes Services Podcast,0,0,0,0,39,39
A Skeptic's Path to Enlightenment,0,0,0,0,10,10
Twisted History,5,1,1,2,41,50
New Scientist Weekly,0,0,2,0,3,5
The Montessori Notebook podcast :: a Montessori parenting podcast with Simone Davies,0,0,0,0,16,16
Pot Psychology,3,1,0,1,45,50
"Estate of Mind, The Art of Selling Luxury Real Estate",0,0,0,0,4,4
The Field,4,0,0,1,9,14
Declassified College Podcast | College Advice That Isn't Boring,0,0,1,0,46,47
Suffer Strong Podcast,0,0,0,0,27,27
The Rustoration Podcast,0,0,0,0,4,4
The One Piece Virgin,2,3,2,3,40,50
Hardpoints,0,0,0,0,7,7
Breakfast Balls Podcast,0,0,0,0,18,18
Fantasy Baseball in 15,2,1,1,1,17,22
Playing A Round With Paige Renee,11,2,6,10,471,500
Checking In,1,0,0,1,12,14
Coronavirus 4 1 1  podcast,2,2,2,2,19,27
Arizona State Parks and Trails Podcast,0,0,0,0,1,1
Genome Insider,0,0,0,0,1,1
BACK TO YOUR STORY,1,0,0,0,30,31
Pre-K Teacher Family,0,0,0,0,15,15
The Horticulturati,0,0,0,0,4,4
The Tour Breakaway: Cycling Podcast,0,0,0,0,4,4
The Nugget Climbing Podcast,0,0,0,1,28,29
Goforth & Golf,0,0,0,0,5,5
Blind Shots Podcast,0,0,0,0,4,4
A People's History of Kansas City,0,0,0,0,8,8
Mill House Podcast,1,0,0,0,63,64
Stoopkid Stories,3,0,0,2,45,50
The WIGO Show: Sex-Talk and Sex Stories,0,0,1,0,5,6
The Arbour Affect,1,0,0,1,5,7
from Architecture to PROFITecture,0,0,0,0,3,3
Smart Family Podcast,0,0,0,0,3,3
From Phenom To The Farm,0,0,0,2,16,18
LSHTM Viral,0,0,0,0,1,1
How to Save the Planet,0,0,0,0,1,1
SLP Coffee Talk,0,0,0,0,30,30
The Antique Shop,0,0,0,0,40,40
This is 40!,0,0,0,0,4,4
The Babesment,0,0,0,0,34,34
Become an Askable Parent with AMAZE,0,0,0,0,5,5
The Cabin,3,0,0,0,70,73
Joe List's Mindful Metal Jacket,1,2,0,0,47,50
Hot Takes on a Plate,0,0,0,0,10,10
Dating While Gray,1,1,3,2,33,40
Verified,8,4,16,16,116,160
Flyers Talk: A Philadelphia Flyers Podcast,4,2,0,1,7,14
Serious Privacy,0,1,0,0,1,2
FOR LIFE: The Podcast,0,0,0,1,34,35
Horror Movie Maniacs,0,0,0,0,5,5
Abraham Hicks,1,0,2,0,13,16
Whiskey&Watches,0,0,1,1,4,6
Hound Howl,0,0,0,0,4,4
The Self Esteem and Confidence Mindset,0,0,0,0,1,1
Jeep Life Podcast,0,0,0,0,27,27
The Upper Hand: Chuck & Chris Talk Hand Surgery,0,0,0,1,28,29
Seven Minute Torah,0,0,0,0,1,1
Simple Stories in Spanish,0,2,0,1,12,15
Disturbed: True Horror Stories,3,5,2,2,23,35
Infectious Groove Podcast,0,0,0,1,32,33
The Aviation RC Noob,0,0,0,0,3,3
ULSUM RADIO,0,0,2,1,10,13
Selling on Amazon with Andy Isom,0,0,0,0,47,47
Believer: A Paranormal Mystery,0,0,3,1,19,23
Killer Boobies Podcast,0,0,0,0,23,23
Fray Foto,0,0,0,0,1,1
Dirty Diversity,0,0,0,0,7,7
Once BITten!,0,0,0,0,9,9
Discovery Park,2,0,0,1,5,8
Audible Chess,0,0,0,1,3,4
Anthems,0,0,0,0,16,16
Always Evolving with Coach Mike Bayer,0,1,1,1,47,50
The Revealer,1,0,0,0,2,3
Lira Clinical Podcast - A SkinDepth Convo,0,0,0,1,2,3
How's Work? with Esther Perel,0,0,0,0,19,19
NALC’s Postal Record Audiobook,0,0,0,0,2,2
The Insurgents,4,0,1,1,44,50
"What If, discussed.",0,0,0,0,9,9
Fish and Game Changers,0,0,0,0,7,7
Locked On Padres - Daily Podcast On The San Diego Padres,8,1,2,0,6,17
Life Handmade by Scrapbook.com,0,0,0,0,50,50
Shallow Graves,1,2,1,1,51,56
Straight Up Sabres,0,0,0,0,1,1
The Pinball Network,1,1,3,4,23,32
The Hospice Chaplaincy Show with Saul Ebema,0,0,0,0,3,3
This Is Awkward,2,0,1,1,20,24
Creative Boom,0,0,0,0,11,11
Islanders Never Say Die Podcast,0,0,1,2,1,4
On The Chain - Blockchain and Cryptocurrency News + Opinion,0,0,0,0,2,2
The Matt Bernier Show,0,0,0,0,3,3
Less Is Morgue,0,2,0,0,28,30
MusicalSplaining,6,4,2,4,58,74
Dreams of Black Wall Street,0,0,1,2,25,28
Classic Children's Story Podcast,0,0,0,0,4,4
4-May,7,0,3,3,37,50
Ferrall on the Bench,2,1,0,0,13,16
Finding Your Village,0,0,0,0,32,32
Dr. Jockers Functional Nutrition,0,0,0,1,49,50
Knot Too Taboo,9,1,1,2,31,44
Win Make Give with Ben Kinney,0,1,0,1,48,50
The DewSweepers,0,0,0,0,3,3
The Victor Davis Hanson Podcast,6,5,4,7,331,353
Sister Wives Secrets,5,1,1,2,22,31
Coast to Coast With Bee'z And Art Bell,0,0,0,0,1,1
God's Big Story,2,0,1,2,45,50
Poem-a-Day,0,0,0,0,4,4
Dive Bomb Squadcast,0,1,0,1,317,319
Charlotte Mason Show,0,0,0,0,13,13
Lick The Rapper,1,0,0,0,49,50
Backcountry BSing,0,0,0,0,18,18
Hot Glue & Bobby Pins,0,0,0,0,6,6
Be the Bridge Podcast with Latasha Morrison,2,2,1,1,36,42
The Nicolas Cage Oral History Podcast,0,0,0,0,29,29
Content Creatives Podcast,0,0,0,0,5,5
Sister Act,0,0,0,0,7,7
Coaching U Podcast with Coach Brendan Suhr presented by Hudl & Hudl Assist,0,0,0,0,1,1
Straight Talk with John Hope Bryant,0,0,0,0,1,1
Living a Sensory Life,0,0,0,0,1,1
NEXT STOP,12,1,4,2,31,50
The Rush Limbaugh Show,59,1,2,3,270,335
Keep Shooting,0,0,0,0,13,13
The Summer House After Show Podcast,1,0,0,0,3,4
The Writers’ Co-op,1,0,0,0,11,12
German Ponce - La Biblia Palabra Infalible,0,0,0,0,1,1
Inside with Brett Hawke,0,0,0,0,10,10
Breaking Green Ceilings,0,0,0,0,27,27
WHY YOU SUCK AT GOLF!,0,0,0,0,7,7
Hold These Truths with Dan Crenshaw,2,0,0,1,47,50
Small Things Often,0,1,1,1,21,24
The Bert Show,3,0,1,5,41,50
Triple R Teaching,0,0,0,0,14,14
In Our Backyard Podcast,0,0,0,0,7,7
Embrace Your Real,0,0,0,0,50,50
Comeback with Erica Cobb,0,0,0,0,3,3
Con Todo: Brown Love,0,0,0,0,96,96
The Residency Podcast,0,0,0,1,85,86
A Breath of Fresh Earth,0,0,0,0,3,3
Running Rivals,0,0,0,0,5,5
Air Combat Sim,0,0,0,0,2,2
Somos LAFC Podcast,0,0,0,0,1,1
Colts Brawl,0,0,0,1,6,7
The Coffee Breakup,1,0,0,0,2,3
Let's Gut Real - Easy to Digest Nutrition Science,0,0,0,0,3,3
Daily Wisdom - Walking The Path with The Buddha,0,0,0,0,1,1
Mystery Recipe,3,1,3,3,40,50
The Bourbon Life,0,0,0,2,28,30
"Pitch, Please",0,1,0,0,3,4
Life of the Prophet Muhammad,0,0,0,0,3,3
Dumb Money LIVE,1,1,0,0,5,7
Hybrid Calisthenics Podcast,0,0,0,0,2,2
Love It or Weeb It! Anime Previews and Reviews,0,1,0,0,4,5
Dog Nerd Show,0,0,0,0,1,1
Guided Jewish Meditations,0,0,0,0,3,3
Lush in Lace - Erotic Audio,2,0,0,0,3,5
Fortnite,6,0,2,0,10,18
Netflix Is A Daily Joke,6,2,2,4,14,28
Locked On Lightning - Daily Podcast On The Tampa Bay Lightning,3,0,0,0,2,5
Mel Giedroyc is Quilting,0,0,0,0,5,5
Faux Reel Podcast,0,0,0,0,7,7
Face to Face by Dezeen,0,0,0,0,1,1
GOLF's Subpar,0,1,1,6,100,108
Perspective For Parents,1,0,0,0,20,21
Marathon Training for Beginners,0,0,0,0,48,48
Seth Rudetsky's Back to School,0,0,0,0,26,26
Setter Talk,1,0,0,1,2,4
On the Corner of Main Street,0,0,0,1,23,24
"The Dream Team Tapes: Kobe, LeBron & The Redeem Team",9,7,7,2,30,55
The Digital Gumbo Podcast,0,0,0,0,11,11
Of All Time,0,0,0,0,5,5
The United States Constitution,1,1,0,0,2,4
Creative Elements,0,0,0,0,75,75
The Prof G Show with Scott Galloway,13,6,7,11,129,166
The Left Right Game,0,3,12,16,19,50
7 in 7 An Educational Podcast for Kids,0,0,1,0,7,8
STAR WARS AUDIO ARCHIVES,0,0,0,1,3,4
The BosBabes,0,0,0,0,12,12
Shadow Work Library,0,0,1,0,8,9
DBT & Me,0,2,1,3,2,8
The Boyscast with Ryan Long,0,0,0,0,50,50
Banking on Digital Growth,0,0,0,0,4,4
Chowhound's Table Talk Podcast,0,0,0,0,1,1
Fifth Wrist Radio,0,0,0,0,1,1
I Weigh with Jameela Jamil,7,3,11,4,53,78
Just Interesting People,0,0,0,0,16,16
The Neverland Files,0,0,0,0,2,2
G.L. Lambert Explains It All,0,0,0,1,3,4
MLB Morning Coffee: A Daily MLB Podcast,3,0,0,0,13,16
FC Bayern Podcast,0,0,0,0,1,1
Everyday Decisions with Jo Firestone,0,0,0,1,49,50
The LoveCrafts show,0,0,0,0,5,5
What The Func?!,0,0,0,0,35,35
The CC Podcast,0,0,0,0,3,3
Freaking Out About Cincinnati’s Opening Day with Randy Freking,0,0,0,0,7,7
On The Verge - BSL Radio - Baltimore Orioles & Orioles Minor League Talk,0,0,0,0,6,6
Focus on Women,0,0,0,0,2,2
I'm So Gay,0,0,0,0,13,13
Forces for Nature,0,0,0,0,6,6
The Loose Head Podcast,0,0,0,0,2,2
Coronavirus Update,10,0,1,2,5,18
Locked On Fantasy Baseball - Daily MLB Fantasy Podcast,0,0,1,0,5,6
Jumping Bomb Audio,3,0,0,0,0,3
Are You Garbage? Comedy Podcast,1,0,0,0,49,50
Nonstop Nonprofit,0,0,0,0,3,3
The Grumpy Economist,1,0,0,0,9,10
LISK: Long Island Serial Killer,3,0,5,8,283,299
Here's The Sitch with Mike & Laurens,1,0,1,2,46,50
Screaming Cinema - A Horror Movie Podcast,0,0,0,0,34,34
Fade the Noise with Brad Evans,0,0,0,0,18,18
Beat The NMLS Test,2,0,0,0,0,2
It's Hertime.,0,0,1,0,11,12
Equinox,0,0,0,0,2,2
Political Theory 101,0,0,0,0,1,1
RUN WILD with Lauren and Bud,0,0,0,0,2,2
The APsolute RecAP: Biology Edition,0,0,0,0,24,24
Talking Tactics with Coach Gough,0,0,0,1,8,9
Boys Watching Girls,0,0,0,0,7,7
This Thing of Darkness,0,0,0,0,7,7
Philly Prime Podcast,0,0,0,0,6,6
Be Organic,0,0,0,0,17,17
3LiveREWIND,0,0,0,2,4,6
EPIDEMIC with Dr. Celine Gounder,12,2,5,1,30,50
Bankless,0,0,1,0,54,55
Running New Mexico Podcast,0,0,0,0,1,1
Awake with Rabbi Lauren Holtzblatt,0,0,0,1,14,15
Fertility Friendly Food,0,0,0,0,1,1
Bedtime Stories with R.A. Spratt,0,0,0,0,6,6
Hogsmen Podcast,0,0,0,0,5,5
The Metrospective: A show about the New York Mets,1,0,3,0,7,11
The Quick Daf,0,0,0,0,2,2
Your Attention Please,0,0,0,0,4,4
Fighting Words with Kurt Schlichter Podcast,2,1,0,0,4,7
Z107.7 FM Unique Garden Show hosted by Mike Branning,0,0,0,0,1,1
Device Nation,0,0,0,0,7,7
Seattle Now,3,1,0,0,46,50
Dynasty Theory Fantasy Football Show | Dynasty Fantasy Football,0,0,1,0,53,54
I Said No Gifts!,1,1,0,0,48,50
Baggs & Brisbee: A show about the San Francisco Giants,2,0,0,0,1,3
The Story Seeds Podcast,1,0,0,0,25,26
Homemaker Chic,5,3,7,1,34,50
AEW Unrestricted,5,6,5,9,117,142
The Radiology Review Podcast,0,0,0,0,11,11
Terrores Nocturnos,0,0,0,0,1,1
The People of Soil Health,0,0,0,0,2,2
Real Estate Rookie,6,4,5,5,80,100
Mastering Medicare,0,0,1,0,1,2
DFS Coach Talk Podcast,0,0,0,0,16,16
Prine Time,0,0,0,0,3,3
That's So Minnesota,0,0,0,1,4,5
Battle for 1600 with Sebastian Gorka and Boris Epshteyn Podcast,2,0,0,2,13,17
Rewire Your Attachment Style with Maya Diamond,0,0,0,0,19,19
The Take with Willie Mason,0,0,0,0,1,1
Enneagram 2.0 with Beatrice Chestnut and Uranio Paes,0,3,3,5,33,44
Super Nintendads Entertainment Podcast,0,0,0,0,14,14
We Danglin,0,0,0,0,23,23
The Lancet Voice,0,0,0,0,2,2
The Coop with Meyer Hatchery,0,0,1,0,22,23
King Of Keno,0,0,0,1,49,50
Max Allotment Podcast,0,0,0,0,2,2
The 73rd Hole,0,0,0,0,2,2
The Keith Law Show,6,0,0,1,33,40
New Discourses,2,0,2,1,45,50
All Spoiler Recap,0,0,0,0,41,41
The New Music Business with Ari Herstand,0,0,0,0,48,48
Ghost Echoes,0,0,0,0,1,1
Gospelbound,0,0,0,0,11,11
Into America,9,0,0,0,41,50
Out Of Nowhere,2,1,0,0,18,21
The Scribes of Summer: A show about the Los Angeles Dodgers,0,0,1,0,4,5
The Rolling Thunder podcast,0,0,0,0,2,2
Soju Bomb,0,0,0,0,1,1
Metal From The Inside,0,0,0,0,1,1
The Dating Game Killer,64,53,78,47,182,424
Picks Central,3,2,3,4,48,60
The Gulf,0,0,0,0,1,1
GT: Garage Talk,0,0,0,0,2,2
The Other Latif,0,1,1,0,7,9
Courtney: Beyond the Cake,2,0,1,3,53,59
Sales Maven,0,0,0,0,28,28
Hair of the Dog Podcast,0,0,0,2,44,46
SimplyPodLogical,0,1,0,2,47,50
The Genomics Life,0,0,0,0,2,2
Hand In The Dirt,0,0,0,0,33,33
World Record Podcast with Brendon Walsh,5,0,0,0,45,50
Hoy Quiero Contarles,0,0,0,0,4,4
Shane's Brilliant Podcast,0,0,0,0,7,7
Identity/Crisis,0,0,0,0,3,3
Deep Convection,0,0,0,0,5,5
SHOEphoria - The Bartold Clinical Podcast,0,0,0,0,1,1
Higher Energy,0,0,0,1,19,20
Hammer Lane Legends,2,0,0,1,81,84
Jesus Unfollower,0,0,0,0,10,10
Sew easy,0,0,0,1,1,2
21st Century Kindergarten,0,1,0,0,1,2
Hex Crypto Podcast | Hexican Backup of Richard Heart,0,0,0,0,1,1
Bingers Assemble: Godzilla vs. Kong,1,0,0,0,52,53
Dear Asian Americans,1,0,0,0,7,8
The Dirty Minds Podcast,0,0,0,0,9,9
Calm The Bleep Down Meditation & Mindfulness,0,0,0,1,4,5
One MANS Opinion with Jeff Mans,1,0,0,2,51,54
Tennis & Bagels Podcast,0,0,0,0,2,2
Forestcast,0,0,0,0,13,13
The Crawford Talks: A show about the Houston Astros,0,0,0,1,12,13
Self-Compassionate Professor,0,0,0,0,3,3
Elijah Rising,0,0,0,0,3,3
Younger with Dr. Robyn Benson,0,0,0,0,12,12
Flat Bottom Girls,0,0,0,0,10,10
The Farm Sim Show,0,0,0,0,1,1
Act Two Podcast,0,0,0,0,5,5
Music And Ideas,0,0,0,0,23,23
The Geek Bracket - A Trivia Podcast,0,0,0,0,1,1
The Professional Athlete Podcast with Ken Gunter,0,0,0,0,15,15
Real Personal Branding Podcast,0,0,0,0,30,30
Latter-day Ladypreneur,0,0,0,0,50,50
How to Be Superhuman,0,0,0,0,1,1
Das Coronavirus-Update von NDR Info,0,0,0,1,25,26
Kayfabe Culture,0,0,0,0,1,1
The Herbalist's Path,0,0,0,0,9,9
"Native Plants, Healthy Planet presented by Pinelands Nursery",1,0,0,0,24,25
The High Performance Podcast,1,2,0,4,90,97
First Kick Podcast,0,0,0,0,1,1
Healthy Runner Podcast,0,0,0,0,46,46
Talking Sopranos,20,21,32,28,399,500
Battlefield Next,0,0,0,0,1,1
Friend Forward,0,0,0,1,8,9
Arrive Alive!,0,0,0,0,27,27
Even the Rich,160,64,100,68,360,752
Locked On Longhorns - Daily Podcast On Texas Longhorns Football & Basketball,0,0,0,0,8,8
Daily Mind Medicine,0,0,0,0,20,20
The Deep Corner,0,0,0,0,2,2
Last Minute Blues Podcast,1,0,0,0,20,21
Everyday Mulemanship,0,0,0,0,39,39
Like A New Day - A Leica Photography Podcast,1,0,0,0,8,9
Cut Maker Podcast,0,0,0,0,2,2
The Tony Walker Podcast,0,0,0,0,3,3
More Than Profit,0,0,0,0,28,28
Driveline R&D Podcast,0,0,0,0,2,2
Affirmations 👏,0,0,0,0,2,2
Calm Christian Parenting,0,0,0,0,5,5
MARVELS,3,2,1,5,24,35
Fullerton Unfiltered,1,0,0,0,199,200
Beyond the Scrum: The Baseball Stories We Didn't Write,0,0,0,2,4,6
Supernatural with Ashley Flowers,28,16,24,26,86,180
The Graffiti Machine,0,0,1,1,14,16
The Walkthrough | HomeLight's Real Estate Podcast,0,0,0,0,17,17
Spies Like Us Podcast,0,0,0,0,3,3
Buddhism for Beginners,0,0,0,0,3,3
Behind The Feed,0,0,0,1,19,20
HAVOC,0,1,0,0,4,5
The Anti-MLM Podcast,17,10,7,2,24,60
Top 100 bedtime stories for kids,0,0,0,0,1,1
A Hot Dog Is a Sandwich,11,1,6,8,174,200
Novel Pairings,1,0,1,0,103,105
True Underdog,2,1,0,1,96,100
Gill Athletics: Track and Field Connections,0,0,0,0,12,12
Triple Play Fantasy’s Baseball Show,0,0,0,0,16,16
Black Girl Missing,0,0,4,2,35,41
Munsons at the Movies,0,0,0,0,5,5
The Too Many Men Podcast,2,1,0,0,14,17
The Center Cut Golf Podcast,0,0,0,0,7,7
Nassaumen Hockey Podcast,0,0,0,0,6,6
Mah Jongg Mondays podcast,0,0,0,0,26,26
SLP Corner,0,0,0,0,6,6
The Cellfie Show,1,0,0,0,49,50
Talk To Me In 100% Korean,0,0,0,0,1,1
Ordineroli Speaking,1,0,0,0,45,46
The Third Party: An Apex Legends Podcast,1,0,0,1,48,50
The Last Tenth Podcast,0,0,0,0,6,6
Women Influencing Post Production,0,0,0,0,1,1
Beyond The Showroom,0,0,0,0,1,1
The Uneducated Duo,0,0,0,0,8,8
Science Diction,4,0,1,6,54,65
Couched,0,0,0,0,4,4
I Survived,18,23,21,19,213,294
Amazin' But True: A NY Mets Baseball Podcast from New York Post Sports,0,1,2,1,41,45
The Imagine Neighborhood,0,0,1,1,48,50
I Spy with my Myo Eye...,0,0,0,0,6,6
Natural Prodcast,0,0,0,0,3,3
Predator Radio,0,0,0,0,4,4
10 Percent True - Tales from the Cockpit,0,0,0,0,1,1
Heme Review,0,0,0,0,15,15
Run For God: Run Club,0,0,0,0,4,4
Coronavirus: Everything You Need to Know,0,1,0,1,4,6
POLITICO Dispatch,2,1,0,1,20,24
Go and See,20,5,0,6,19,50
The Societies,0,0,0,0,2,2
Creative Ways Podcast,0,0,0,0,7,7
"Standup Comedy   ""Your Host and MC""",0,0,0,0,2,2
Outgrowth: A Slice of Pro Beauty,0,0,0,2,17,19
Coronavirus: Fact vs Fiction,44,11,11,11,342,419
Chrissie Mayr Podcast,0,0,0,0,50,50
The Dork-O-Motive Podcast,0,0,0,0,41,41
The WTF Bach Podcast,0,0,0,0,2,2
The North-South Connection,0,0,0,0,8,8
The PedsDocTalk Podcast,2,0,0,0,48,50
City of Women,0,0,0,0,1,1
What's Our Verdict Movies,0,0,0,0,8,8
Teamistry,1,0,0,0,31,32
It's Not A Crisis,1,0,0,2,28,31
The Ceramics Podcast,0,0,0,0,4,4
Crush Step 1: The Ultimate USMLE Step 1 Review (An InsideTheBoards Podcast),0,0,0,0,4,4
Strictly Anime,0,0,0,0,4,4
The Sidewalk Weekly,0,0,0,0,1,1
WDW Escape,0,0,0,0,7,7
Superman and Lois Radio,2,2,0,0,1,5
CrossFade: The Dueling Album Review Show,0,0,0,0,10,10
Goalie Hacks Podcast,0,0,1,0,68,69
Passion for the Pastime,0,0,0,0,4,4
Turn Your Followers Into Clients with Vanessa Lau,0,0,1,0,49,50
Trees and PhDs,0,0,0,0,5,5
Unfiltered Faith,9,2,3,6,254,274
Crimeaholics,1,2,3,6,31,43
Destination Sasquatch Podcast,0,1,0,0,1,2
Gino Time: A Boston Celtics Podcast,0,1,0,0,22,23
The Dabble Co. Podcast,1,0,0,0,49,50
The Plot Against America Podcast,4,1,2,0,51,58
Jerusalem Lights,0,0,0,0,1,1
Dr. NoSleep | Scary Horror Stories,1,0,0,2,27,30
Us Weekly's Bachelor Podcast - Here For The Right Reasons,5,1,1,1,18,26
The MEND Fly Fishing Podcast with Joe Rotter and Red's Fly Shop,0,0,0,0,4,4
The Greg Cote Show with Greg Cote,15,1,1,3,332,352
Floodlines,3,0,3,1,43,50
Pinstripe Pod: A NY Yankees Baseball Podcast from New York Post Sports,0,0,0,1,5,6
Dump 'n Change,0,0,0,1,10,11
Positively Trek,0,0,0,0,4,4
The Bad Boys Podcast,0,0,0,0,5,5
Coronacast,4,1,1,1,84,91
Dictionary.com's Word Of The Day Podcast,0,0,0,0,4,4
IEP Essentials Pro Tips with Wendy Taylor,0,0,0,0,3,3
Kottke Ride Home,11,7,6,4,108,136
Melton Forge Works Podcast,0,0,0,0,2,2
PlasticPills - Philosophy & Critical Theory Podcast,1,0,0,0,2,3
A Teen's Perspective,0,0,0,0,28,28
Free Range American Podcast,4,2,5,6,152,169
Privacy Please,0,0,0,0,9,9
Flying BC - Pilot Stories and Aviation Adventures,0,0,0,0,2,2
Rising Tide: The Ocean Podcast,0,0,0,0,2,2
The Screenwriting Life with Meg LeFauve and Lorien McKenna,0,0,0,0,84,84
Cardinal Aviation Audio Briefings,0,0,0,0,1,1
What Do You Call That Noise? The XTC Podcast,0,0,0,0,2,2
Hinduism Spirituality,0,0,0,0,1,1
The Ottobot Podcast,0,0,0,0,2,2
Stories of our times,13,0,7,6,68,94
Coronavirus Global Update,2,0,1,2,18,23
No Filter: A skincare podcast,0,0,0,0,5,5
Coffee With My Ex: Caleb Marshall and Haley Jordan,0,0,0,1,33,34
Texx Talks,0,0,0,0,16,16
Prepared Disc Golfers,1,0,0,0,5,6
SBJ Unpacks,1,0,0,0,1,2
Coffee and Cauldrons,0,0,0,1,29,30
One Minute Scripture Study: A Come Follow Me Podcast,1,0,0,0,74,75
The Blackthorn Grove,0,0,0,0,2,2
Bootleg Football,0,1,0,1,23,25
Adults Talking Anime +,0,0,0,0,1,1
The Homegirl Fox,1,0,0,0,29,30
F*** You Dad,0,0,0,0,6,6
Wheels On Fire : An Absolutely Fabulous Podcast,0,0,0,1,14,15
D&D Minus,0,0,0,2,48,50
The SoleSavy Podcast,0,0,0,0,3,3
Multiplayer Gaming Podcast,3,0,0,2,94,99
Stock Market Options Trading,0,0,0,4,20,24
Leadership Next,0,0,0,1,3,4
The Big Melt,2,1,1,1,28,33
The Real Python Podcast,1,0,0,0,5,6
Ghost Stories – A Rolls-Royce Podcast,0,0,0,0,1,1
Getting Over: Wrestling Podcast,1,1,1,3,147,153
Military History By Kids For Kids,0,0,0,3,5,8
Thirteen,5,3,3,1,38,50
Sailor Moon Fan Club,0,0,0,0,4,4
Queens of Adventure: Legends,0,0,0,0,5,5
Black Spin Global: The Podcast,0,0,0,0,2,2
Simple Doesn't Mean Easy,0,0,0,0,11,11
The Mysterious and Unbelievable Case of the Batboy and the Hot Dogs,0,0,0,0,7,7
Lean With Plants,0,0,1,0,49,50
Rondail's Unpopular Opinion,0,0,0,0,2,2
The Shelf Life: A Podcast Sitcom,0,0,0,0,3,3
Crossing Animals - an Animal Crossing New Horizons Podcast Series,0,0,0,1,48,49
Build Your Brand Podcast with Jeff Echols,0,0,0,0,3,3
ABC News Radio Specials,8,3,2,2,19,34
Surprisingly Brilliant,4,4,6,1,60,75
Strange Arrivals,8,7,4,2,29,50
The Unplugged woodworking podcast,0,0,0,1,1,2
Simple Homesteading Life,0,0,0,0,1,1
The Beauty Lounge,0,0,0,0,11,11
The Confessional with Nadia Bolz-Weber,10,1,8,6,278,303
Blowback,6,4,2,3,86,101
Dump N' Change Podcast,0,0,0,0,7,7
This Matters | Daily News Podcast,0,0,0,0,1,1
Heart Shaped Leaves After Dark Podcast,0,0,0,0,14,14
The BMW Podcast | Changing Lanes,4,1,1,0,3,9
No Puedes Jugar Boxeo El Podcast,0,0,0,0,1,1
Pair of Kings,0,0,0,0,30,30
Generation Jihad,2,0,1,1,30,34
The Fitness Movement: Training | Programming | Competing,0,0,0,0,14,14
Another Woodshop Podcast,1,0,1,0,48,50
Fiction Writing Made Easy,0,0,0,2,87,89
MLS Gone Wild,0,0,0,0,11,11
Mind of the Meanie,0,0,0,0,27,27
The Triton Incident,0,0,0,1,2,3
The Suga,0,0,0,5,45,50
The Missing Link for SLPs,0,0,0,0,1,1
MetFlex and Chill,0,0,0,0,50,50
Top of the Mook,0,1,2,0,47,50
Country Club Adjacent,1,0,0,0,29,30
Rink Stories,1,0,0,0,7,8
Dynamic Dialogue with Danny Matranga,0,0,1,0,49,50
Protection Dog Podcast,0,0,0,0,4,4
"From Borderline to Beautiful: Hope & Help for BPD with Rose Skeeters, MA, LPC, PN2",1,0,1,0,13,15
Dog Mom Podcast,6,0,0,1,15,22
The Unfiltered Motherhood Podcast,0,0,1,1,48,50
Interleaved: A Talmudic Podcast,0,0,0,0,4,4
Mike Gallagher Podcast,0,0,0,0,2,2
TFLTalk,0,1,2,1,10,14
The Larry Elder Show,1,0,0,2,47,50
Ask Kati Anything!,0,0,0,0,29,29
Behold Israel,2,0,0,0,31,33
Anime Brothers,0,0,0,0,1,1
Becoming Mama™: A Pregnancy and Birth Podcast by Motherly,2,1,0,0,3,6
Learn Taiwanese Mandarin,0,0,0,0,3,3
Mommin' With Friends,0,0,0,0,1,1
Beyond the Basement: The Attack on Titan Podcast,1,0,2,1,15,19
SGT Report's The Propaganda Antidote,5,3,0,3,36,47
Weaving Community w/Amy D. McKnight,0,0,0,0,1,1
Trail to 100,0,0,0,0,3,3
The Fight Site Podcast Network,0,0,0,0,1,1
GardenDC,0,0,0,0,2,2
Start - Le notizie del Sole 24 Ore,0,1,0,0,0,1
The Villager's Voice - an Animal Crossing podcast,4,2,1,0,35,42
Prince Kumi Live!,0,0,0,0,2,2
The Viral Volley Podcast,0,0,0,0,3,3
Books and Beyond with Bound,0,0,0,0,18,18
The Lefty’s Lounge,0,0,0,0,7,7
This Day in Esoteric Political History,1,2,5,3,39,50
frisellasallaroundtheyard's podcast,0,0,0,0,1,1
Dangerous World Podcast,3,1,0,0,40,44
Holding Kourt Podcast,0,1,0,0,42,43
Mythology & Fiction Explained,0,0,0,0,14,14
Work Matters With Ken Coleman,0,0,0,0,7,7
Trent Loos Podcast,0,0,0,0,1,1
Red Valley,0,0,0,1,23,24
Witchcraft Off the Beaten Path,0,0,0,0,15,15
Oscar Wild,0,0,0,0,4,4
Who's Saving the Planet?,0,0,0,0,15,15
The Sakara Life Podcast,2,0,3,3,42,50
Rigs of Dad Prodcast,0,0,0,0,2,2
Grow or Die Podcast,3,0,1,0,46,50
Find Your Beach,0,0,0,0,50,50
The PAPER STREET Podcast,0,0,0,0,1,1
SLP Nerdcast,0,0,0,0,6,6
"The Prather Point.  Uncensored, Unafraid, Outside the Box",1,0,0,0,5,6
Saltwater Edge Podcast,0,0,0,0,11,11
"All-In with Chamath, Jason, Sacks & Friedberg",19,5,5,11,137,177
Macro Hive Conversations With Bilal Hafeez,0,0,0,0,4,4
Kids Listen Activity Podcast,0,1,1,0,11,13
Meaningful People,0,1,0,1,125,127
Do You F*****g Mind?,4,2,2,0,168,176
Strange News Daily,2,1,2,1,30,36
The No Good Podcast,1,0,0,0,1,2
I Don't Need an Acting Class,1,0,0,0,12,13
Sarah Bowling - Living Genuine Love,0,0,0,0,1,1
Podioslave Podcast,0,0,0,0,12,12
Token CEO,13,4,3,3,177,200
I AM Beautiful Wild Free: A Guided Affirmation and Meditation Podcast,0,0,0,0,40,40
Quilt Buzz,1,1,0,5,43,50
Forerunners: The Surfline Podcast,0,0,0,0,1,1
Skyjacks: Courier's Call,0,0,0,0,21,21
Mind Yeti,1,0,0,1,1,3
Home Cooking,0,0,1,0,199,200
Dudes Talkin' Sports,0,0,0,0,2,2
Tripping on My Roots,0,0,0,0,1,1
Yes UConn!,0,0,0,0,3,3
The Dadass Podcast,0,0,0,0,4,4
Consider This from NPR,70,30,10,8,78,196
Animal Testing,0,0,0,0,1,1
Get With The Programming,1,0,0,0,25,26
Complete Spanish,0,0,0,0,6,6
Wild Ride! with Steve-O,5,1,1,5,162,174
Mind-Jam Podcast: Pet Health & Longevity,0,0,0,0,2,2
Marietta Daily Journal Podcast,0,0,0,0,20,20
Da Rona Report with Mandii B,0,0,0,0,2,2
UpNFlamez,0,0,0,0,11,11
Hunger Hunt Feast | Strategic Fitness,0,0,0,0,3,3
House Of Hockey Podcast,0,0,0,0,4,4
From Lab to Leader,0,0,0,0,2,2
Passport,0,0,0,2,40,42
The Hang with Ramin Karimloo,0,0,0,0,10,10
Nate The Hate,1,0,0,0,11,12
Mansplain Baseball Elsewhere,2,0,0,1,20,23
The Boat Life Podcast,0,0,0,0,14,14
The Simple BioTech Podcast,0,0,0,0,5,5
"Cancel Me, Baby!",0,0,0,0,1,1
How Long Gone,6,1,4,2,37,50
A BA Study Podcast,0,0,2,0,30,32
Elle’s Cottage Podcast,0,0,0,0,1,1
Locked On Big 12 - Daily College Football & Basketball Podcast,1,1,0,0,4,6
HSL Retriever Talk,0,0,0,0,1,1
#EnCasadeMara,0,0,0,0,1,1
Crypto-Z,13,5,2,3,27,50
"Psyched : Convos on Psychology, Relationships and Personal Growth",0,0,2,0,1,3
NurseSpeak,0,0,2,3,59,64
Faith 'N Fish'N,0,0,0,0,2,2
Timcast IRL,14,4,5,7,169,199
Black Box Down,11,6,14,10,332,373
Middle Children,0,0,0,0,50,50
TFL Talkin' Trucks,1,0,0,0,16,17
Dragonfly Tales,0,0,0,0,7,7
Criminalia,21,12,18,19,73,143
"Fake Doctors, Real Friends with Zach and Donald",8,8,11,12,298,337
Both World Tarantulas,0,0,0,1,2,3
Theo Rossi's THEOry with Kim Coates,1,0,0,2,289,292
But It Was Aliens,0,0,0,0,28,28
Swan Signal - A Bitcoin Podcast,2,0,0,0,14,16
The Cheat Code,2,1,0,3,52,58
Chad Ford's NBA Big Board - NBA Draft Podcast,5,0,1,6,22,34
Prophet Muhammad Podcast,0,0,0,0,2,2
StraightioLab,0,0,0,1,49,50
The Content Mines,0,0,0,0,5,5
Captain Kindergarten,0,0,0,0,5,5
Living your best life Podcast,0,0,0,0,6,6
Over the fence podcast,0,0,0,0,10,10
Shut The Front Door,0,0,0,0,1,1
What are YOU going to do with THAT?,0,0,0,0,3,3
Alice Cooper's Vintage Vault Podcast,0,0,0,0,14,14
TK PRODUCTIONS/MUSIC CRITIC,8,0,0,0,0,8
Commit Or Quit,2,0,0,3,492,497
Freedom Challenge Online,0,0,0,0,4,4
"Say Less With Kaz, Lowkey and Rosy",2,0,1,0,31,34
Field Ethos Journal,0,0,0,0,4,4
Casper Dog Training,0,0,0,0,1,1
The 9Gs Podcast - An Aviation Podcast,0,0,0,0,1,1
The Coronavirus Effect - Where Do We Grow From Here?,0,0,0,3,0,3
Daigle Bites,0,0,0,0,50,50
Tell Me About Your Pain,0,0,2,0,48,50
Ultimate Swimmer,0,0,0,1,3,4
Red Inker With Jarrod Kimber,0,0,0,0,6,6
The Plan on Purpose Podcast,0,0,0,0,6,6
Podcast M.D. for medical students By Erfan Sheikhbahaei|پادکست مشاوره پزشکی ام دی با عرفان شیخ,0,0,0,0,1,1
The Resetter Podcast,0,1,0,0,62,63
Phoebe Reads a Mystery,0,0,0,0,5,5
The Socially Distant Sports Bar,0,1,2,1,366,370
Deviant Gentlemen Podcast,2,0,1,0,47,50
The Wild Photographer,0,0,0,0,1,1
"Peace Lutheran Church, Sussex, WI",0,0,0,0,1,1
His and His,0,1,2,0,57,60
Henry Danger Universe With Maralyn Negron,0,0,0,1,4,5
Cancelled Movie Report,0,0,0,0,2,2
Greaux Rugby by GiftTime Rugby Network,0,0,0,0,1,1
Cajun and Creole Talk,0,0,0,0,2,2
Track and Field History with Jesse Squire,0,0,0,0,3,3
The Morning Ritual,0,0,0,0,39,39
Riled Up with Arielle & Matt,6,0,0,3,41,50
Tiny Toreros Story Time,0,0,0,0,2,2
Athletic Motion Golf- The Podcast,0,0,0,0,48,48
The Angry Joe Show Podcast,0,0,0,0,2,2
Sunday League: The Podcast,0,0,0,0,2,2
The Rachman Review,0,0,0,1,3,4
Pilates With Kate,0,0,0,0,3,3
Living with Landyn with Landyn Hutchinson,13,9,1,7,448,478
Daily Spiritual Antidote by Rabbi Simon Jacobson,0,0,0,0,1,1
In the Bubble: From the Frontlines,8,2,3,8,208,229
The Intercooler,0,0,0,0,10,10
Veterans Corner Radio,0,0,0,0,2,2
"Podcast in Hindi on Kids Moral Stories & Indian History, Hindi Kahaniya, हिंदी कहानियाँ, बाल",0,0,0,0,1,1
STRUCK: An Aerospace Engineering & Lightning Protection Show,1,0,0,0,1,2
All God's Women,0,0,0,0,11,11
Soy Claretiano,0,0,0,0,1,1
Time To Die,0,0,0,0,7,7
Banjo Studio Podcast,1,0,0,0,4,5
CannMed Coffee Talk,0,0,0,0,1,1
The Uptime Wind Energy Podcast,0,0,0,0,1,1
Barron's Streetwise,5,3,4,4,119,135
The Outlaw Nation Podcast Network,1,0,0,0,10,11
Barndominium Lifestyle,1,0,0,0,1,2
The Boneyard Podcast,0,0,0,0,15,15
Dark Side of Wikipedia | True Crime & Dark History,5,1,5,3,36,50
Modern Medicine Movement,0,0,0,0,46,46
Five-Tool Fantasy Baseball Podcast,0,1,0,0,13,14
UNHhhh,1,0,2,0,41,44
Blocked and Reported,20,11,6,8,247,292
At a Distance,0,0,0,0,13,13
A Runner’s Life,0,0,0,0,4,4
Headmirror's ENT in a Nutshell,0,0,0,0,17,17
Bob Saget's Here For You,3,3,4,5,35,50
Skeptics vs. Believers Podcast,0,0,0,0,5,5
Real Relationships Real Revenue - Video Edition,0,0,0,0,9,9
The Osterholm Update: COVID-19,8,2,5,8,206,229
The Mind Of George Show,0,0,0,0,50,50
The Latched Mama Podcast,0,0,0,1,4,5
The XLR8 Performance Lab Podcast,0,0,0,0,1,1
Charter Cities Podcast,0,0,0,0,4,4
Animalia,0,0,0,0,1,1
Real Narcos,1,0,1,7,41,50
Did You Wash Your Hands?,0,0,0,0,7,7
Seerah of Prophet Muhammad (sws) - Yasir Qadhi,0,0,0,0,2,2
The Wizard Scroll,0,0,0,0,3,3
"Your Enneagram Coach, the Podcast",0,1,1,2,53,57
Visionaries Audio Drama,0,0,0,0,35,35
The Funky Farm Girl,0,0,0,0,28,28
The Headgum Podcast,1,0,1,1,47,50
PetAbility  Podcast,0,0,0,0,4,4
The Game Changing Attorney Podcast with Michael Mogill,0,0,0,0,88,88
Checking In with Susan David,0,0,0,0,40,40
Reptile Talk,0,0,1,0,14,15
The Ask Joe Powder Powdcast,0,0,0,0,1,1
The Hidden Gnome Podcast,0,0,0,0,5,5
WorkWoman,0,0,0,0,17,17
Traffic Secrets: The Underground Playbook for Filling Your Websites and Funnels with Your Dream Cust...,1,0,1,0,48,50
The Plot Thickens,13,7,5,16,278,319
Don't Shoot The Messenger,0,0,0,3,41,44
Beyond Belief,0,0,0,1,24,25
"Lockdown Universe (A UFO, ALIEN, BIGFOOT, SCI FI AND PARANORMAL PODCAST!!)",0,0,0,0,2,2
Girl Mom Podcast,0,0,0,0,11,11
Trauma ICU Rounds,0,0,0,0,50,50
Seeking the Truth - Searching for Answers.,1,0,0,0,1,2
Serhant Soundtracks,0,0,0,0,3,3
MSL Talk,0,0,1,0,16,17
The Shit Show,2,1,0,0,10,13
The Tiger King After Show Podcast,5,1,0,1,1,8
Running Things,0,0,0,0,4,4
The Weight Loss Shift Podcast,0,0,0,0,17,17
The Pogcast,0,0,0,1,3,4
"Be Reasonable: with Your Moderator, Chris Paul",13,0,0,0,66,79
Seek Outside Podcast,0,0,0,0,3,3
Finding Humanity,0,0,0,0,7,7
Time For Lunch,0,0,0,0,6,6
Sony Alpha Photographers,0,0,0,0,2,2
Early Call Time,0,0,0,0,5,5
Dear Fathers Podcast,0,0,0,0,19,19
Talk'n Shop,2,0,0,2,184,188
Bananas,0,0,1,1,48,50
Treasure Island 2020,1,0,1,4,44,50
Birth Of A Nation,0,0,0,0,10,10
The Modern Homemaker,0,0,0,0,8,8
Questions from the Closet,1,0,1,0,93,95
The Emcee Podcast,0,0,0,0,5,5
knitting with confidence & hope,0,0,0,0,1,1
The Weekly Take from CBRE,0,0,0,0,8,8
Wine Blast with Susie and Peter,0,0,0,0,4,4
FRESHSQUEEZED 🍋,0,0,0,0,1,1
The Future of Learning and Development Podcast,0,0,0,0,6,6
Otaku Host Club,0,0,0,0,2,2
We're Having Gay Sex,2,1,1,0,46,50
Jurisprudence Course,1,0,0,0,7,8
The Compound - MLB Player Podcast,0,2,0,0,330,332
The GOTDamn Kylan Show,3,0,1,0,20,24
Coach Morton and Friends Real Talk,0,0,0,0,1,1
The Accidental Swingers,0,0,0,0,6,6
The Podcast from The Temple,0,0,0,0,4,4
Outbreak Alabama: Stories from a Pandemic,0,0,0,2,1,3
The Growth Equation Podcast,0,1,0,0,49,50
Fist Full of Dirt,0,0,0,0,61,61
Tokyo Inklings,1,0,0,0,21,22
The Fire Pit with Matt Ginella,0,0,0,0,108,108
Tomlin's Harmonica Podcast,0,0,0,0,7,7
What Would Love Do?,0,0,0,1,24,25
Let's Go! Hockey Podcast,0,0,0,0,17,17
Rough Cut Golf Podcast,0,0,0,1,5,6
Us Weekly's Getting Real with the Housewives,0,2,0,0,6,8
The CHEF Radio Podcast,0,0,0,2,10,12
Rudy Giuliani's Common Sense,15,0,0,0,35,50
Dish on Dogs Podcast,0,0,0,0,3,3
Spanking & All Things FemDom,1,0,0,0,0,1
TeapotOne - Bru Time,0,0,0,0,3,3
It's the Pictures that Got Small,0,0,0,0,8,8
Road to the Skeleton Coast,0,0,0,4,57,61
Rene Ritchie,2,1,0,1,17,21
Selling The Scream,0,0,0,0,3,3
The Frequency: Daily Vermont News,0,1,0,0,9,10
Sex and Psychology Podcast,1,0,0,0,8,9
Out with Suzi Ruffell,0,0,0,0,4,4
Inside The Groove - Madonna's Music,0,0,0,0,24,24
On Your Mark Wrestling Podcast,0,0,0,0,18,18
Journeys in Greenery with Hilton Carter,0,0,0,0,3,3
The Straight Shooter Recruiter,0,0,0,0,7,7
The Gunkhole State Park Podcast,0,0,0,0,6,6
The Art of Happiness with Arthur Brooks,0,0,4,0,45,49
Relatos De Horror (Historias De Terror),1,0,2,1,8,12
The Family Pupz Podcast,0,0,0,0,2,2
REimagine,1,0,0,0,1,2
The Kame House Podcast,0,0,0,0,2,2
Just Pod Baby! - A Las Vegas Raiders Podcast,0,0,0,0,2,2
Seeing Other People,7,3,5,4,40,59
NASA's Curious Universe,0,0,1,1,26,28
I'll Find Myself When I'm Dead,0,0,0,0,4,4
What's Gaby Cooking in The Wild,1,0,0,0,24,25
Knitting Nerdcast,3,0,0,2,19,24
The Measure of an Episode,0,0,0,0,2,2
K9 Mindfreak,0,0,0,0,2,2
Turtle Creek Lane,0,0,0,0,9,9
The Girls Uninterrupted,0,0,1,0,16,17
The Thomas Eriksen Podcast,0,0,0,0,6,6
"Self Care Club: Wellness, road tested",0,0,1,0,34,35
The Mom's Organization Motivation Podcast,0,0,0,0,39,39
Tango Alpha Lima Podcast,0,0,0,0,3,3
Ableton & Music Habits Podcast,0,0,0,0,1,1
Shaun101's Podcast,0,0,0,2,24,26
Common Goal,0,0,0,0,11,11
The Deep-Sea Podcast,0,0,0,0,3,3
Definitely Dylan,0,0,0,0,6,6
Lights Out Podcast,16,9,13,15,447,500
Brunch with Desb Podcast,1,0,1,0,48,50
The Debrief with Major Garrett,0,0,1,1,40,42
Road to Redline : The Porsche and Car Podcast,0,0,0,0,3,3
GoodFellows: Conversations from the Hoover Institution,3,3,1,1,12,20
The Detailing Business Class Podcast,0,1,0,0,7,8
Transformational Leadership with Henna Inam,0,0,0,0,2,2
"Oh, Hello: the P'dcast",0,0,0,0,50,50
My New Life,1,0,0,0,49,50
America's Offroad Podcast,0,0,0,0,2,2
WWE's The Bump,0,0,0,0,6,6
Dark Topic,1,1,1,2,253,258
Brutally Blunt with Jennifer & Katie,0,0,0,0,5,5
The My Little Eater Podcast,0,0,0,0,12,12
In The Light with Dr. Anita Phillips,0,0,0,1,49,50
The 7investing Podcast,1,0,1,0,7,9
Mostly Movies with Aaron Woodall,0,0,1,0,4,5
We Speak Beauty,0,0,0,0,45,45
Real Talk with Snoop and Lady S,0,0,0,0,1,1
Vanguard of Hollywood,0,0,0,0,5,5
Apokalypse & Filterkaffee,1,0,0,0,0,1
Erotic Audio by Audiodesires.com,0,1,0,0,0,1
"The Mistholme Museum of Mystery, Morbidity, and Mortality",0,1,0,0,5,6
EMS Today,0,0,0,0,1,1
At Last She Said It,0,0,0,1,32,33
Philanthropy 360 Podcast,0,0,0,0,1,1
How I Did It!,0,0,0,0,5,5
The Jesse Kelly Show,8,1,0,0,181,190
Backroad Exploration Podcast,0,0,0,0,2,2
Kennedy Dynasty,1,1,5,0,43,50
The Best Friends Podcast,0,0,0,0,9,9
Sunday Papers,8,4,2,2,34,50
The Breakdown with Robbie,0,0,0,0,27,27
MobCast Mafia Anime,0,0,0,0,6,6
Live Sound Bootcamp,0,0,0,0,4,4
Podcast Minute Talk Show,0,0,0,0,16,16
Making the Argument with Nick Freitas,2,0,0,0,36,38
Dear Culture,1,1,0,0,6,8
The Last Archive,8,4,4,7,27,50
Opinion Science,0,0,0,0,11,11
Lost Fore Words,0,0,0,0,3,3
Feedstuffs Precision Pork,0,0,0,0,1,1
Heal Your Heartbreak,1,0,0,1,48,50
The Paranormal Files (Official Podcast),0,0,0,0,29,29
Toward Light: Practical Buddhism for the Modern World,0,0,0,0,2,2
Jewelry Artist,0,0,0,0,9,9
The Joe and Todd Show,0,0,0,0,2,2
The Media Hijacked,1,0,0,0,3,4
The Sheep Show podcast,0,0,0,0,1,1
Feed Room Chemist: An Equine Nutrition Podcast,0,0,0,0,19,19
Mixed Tag,0,0,0,0,11,11
Glorious Professionals,0,0,0,0,39,39
Red Dice Diaries RPG Podcast,0,0,0,0,1,1
Teamcast,0,0,0,0,6,6
Madame Magenta: Sonos Mystica,0,0,0,0,10,10
Rebel Entrepreneur with Alan Donegan,0,0,0,0,21,21
Self Sufficient Hub,0,0,0,0,6,6
Gettin Gritty Wit It,0,0,0,0,1,1
Billy Gene Is Marketing Offends The Internet,2,0,0,0,48,50
Love What You Love,0,0,0,0,6,6
The Commercial Break,0,0,0,0,10,10
"Stop Scrolling, Start Sewing",1,0,0,0,4,5
Lessons Learnt with the Greats,0,0,0,1,1,2
Making Sense,0,0,0,0,14,14
Cousins By Blood,27,5,5,4,58,99
Mr Charlton’s Audio Stories,0,0,0,0,17,17
Bourbon & Banter,0,0,1,1,11,13
Jazz Focus,0,0,0,0,1,1
Imagine a Place,0,0,0,0,14,14
Flusterclux With Lynn Lyons: For Parents Who Worry,0,0,0,0,23,23
"Better Men, Better Ballplayers",0,0,0,0,1,1
OT: The Podcast,0,0,1,0,8,9
Saving Apollo 13 👨‍🚀,0,0,2,1,10,13
The Stubborn Light of Things,0,0,0,1,14,15
The Double Cleanse,2,1,0,0,197,200
Spencer Berke Podcast,0,0,0,0,8,8
Everything is Super Marvel,1,0,0,0,14,15
Holding Court with Patrick McEnroe,0,0,0,0,27,27
Conversations with Mike Milken,0,0,0,0,5,5
The #EladPod,0,0,0,0,1,1
"Dear Crochetpreneur® Podcast for Crochet Business Owners: Sellers, Designers, and Bloggers",0,0,0,1,6,7
History of the Second World War,0,1,1,6,14,22
Dog In The Yard,0,0,0,0,8,8
21st Century Spielberg,0,0,1,1,21,23
The Singing Success Show,0,0,0,0,1,1
HYDRATE with Tracy Duhs,0,0,0,0,50,50
Flour Hour Baking Podcast,0,0,0,1,4,5
Radio Advisory,0,0,0,0,14,14
Legal Talk Today,0,0,0,0,2,2
Yoga Inspiration,0,0,0,0,26,26
No Mercy: A Cobra Kai Kickback,1,0,0,0,4,5
'The Wire': Way Down in the Hole,65,25,31,31,181,333
Bawk Tawk! Welcome to Chickenlandia's 100% Friendly Chicken Show,0,0,0,1,3,4
Glitter and Garbage,0,0,0,0,21,21
The Slice,1,0,0,0,10,11
Zoned Out Turf and Golf,0,0,0,0,1,1
The Curious Competitor with Connor Carrick,0,0,0,0,16,16
Flashback: History's Unintended Consequences,5,0,2,3,40,50
The Way We Live Now,4,1,0,1,14,20
Light House,5,8,4,7,26,50
The Loud Boys,0,0,0,0,32,32
Real_bitch_shit,1,0,0,1,4,6
The Daytripper Podcast,0,0,0,0,2,2
Freestylin Life And Swim,0,0,0,0,2,2
Thomas & Friends™ Storytime (US),2,0,0,1,47,50
Missing in Alaska,84,76,45,29,144,378
Eric Krasno Plus One,0,0,0,0,27,27
The Shack Show,2,1,1,0,12,16
Startline,0,0,0,1,1,2
"Magnum, podcast - revisiting ""Magnum P.I.""",0,0,0,1,6,7
The Best of RSlash | Best Reddit Stories,2,1,4,1,9,17
Coronavirus (COVID-19) Q&A,1,0,5,0,8,14
The DFD Podcast: Live From Sunset Sound,0,0,0,0,3,3
The Style Files: Conversations with Creatives,3,1,1,4,36,45
La Pizarra con Nicky Mondellini,0,0,0,0,1,1
The Office Grunts,0,0,0,0,3,3
LOLz : A DFS Show,0,0,0,0,2,2
Don Juan’s of Dynasty,0,0,0,0,5,5
Everyday Māori,1,0,0,1,3,5
Life Coaching for Women Physicians,0,0,0,0,50,50
"The Sexiest Voice ASMR - Erotic Audio For Women, Romance Novels, Erotic Stories, Erotica And Much Mo...",14,0,1,0,1,16
Devin Townsend Podcast,0,1,0,0,24,25
Empowering Industry Podcast - A Production of Empowering Pumps & Equipment,0,0,0,0,15,15
Greatest Music of All Time,0,0,0,0,1,1
6th and Jump,2,0,1,0,70,73
The Critical Care Obstetrics Podcast,0,0,0,0,7,7
Kon-tiki Podcast,0,0,0,0,1,1
Dig & Swing,0,0,0,0,1,1
ENigmas unCHAINED,0,0,0,0,1,1
Beneath The Grandstand,0,1,0,0,3,4
The I/O Tower,0,0,0,0,1,1
"Rig Doctor Podcast: Tone Tips, Pedalboard Tricks, & Easy DIY Hacks",1,0,0,0,2,3
MTV Challenge Accepted,2,0,0,1,8,11
The Briefing,2,4,7,7,54,74
What The Flip Podcast,0,0,0,0,1,1
Katherine Ryan: Telling Everybody Everything,16,5,7,6,162,196
The Sociology Show,0,0,0,0,2,2
Gardening Utah Podcast,0,0,0,0,1,1
YHH Hockey Podcasts,1,0,0,0,3,4
Plantopia,0,0,0,0,1,1
Girl Why,0,0,0,0,50,50
Open Question,0,0,0,3,54,57
Cinema 9,0,0,0,0,10,10
TheWrap-Up,0,1,0,0,2,3
The Forza Napoli Calcio Podcast,0,0,0,0,5,5
"Hope, Through History",6,3,3,1,37,50
Diet Disruptors Podcast,0,0,0,0,6,6
Masters of Scale: Rapid Response,0,0,0,0,13,13
World of Warbirds,0,0,0,0,3,3
Jocko Unravelling,1,0,0,1,48,50
The Jboy Show,2,0,1,0,23,26
AJFF In Conversation: The Jewish Film Podcast,0,0,0,0,1,1
Millionaire Secrets,0,0,0,0,8,8
I Will Write Your Book,0,0,0,0,30,30
The Caddie Network Podcast,0,0,0,0,6,6
Bedtime Stories for Adults,2,0,0,0,4,6
Wealthy Mom MD Podcast,0,0,0,0,23,23
Rabbit Hole,12,9,9,6,87,123
The Daily Shine,0,0,0,0,23,23
Clean Comedy Time,0,0,0,1,5,6
PorterFlute Pod,0,0,0,0,4,4
X22 Report,44,4,3,5,185,241
Shout! A football podcast on the Buffalo Bills with Matt Parrino and Ryan Talbot,0,0,2,0,32,34
InsideEVs - Electric Vehicle News,0,0,0,1,0,1
Just Trek Podcast,0,0,0,0,10,10
Lady Don't Take No,0,0,0,1,65,66
The Beers on Heads Pod,0,0,0,0,1,1
Let's Do Life with Autumn Calabrese,2,1,1,3,43,50
Hot Takes & Deep Dives,15,3,2,2,158,180
Smith and Sniff,0,2,0,0,11,13
The Teaching Behavior Together Podcast,0,0,0,1,3,4
Hypnosis for Permanent Weight Loss,0,0,1,0,11,12
Garden Basics with Farmer Fred,0,0,0,0,18,18
Tech Won't Save Us,0,0,0,0,4,4
The ION Pod,1,0,1,0,7,9
Total Skin Nerds: Your Appt with the World’s Top Derms & Docs,0,1,0,0,3,4
On Deez Hoes,1,0,0,0,11,12
One Piece D&D,0,0,1,0,29,30
Built To Birth,0,0,0,0,12,12
BAPS Better Living,0,0,0,0,7,7
Surveillance Report,0,0,0,0,2,2
Town,0,0,0,0,5,5
"From Tip to Tail, a Podcast Dedicated to Animal Welfare",0,0,1,0,12,13
The Divorce Club,0,0,0,0,3,3
THE MOM CAST,0,0,0,0,4,4
Talk Nasty to Me,1,0,1,1,196,199
Killing Eve: Post Show Recaps,1,0,1,0,1,3
Watch With Jen,0,0,0,0,4,4
Design is Everywhere,0,0,0,0,7,7
What's a Grip?,0,0,0,0,6,6
Blue Collar Zen,0,0,0,0,3,3
The Best Advice Show,0,0,0,1,49,50
Bible Brothers,0,0,0,0,39,39
Serch Says,0,0,0,0,1,1
The Negro Baseball Leagues - Chattin' With The Legends with Byron Motley,0,0,0,0,4,4
Time To Say Goodbye,0,0,0,1,14,15
Triple Click,19,10,10,8,73,120
POPlitics,5,0,0,0,45,50
Pelvic PT Rising,0,0,0,0,23,23
"The Lights, Camera, Pro! Podcast",0,0,0,0,17,17
The Deliberation with Jacquis Neal and Rae Sanni,2,0,0,1,52,55
Spirituality,0,2,0,0,10,12
Fort Salem Witching Hour,0,0,0,0,10,10
Cracking One Health,0,0,0,0,1,1
Road Dog Podcast,0,0,1,2,35,38
The Jeff Ward Show,0,0,0,0,15,15
Lab in the Time of Coronavirus,0,0,0,0,3,3
Julie’s Library,0,0,3,5,42,50
Humorous Mathematics,1,0,0,1,2,4
Let's Get Technical,0,0,0,2,11,13
Primus Tracks,0,0,0,0,31,31
Nailed It Ortho,0,0,0,0,19,19
WHERE’S WALLO267,0,0,0,0,18,18
NATAL,1,0,0,0,34,35
Wording is Hard,0,0,0,0,3,3
Cake for Breakfast,2,1,0,0,91,94
The Choir Room: A Glee Podcast,0,0,0,0,34,34
Customer Service Revolution,0,0,0,0,1,1
There Is Always A Way with Dr. Jay Strack,0,0,0,0,21,21
Interracial Relationships,0,0,0,0,1,1
Dog in the Spotlight,0,0,0,0,4,4
The Waxing Podcast,0,0,0,1,24,25
The LA Report,0,0,0,0,1,1
DarbyCast,0,0,0,0,32,32
Closer Look with Rose Scott,0,0,0,1,4,5
The North Texas Gardener,0,0,0,0,7,7
LIW Anthology Series Review,1,0,0,0,0,1
Murder With My Husband,1,0,2,6,215,224
OceanPoddy,0,0,0,0,2,2
Philosophy of Psychoanalysis,0,0,0,0,3,3
Homeschool History,0,0,0,2,40,42
Jalen & Jacoby - The Aftershow,0,0,0,0,2,2
Brawl On - A Brawl Stars Podcast,2,0,1,1,19,23
Heroics,0,0,0,0,12,12
ETF Edge,0,0,0,1,6,7
The New Abnormal,48,27,38,36,351,500
Outrageous Love the Podcast: Our Journeys to Responsiveness,0,0,0,0,2,2
For Fact's Sake! Podcast,0,0,1,0,49,50
Barrel Racing,1,0,0,1,3,5
"Coach P's Perspective | Where Coaching, Inspiration, and Faith Collide.",0,0,0,0,64,64
Bigwater Fishing with Ross Robertson,0,0,0,0,1,1
Hebrew School,0,0,0,0,4,4
The Dog Show,0,0,0,0,1,1
Profit Answer Man: Implementing the Profit First System!,0,0,0,0,5,5
Trailer Trashing,0,0,0,0,62,62
Inside the Wires | Platform Tennis and Paddle podcast,0,0,0,0,3,3
"Good Morning, Kids",0,0,0,0,4,4
NESN Bruins Podcast,0,0,0,0,1,1
All Things Gymnastics Podcast,0,1,0,1,9,11
Basketball Journeys,0,0,0,0,3,3
Cut the Craft,0,0,0,0,22,22
The Joe Beaver Show,0,0,0,0,1,1
Not At The Dinner Table,0,0,0,0,2,2
Unpack ‘n Bounce Back,3,0,0,3,473,479
The Mermaid and The Lion,0,2,1,1,39,43
Movie Therapy with Rafer & Kristen,0,1,1,4,87,93
The BBR Podcast,0,0,0,0,7,7
True Spies: Espionage | Investigation | Crime | Murder | Detective | Politics,8,4,11,11,87,121
Beyond The Ring,1,2,0,0,24,27
I Married a Weeb - Anime Podcast,0,0,0,0,1,1
James Acaster's Perfect Sounds,0,0,0,0,13,13
The Long Thread Podcast,0,0,0,0,2,2
The Grant Williams Podcast,0,1,1,0,98,100
No Nonsense Catholic,0,0,0,0,2,2
The Sheridan Tapes,0,0,2,0,17,19
Steve Stine Guitar Podcast,0,0,0,0,10,10
Ladies Let's Talk About Sex,0,0,0,0,1,1
Full Impact: A Neon Genesis Evangelion Exegesis,0,0,0,0,2,2
From The Jingweeds,0,0,0,0,2,2
Sydney Sloth's Bedtime Stories (Lectio Divina for Kids),0,0,0,0,1,1
Making Stitches Podcast,0,0,0,0,1,1
DJ Ravish Remixes,0,0,0,0,2,2
Hushlife Podcast,0,0,0,0,21,21
Growing With It,0,0,0,0,1,1
Cinematic Heartland: A Filmmaking Podcast,0,0,0,0,2,2
Tales From A Gemini,0,0,0,0,4,4
Girl Gang Craft The Podcast,0,0,0,0,21,21
The Real DNA Podcast,0,0,0,0,2,2
Crew 1st Culture Podcast,0,0,0,0,5,5
The Poco a Poco Podcast with the Franciscan Friars of the Renewal,1,1,0,2,496,500
Armbar Audio,0,0,0,0,1,1
Living By The Lore,0,0,0,0,1,1
The Actual Astronomy Podcast,0,0,0,0,3,3
Modern Miss Mason,0,0,0,0,49,49
Slo Mo: A Podcast with Mo Gawdat,0,2,0,0,52,54
The One Minute News with Derek O'Shea,0,0,0,0,13,13
Matt and Alex - All Day Breakfast,3,0,0,3,87,93
The Church Boys,0,0,0,0,3,3
It's Not Just In Your Head,1,0,0,0,8,9
Inherited,1,1,0,0,22,24
Phoenix Cast,0,0,0,1,4,5
Grounded with Louis Theroux,8,8,4,16,364,400
Talking Politics: HISTORY OF IDEAS,0,1,1,1,50,53
Talking All the Things with Grace,0,0,1,0,1,2
Safari Stories,0,0,0,0,3,3
Creative Conversations with Suzy Menkes,0,0,0,0,7,7
NOQ Report,0,0,0,0,4,4
The Fairy God Barber,0,0,0,0,1,1
The Trey Gowdy Podcast,3,0,2,1,44,50
Banned Biographies,0,0,0,0,4,4
I Have Notes,0,1,0,0,3,4
Economics & Beyond with Rob Johnson,1,3,0,0,8,12
The Dharius Daniels Podcast,1,0,0,1,80,82
Profit First Nation,0,0,0,1,17,18
Corvette Today!,0,0,0,0,4,4
Blk Pod Collective: The Podcast,0,0,0,0,26,26
The Laughing Couple,0,0,0,0,19,19
Deep Dive Dynasty Podcast,0,0,0,0,1,1
The Ars Amorata Podcast,0,0,0,0,2,2
Quran for All Seasons,0,0,0,0,13,13
Two Pints with Will & Ralf,2,1,3,4,153,163
Block In The Back: Dynasty Fantasy Football,0,0,0,0,4,4
Making Fun of MacGyver,0,0,0,0,1,1
Biblical Genetics,0,0,0,0,2,2
Genetic Drift,0,0,0,0,4,4
The Urban Lab,0,0,0,0,12,12
"This Podcast is Making Me Thirsty (The ""Place to Be"" for Seinfeld fans)",0,2,0,0,4,6
LA MAGIA DEL CAOS con Aislinn Derbez,0,1,1,0,28,30
Kasher vs Kasher,0,0,0,0,5,5
The Founder's Journal,2,0,0,0,131,133
Molecule to Market: Inside the outsourcing space,0,0,0,0,4,4
Ask Dr. Ben,0,0,0,0,29,29
Inside-Out,0,0,0,0,1,1
Being Planful,0,0,0,0,5,5
Wind of Change,36,23,31,17,188,295
Closening with Jessie Kahnweiler,0,0,0,0,1,1
Brake Check,0,0,0,2,27,29
Stay Human,1,0,1,0,32,34
WBFO Brief,0,0,0,1,2,3
Gay Card Revoked,0,0,0,0,9,9
This Is Palestine,0,0,0,0,7,7
Learnings from Leaders: the P&G Alumni Podcast,0,0,0,0,15,15
Don't Be Ugly,0,0,0,0,2,2
The Insert Credit Show,0,0,0,0,48,48
United Basketball and Leadership Podcast,0,0,0,0,22,22
Titillating Stories,2,0,0,1,1,4
18Forty Podcast,0,0,0,0,17,17
On The Pond,0,0,0,0,6,6
Food Freedom Podcast,0,0,0,0,14,14
The New Generation Entrepreneur Podcast,0,0,0,2,90,92
Facing It,0,0,0,0,4,4
I'm Losing It! with Brian Krock,0,0,0,0,15,15
TEDx SHORTS,0,0,0,0,7,7
Bastard Radio,2,0,0,1,47,50
Fancy Scientist: A Material Girl Living in a Sustainable World,0,0,0,0,3,3
The ABMP Podcast | Speaking With the Massage & Bodywork Profession,0,0,0,0,4,4
ARE WE ON AIR ?,0,0,0,0,17,17
K9 Aptitude,0,0,0,0,16,16
Baby-Led Weaning Made Easy,0,0,0,0,50,50
North American Missions UPCI,0,0,0,0,1,1
The Showtime Podcast with Lakers Legend Coop,0,0,0,0,22,22
Dynasty Hotsauce Podcast,0,0,0,0,3,3
Trek Untold: The Star Trek Podcast That Goes Beyond The Stars!,0,0,0,0,6,6
Ramen Hunter,0,0,0,0,1,1
The Owlsteins,0,1,0,0,9,10
Big Lists,0,0,0,0,4,4
Going to Bed with Garcelle,0,0,0,0,50,50
All Ears with Abigail Disney,1,0,0,0,7,8
More Than Running with Dana Giordano,0,0,0,0,4,4
The Squidge Rugby World Cup Retrospective,0,0,0,0,1,1
Name Drop San Diego,0,0,0,0,8,8
Physics After Hours,0,0,0,0,1,1
The Human Experience,0,0,0,0,4,4
Duel of the Fates,0,0,1,0,5,6
Real Talk with Pastor Rema,0,1,0,0,3,4
Teens Talk,1,0,0,0,0,1
Tales of Space: Noksvale Moon,0,0,0,0,2,2
The Oklahoma Breakdown with Ikard and Lehman,2,0,3,0,87,92
The Fill with Phil Podcast,0,0,0,0,6,6
My Favorite Friendship,0,0,0,0,3,3
Let's Go Together,0,0,0,1,20,21
Thrilling Tales of Modern Capitalism,3,0,0,1,6,10
Keep It Locked With Simon Hill,0,0,0,0,1,1
It Starts With Attraction,0,0,1,2,47,50
Tama's Island,2,0,2,1,38,43
During The End Phase - A Yu-Gi-Oh Podcast,1,0,0,1,6,8
No Stupid Questions,8,7,8,10,137,170
On the Step with thatmallardguy,0,0,0,0,32,32
Conversations with Big Rich,0,0,0,0,3,3
The Juicy Hour with Nene,0,0,0,0,3,3
NWCZradio's Down The Rabbit Hole,1,0,0,0,20,21
MARK CROSSFIELD GETTING STUCK INTO GOLF,0,0,0,0,8,8
In Moscow's Shadows,0,0,0,0,6,6
Off Topic with Tom Arnold,1,0,1,0,12,14
The RC Hangout,0,0,0,0,8,8
The Balanced Parent Podcast,0,0,0,0,12,12
A Touch More with Megan Rapinoe & Sue Bird,0,0,0,0,23,23
Can't Stop Watching,0,0,1,0,13,14
Dirty Giants,0,0,0,0,3,3
Legendary Mindset,0,0,0,0,2,2
Just Trust Us,0,0,0,0,1,1
The Alphabetical Fugazi,0,0,0,0,10,10
Eidolon Playtest,0,0,0,0,8,8
Top Landing Gear,0,0,0,0,1,1
Stacking Slabs,0,0,0,0,16,16
Michael Jackson: Unspun,0,0,0,2,4,6
The MeidasTouch Podcast,1,1,1,3,44,50
The WILDCAST,0,0,0,0,50,50
Trey and Kevin Change the World,0,0,0,0,4,4
Rob Beckett and Josh Widdicombe's Lockdown Parenting Hell,6,4,0,8,482,500
6 Ranch Podcast,0,0,0,0,9,9
4th Line Voice Podcast,0,0,0,0,4,4
IS THIS ON?,0,0,0,0,1,1
Ho Ho Hong Kong,0,0,0,0,15,15
Learn Spanish and Go,0,0,0,1,30,31
I Think We're Good Here: Volleyball Podcast,0,0,0,0,8,8
ROHStrong Podcast,0,0,0,0,3,3
Until All Are Free,0,0,0,0,35,35
Motive for Murder,22,32,38,12,80,184
The HomeKit Show,0,0,0,1,2,3
Field of Vision Sports - Fantasy Football & Baseball Podcast,0,0,0,2,239,241
Rise Through Style,0,0,0,0,23,23
724 STG: Insight Thru Experience Podcast,0,0,0,0,2,2
The Rabbi's Husband,0,0,0,0,4,4
Cooking In Mexican From A to Z,0,0,1,1,5,7
East2West_WLS: The Podcast,0,0,0,0,11,11
Experimental Aircraft Channel's Podcast,0,0,0,0,1,1
The Epic Order of the Seven - The Podcast,0,0,0,0,4,4
Lab Notes,0,0,0,0,1,1
Final Gravity,0,0,0,0,1,1
Second Serve Tennis,0,0,0,0,17,17
Spooky Science Sisters,0,0,0,0,6,6
The Road to Medical Sales Podcast,0,0,0,0,50,50
The Johanna Konta Podcast,0,0,0,1,0,1
Tribe of Hackers Podcast,0,0,0,0,3,3
Cyclist Magazine Podcast,0,0,0,0,1,1
Five Questions,0,0,0,0,1,1
The PathPod Podcast,0,0,0,0,9,9
Truth vs Hollywood,6,9,7,9,69,100
Waldy and Bendy's Adventures in Art,0,0,0,0,13,13
The Scope of Practice Podcast,0,0,0,0,55,55
The Eddie Jones Coaching Podcast,0,0,0,0,1,1
Homemade,1,0,2,4,40,47
Lark: Fallen Gods,0,0,0,0,16,16
The Sarah Scoop Show,0,0,1,0,2,3
The Dissenters with Debra Messing and Mandana Dayani,22,1,2,0,123,148
Biscuits & Jam,0,0,0,1,39,40
Get Tucked!,0,0,0,0,6,6
Heated,0,0,0,0,1,1
Kickin' Back,0,0,0,0,13,13
PODCAST-19: FiveThirtyEight on the Novel Coronavirus,5,2,3,5,20,35
Team Deakins,2,0,0,3,55,60
Beverly Hills 90210 Show,2,1,3,1,30,37
The Outer Reach: Stories from Beyond,0,1,0,1,18,20
"The Hat-Trick, presented by the ICC",0,0,0,0,18,18
Beaver State Podcast,0,0,0,1,8,9
The Last Looks Podcast,0,0,0,0,12,12
Annie and Eddie Keep Talking,2,2,1,1,494,500
Free Email List Building Course with Jenna Kutcher,0,0,0,0,2,2
Media Roundtable,0,0,0,0,3,3
The Directors Box  |  A Football Business Podcast,0,0,0,0,1,1
Son of a Hitman,26,4,9,4,22,65
Fox News Rundown Evening Edition,0,1,0,0,0,1
The RAF and Backcountry Flying,0,0,0,0,1,1
Down The Line,0,0,0,0,5,5
The Relaxed Dog,0,0,0,0,3,3
The Open Podcasts,0,0,0,0,52,52
In Bad Taste,0,0,0,0,9,9
The Pursuit of Outdoor Clues,0,0,0,0,5,5
The Run Healthy Podcast,0,0,0,0,7,7
Enough Wicker: Intellectualizing the Golden Girls,0,0,0,0,15,15
Do Your Crap,0,0,0,1,42,43
FactSet U.S. Daily Market Preview,0,0,0,0,2,2
Girl At The Game,1,0,0,1,20,22
Roger Moore's Cubby Hole,0,0,0,0,4,4
One Visit Away,0,0,0,0,40,40
TAC Right Now,1,1,1,1,7,11
How'd You Do It?,0,0,0,0,14,14
DumpStat - A D&D Podcast,0,0,0,0,3,3
MMA UNCENSORED,0,0,0,0,19,19
Just Being ERNEST,0,0,0,0,21,21
Movies That Changed My Life,0,0,3,0,50,53
Professional Weaver Podcast,0,0,0,0,3,3
The Keys To The Kingdom,0,0,0,0,4,4
Interdependence,0,0,1,0,3,4
Shank Happens,2,0,0,0,76,78
My Jewish Parents,0,0,0,0,2,2
Chris Chan: A Comprehensive History,0,0,0,0,4,4
30 Minutes to President's Club | No-Nonsense Sales,0,0,0,1,49,50
Can You Survive This Podcast?,2,2,1,2,21,28
Fertility Education,0,0,0,0,13,13
Scaredy Cats,0,0,0,0,1,1
The Destination Angler Podcast,0,0,0,0,1,1
Talking Sleep,0,0,0,0,4,4
The Online Business Show,0,0,0,0,62,62
Legends Never Die,2,1,0,1,3,7
Radio Headspace,5,0,2,6,34,47
Moldcast,0,0,0,0,3,3
On The Journey Conversations,0,0,1,2,25,28
Meant For This,0,0,0,0,18,18
Pretty Soul,0,0,0,0,7,7
God Hears Her Podcast,0,1,0,3,127,131
Control the Controllables,0,0,0,0,7,7
Let's Talk About Cool Animals!,0,0,0,0,18,18
The Boulet Brothers' Creatures of the Night,0,0,0,0,105,105
Ink & Paint: A Journey Through the Disney Animated Classics,1,0,0,0,1,2
Sowing and Reaping Audio Podcast,0,0,0,0,1,1
Break the Diet Cycle,0,0,0,0,12,12
POP ART,0,0,0,0,4,4
Story time for Kids,0,1,0,0,4,5
Get Some with Gary Owen,0,0,0,0,11,11
That UFO Podcast,0,0,1,0,16,17
To The Pen,0,0,0,0,1,1
KPMG Financial Reporting Podcast Series,0,0,0,0,1,1
Out and Back,1,1,2,1,33,38
The Daily Smile,3,2,3,4,131,143
DODReads: What are you reading?,0,0,0,0,21,21
Living with Reality with Dr. Robert Svoboda,0,0,0,0,2,2
Vertical Farming Podcast,0,0,0,0,4,4
Millennial Life Crisis,5,2,3,4,86,100
This Is Not A Cult Podcast,0,0,0,1,16,17
From Rock Bottom to Rockin' It,1,0,0,1,15,17
Liquor and Liqueur Connoisseur,0,0,0,0,2,2
No Doubt: A Shin Buddhist Approach,0,0,0,0,1,1
Spanish to English,1,0,0,0,3,4
TheSync Podcast,1,0,1,1,281,284
Next Shift - More Than A Hockey Podcast,0,0,0,0,24,24
The History Of European Theatre,0,0,0,0,3,3
We're Listening: A Frasier Podcast,0,0,0,0,10,10
The Colion Noir Podcast,1,0,1,3,81,86
How'd She Do That?,1,0,0,0,22,23
TommyInnit Life Lessons,2,0,0,0,22,24
Dynasty Addicts Podcast Network,0,0,0,0,8,8
The Delta Flyers,2,3,4,9,115,133
Laidlaw's Harley-Davidson,0,0,0,1,11,12
The Valorant Show,0,0,0,0,53,53
MoneywebNOW,0,0,0,1,7,8
Inspire To FIRE Podcast (Financial Independence Retire Early),1,0,0,1,21,23
Cat Chronicles,0,0,0,0,1,1
Scarlett Moffatt Wants to Believe,4,0,0,2,71,77
PSI/Persona,0,0,0,0,3,3
ASCP Esty Talk,0,0,0,0,3,3
News Du Jour,0,0,0,0,12,12
JOANNA BECK PODCAST,0,0,0,0,14,14
Okashi Na Podcast: Anime With Friends!,0,0,0,2,2,4
State of Demand Gen,0,0,1,0,11,12
Good in Theory: A Political Philosophy Podcast,0,0,0,0,8,8
"Dom's Club: Film, TV, Comedy & Books with Dominique Mobley",0,0,0,0,1,1
Two Funny Mamas,2,1,1,2,124,130
Sick Empire,0,0,0,0,31,31
Alicast,0,0,0,0,50,50
JuHeardMe,0,0,0,0,15,15
Not Invisible: Native Womxn on the Frontlines,0,0,0,0,5,5
The ADHD Good Life Podcast,0,0,0,0,10,10
Inside the Wolf’s Den an Entrepreneurial Journey with Shawn and Joni Wolfswinkel,0,0,0,0,2,2
RomComPods,4,1,3,3,39,50
"Send Me To Sleep Podcast - World's Sleepiest Stories, Meditation & Hypnosis",1,0,4,6,39,50
Instagram Insider Hacks,0,0,0,0,50,50
Nature Centered from Wild Birds Unlimited,0,0,0,0,17,17
The blondEST,2,0,0,0,198,200
Hoot & a Half with Matt King,4,7,3,4,32,50
Instrumental with JJ Heller,0,1,0,0,161,162
Podraculous: A Miraculous Ladybug Podcast,0,0,0,1,0,1
One Bell Trader Joe's,0,0,1,0,0,1
SLASH HER,0,0,0,0,4,4
This Universe,0,0,0,0,1,1
Mindfulness for Kids,0,0,0,0,1,1
Ugh! You're So Good!,0,1,1,2,18,22
The business of vulnerability,0,0,0,0,1,1
You Are Not Alone w/ Spiritual Medium Erika Gabriel,3,0,0,1,44,48
Package Design Unboxd - with Evelio Mattos,0,0,0,0,9,9
Monster Fuzz,0,0,0,0,7,7
Deep Sleep Sounds,4,1,1,5,32,43
247Sports Football Recruiting Podcast,1,3,2,2,44,52
Adventures in Quilting,0,0,0,0,3,3
Talking Tennis Southern Style,0,0,0,0,1,1
Baseball BBQ,5,3,1,4,31,44
Plum Forest Podcast,0,0,0,1,10,11
The Jets Way,0,0,0,0,9,9
KnightSA89 - MidTempo Sessions Uploads,0,0,0,1,11,12
Tori Dealing With,0,0,0,0,50,50
WHY GACHA LIFE IS A TOXIC COMMUNITY,2,1,2,4,13,22
Black & White & Read All Over: for Juventus fans,1,0,0,0,5,6
Donuts and Devos,0,0,0,0,9,9
Podcast Of The Planet Of The Apes,2,0,0,0,3,5
Qanon FAQ,44,0,0,0,6,50
A Sense of Well-Being with Shayna Taylor,0,0,0,1,13,14
AA Big Book Workshop,0,0,0,0,5,5
Redditor,5,0,2,2,41,50
Hop Culture,0,0,0,0,6,6
The Ace Space,0,0,0,0,3,3
We're Getting a Dog,0,0,0,0,1,1
Hot and Rich,0,1,0,1,48,50
B.M.W. (Black Millennial Women),0,0,0,0,20,20
Fantastic Tales: A Bedtime Podcast for Kids,1,0,1,1,23,26
Birdies & Bourbon,0,1,0,0,25,26
"Learning to Surf - Talks on Buddhism, Dharma and riding the waves of life",0,0,0,0,1,1
Breaking Balls with Emily Nyman,0,0,0,0,17,17
Mile Marker,0,0,0,0,1,1
Hard Men Podcast,3,0,0,0,26,29
Fantasy Golf Pod,1,0,0,0,27,28
Dare To Be,0,2,0,1,52,55
Equip and Empower with Christine Caine,0,0,0,0,5,5
Hey It's The Luskos,0,2,0,1,42,45
FIREFIGHTER AND EMS STORIES,0,0,0,0,2,2
The Secret Adventures of Black People,0,0,0,0,18,18
AEW Uncensored Podcast,1,0,0,0,8,9
The Mrs. Bush's Story Time Podcast,0,0,0,0,2,2
The Wayward Pilot Podcast,0,0,0,0,7,7
The Grunge,0,0,1,0,5,6
Acid Horizon,0,0,0,0,4,4
The Defiant,0,0,0,0,2,2
The Happy Runner,1,0,0,0,0,1
The Plant Nook,0,0,0,0,3,3
Science + God with Dr. G,0,0,2,0,13,15
Where We Live,0,0,0,0,9,9
Genuine JBH,0,0,0,0,4,4
Quarantine Creatives with Heath Racela,0,0,0,0,9,9
Quality Queen Control,0,0,1,1,18,20
Print Design Podcast,0,0,0,0,12,12
The HC Insider Podcast,0,0,0,0,17,17
Global Health Pursuit,0,0,0,0,12,12
The Program Podcast,0,0,0,0,4,4
Committed to Create,0,0,0,0,174,174
make joy normal:  cozy homeschooling,0,0,0,0,5,5
The Kingcast,7,1,4,3,62,77
Let's Vibe With It,0,0,0,0,10,10
WHAT WENT WRONG,0,0,2,1,61,64
Hot Takes With Matt Gaetz,46,0,3,1,377,427
The Darin Olien Show,1,1,2,5,41,50
The Direct Sales Podcast: the BEST advice from top leaders and coaches,0,0,0,1,7,8
Hope in Darkness: The Josh Holt Story,17,15,26,8,51,117
2PAC MUSIC PODCAST,0,0,0,0,1,1
Let's Have a Drink - with Denver Sean,1,0,1,3,38,43
Stand Up Comedy,0,0,0,0,1,1
Ariana Grande,0,0,0,0,4,4
We Are What We Eat: Pay The Farmer Not The Pharmacy,0,0,0,0,3,3
The Tech Edit by Vogue Business,0,0,0,0,1,1
People & Music Industry,0,0,0,0,1,1
The Contact Sheet,0,0,0,0,20,20
AMAPIANO PANDEMIC,0,1,0,0,8,9
Learn Spanish Vocabulary (Cognates),0,0,0,0,1,1
From the Woodshed,0,0,0,0,16,16
The Devil's Music with Pleasant Gehman,0,0,0,0,9,9
Boom/Bust: HQ Trivia,5,3,5,2,53,68
Water Colors Aquarium Gallery,0,0,0,0,5,5
The Humble U Podcast,0,0,0,0,6,6
The Justin Moore Podcast,0,0,0,1,170,171
The Non Essentials Podcast,0,0,0,0,1,1
EMS 20/20,0,1,0,0,37,38
(De eso no se habla),0,0,0,0,3,3
The Nagging Naturalist,0,0,0,0,2,2
The Proven Principles Hospitality Podcast,1,0,0,0,4,5
CROSSNET Volleyball Podcast,0,0,0,0,15,15
We Get Dubbed,0,0,0,0,10,10
Wine 101,1,0,0,0,15,16
Empire Building,0,0,0,1,68,69
Greekly Speaking,0,0,0,0,1,1
Spanish for Beginners Pedro,0,0,0,0,4,4
Wisteria Gays | A Desperate Housewives Podcast,1,0,0,0,10,11
Wrestle Buddies,0,0,0,0,10,10
Citizen Chef with Tom Colicchio,3,0,1,1,27,32
nesmith tork goffin & king,0,0,0,1,0,1
Women Birders (Happy Hour),0,0,0,1,4,5
Calm Kids,0,0,0,1,0,1
What's Essential hosted by Greg McKeown,0,0,1,1,48,50
Strong Men Strong Marriages,0,0,0,0,15,15
The Korean Beauty Show Podcast,0,0,0,0,7,7
Stand up comedy for everyone,0,1,0,0,1,2
Vanity Lab,0,0,0,0,6,6
Life of Coco Chanel,0,0,0,0,1,1
Off The Mound with Ryan Dempster,1,0,0,0,1,2
Cubs Weekly,0,0,0,0,4,4
JR SportBrief,0,0,0,0,2,2
Crazy Dog Lady Podcast,0,0,0,0,3,3
Wong Notes,0,0,0,0,22,22
Caribbean Cricket Podcast,0,0,0,0,1,1
It Was Simple: The Betty Broderick Murders,43,35,31,25,49,183
3ABN Sabbath School Panel,0,0,0,0,2,2
Radio Chicken,0,0,0,0,1,1
Everything Real Estate: Connecting Ideas With Action,0,0,0,0,7,7
Tae & Todd Washington Football Podcast,0,0,0,0,8,8
Behind the Bima,1,0,0,1,49,51
Island Crime: Gone Boys,0,2,4,1,10,17
Heaven Bent,0,0,0,0,4,4
Dirty John Season 2: The Podcast,2,0,0,0,1,3
Champions for HD Podcast,0,0,0,0,2,2
Behind the Golf Brand Podcast with Paul Liberatore,1,1,0,7,191,200
That's What Schur Said,0,0,0,0,1,1
Purple Insider - a Minnesota Vikings and NFL podcast,2,3,1,1,105,112
Spooked,2,0,0,0,3,5
The Functional Breeding Podcast,0,0,0,0,6,6
De Todo Un Mucho,1,0,0,0,20,21
Thanks For Coming In,0,0,0,0,2,2
Borrasca,1,2,0,3,44,50
WWF: The Legacy Series,0,0,0,0,1,1
You Tube,1,0,0,0,0,1
The Superset,0,0,0,0,7,7
Inside Joke: Space Force,0,1,0,0,4,5
REACH A Space Podcast for Kids,0,0,0,1,15,16
Any Given Monday,0,0,1,0,3,4
Where Do I Start,0,0,0,0,7,7
Wylde In Bed: Erotic Audio Stories at Bedtime,0,0,0,1,7,8
Let's Talk,0,1,4,0,123,128
Hollywood Party,0,0,0,0,17,17
My Town,0,0,0,0,50,50
The Prosecutors,12,6,3,9,364,394
Transparency - The Podcast | w/ Eshon & Zara,0,0,0,0,8,8
Mindful Moments for Families and Schools,0,0,0,0,3,3
Get Hard! With Jaide Alicia,0,0,0,0,3,3
The Collin Kartchner Podcast,2,0,0,0,48,50
Left to Our Own Devices with Erica Keswin,0,0,0,0,19,19
Tottenham Podspur,0,0,0,0,5,5
Conversations with the Hostess,0,0,0,0,9,9
BFDI - Bedtime Stories For Children,1,0,0,0,0,1
Project Medtech,0,0,0,0,1,1
Sports Performance Training,0,0,0,0,28,28
The Fourth Messenger Podcast - Teachings and Art from the Sangha,0,0,0,0,1,1
Recap and Gown,2,0,0,0,15,17
Box 13,0,0,0,0,2,2
Action Filmmaking Decoded- The Story of Action Films,0,0,0,0,6,6
Prepare to Brace! The Snowpiercer Podcast by Pod Clubhouse,0,0,0,0,2,2
We Need to Calm Down: a Taylor Swift Podcast,0,1,0,0,16,17
Bottom Bracket Biking,0,0,0,0,5,5
The Album Years,0,1,1,1,85,88
Far Flung with Saleem Reshamwala,1,2,0,3,72,78
Canis Hoopus: for Minnesota Timberwolves fans,0,0,0,0,4,4
"NONSENSIBLE w/ Sam, Dave, and Saul",1,1,1,2,110,115
Movies That Raised Us,0,0,0,0,12,12
Prairieland Paranormal Podcast,0,0,0,1,8,9
The Mikhaila Peterson Podcast,4,3,2,5,80,94
Time Has Come,0,0,0,0,19,19
Let's Talk - Movies,0,0,0,0,1,1
Golf Under Par Podcast,0,0,0,0,3,3
In Your Shoes With Mauro Porcini,0,0,0,0,4,4
The U.S. Soccer Podcast,0,0,2,0,11,13
Money 4 Nothing,0,0,0,0,3,3
The Curious Clinicians,0,0,1,0,15,16
Space Policy Pod,0,0,1,0,1,2
The Aviation Spotters Podcast,0,0,0,0,3,3
Imperfect Strangers,0,0,0,0,129,129
Dr. GPCR Podcast,0,0,0,0,1,1
The Next Stage,0,0,0,0,2,2
Axios Today,23,14,11,8,89,145
Xbox Empire,1,1,0,0,8,10
Run Pure Sports DFS Pods,0,0,0,0,12,12
The Tomorrowland Times Podcast,0,0,0,0,2,2
Easy Peasy Finance for Kids and Beginners,0,0,0,0,1,1
The Wakeup,0,0,0,0,7,7
The Ten News,2,1,1,0,29,33
Find Your Focus,0,0,0,1,98,99
Speaking of Resilience,0,0,0,0,3,3
Elite Week - Your American Elite Dangerous Podcast,0,0,0,0,5,5
THE DARLING JOURNEY,1,0,0,0,28,29
The Mistress Carrie Podcast,0,0,0,0,42,42
"Husband Help Haven Podcast: Marriage Advice for Men Facing Separation, Affair or Divorce",0,0,0,0,7,7
Two Sides of the Spectrum,0,0,0,0,6,6
Beyond Solitaire,0,0,0,0,3,3
Black History for White People,4,2,0,2,28,36
Ultra Hope Girls: A Danganronpa Podcast,0,0,0,0,11,11
The Yamcast,0,0,0,0,5,5
DTC Podcast,0,0,0,0,1,1
Nibblybits,0,0,0,0,18,18
Horror Movie Crew Podcast,1,0,1,1,21,24
There R Giants,0,0,0,0,4,4
Wholesale Hotline,0,0,0,0,69,69
"Real Money, Real Experts",0,0,0,1,5,6
Everyday American English,0,0,0,0,1,1
The Lo Life,0,1,1,3,495,500
"Dear Diary, You're Effed!",1,0,1,0,72,74
Laughing with Myself,0,0,0,0,24,24
Modern Jewish Girl,0,0,0,0,13,13
Good for a Weekend: A Taylor Swift Podcast,0,0,0,1,36,37
La Oficina de Hoy,0,0,0,0,16,16
I Quit ____ and Started Running,0,0,0,0,5,5
The Official The Last of Us Podcast,1,0,0,0,49,50
The New Craft House Podcast,1,0,0,0,0,1
Shop Sounds Podcast,0,2,0,0,30,32
The Trauma-Informed Lawyer hosted by Myrna McCallum,0,0,0,0,4,4
The Golden Hour,0,0,0,0,5,5
KristianUltra Trail Running Podcast,0,0,0,0,1,1
How I F*ck,0,0,0,0,16,16
All That Glitters,0,0,0,1,59,60
Sex Stories by Audiodesires.com,0,0,0,0,2,2
Dirt Rich,0,0,0,0,1,1
Sorry We're Stoned with Tish & Brandi Cyrus,2,0,0,0,165,167
Sunny Side Up Nutrition,0,0,0,0,4,4
The Medical Sales Podcast,0,0,0,0,29,29
Affirmation Kids,0,0,0,0,1,1
I'm New Here: A Podcast for New Instructional Designers and E-Learning Developers,0,0,0,0,12,12
"Past, Present, Future, Live!",0,0,0,0,8,8
MIKED UP with Mike Woellert,0,0,0,0,13,13
Planet Normal,1,0,0,0,9,10
Preferred Lines Podcast,0,0,0,1,31,32
The Open Seat,0,0,0,0,19,19
Titan Upload Network,0,0,0,0,2,2
Politicology,37,6,8,9,440,500
But I Played One on TV,0,0,0,0,1,1
Spill the Beans Podcast,0,0,0,0,4,4
Overshare with Joslyn Davis & Lily Marston,0,0,1,1,21,23
Talking Shtick,0,0,0,0,3,3
F**kface,0,0,1,2,47,50
Emotional Storytelling with Twyla Jones,0,0,0,0,25,25
Hughes and Mincks: Ghost Detectives,0,0,0,0,2,2
The Podcast by KevinMD,0,0,0,0,28,28
#moldfinders: RADIO,0,0,0,0,13,13
Seven Deadly Sinners,5,1,8,2,112,128
Science Fiction Remnant,0,0,0,0,6,6
The BUMP Podcast,0,0,2,2,17,21
The Daily Study,0,0,0,0,2,2
The Deep,0,0,0,0,3,3
The Iced Coffee Hour with Graham Stephan,1,0,2,0,22,25
You Can’t Disappoint a Podcast,0,0,0,0,3,3
The Tap and Go,0,0,0,0,1,1
Pod Sing Se: An Avatar The Last Airbender Podcast,0,0,0,0,6,6
Cryptocurrency for Beginners: with Crypto Casey,0,0,0,0,4,4
Back of the Shul,0,0,0,0,15,15
Higher Learning with Van Lathan and Rachel Lindsay,28,1,4,0,466,499
A Man on a Mattress who Watches Movies,0,0,0,0,3,3
What Makes It Great?,0,0,0,0,1,1
Conversations About Running,0,0,0,0,1,1
Primas Chismosas,0,0,0,0,3,3
Opening Weekend,0,0,0,0,14,14
"Actually, It's Good",0,0,0,1,4,5
EVERYNIGHTNIGHTS PODCAST,0,0,0,0,78,78
The Company of the Mad: The Stand Podcast (Discussing The Stand by Stephen King in a Global Pandemic...,4,1,2,1,18,26
Burst,0,0,0,0,5,5
Refining Politics and Culture,4,0,0,0,99,103
A Quilting Life Podcast,0,1,1,0,44,46
Rise of the Divine Feminine,0,0,0,0,3,3
Maximum Growth Live!,0,0,0,0,3,3
Bulgogi Pod,0,0,1,0,32,33
Autism Parenting Secrets,0,0,0,0,21,21
Monday's With Mindy,0,0,0,0,15,15
festivalPass Stories,0,0,0,0,5,5
Doing It Different,1,0,0,0,49,50
Real Food. Real Conversations.,0,0,1,1,21,23
A Bit of Optimism,0,0,0,0,3,3
50 Years of Music w/ 50 Year Old White Guys,0,0,0,0,23,23
No Lie with Brian Tyler Cohen,5,1,2,5,487,500
The Riffhard Podcast,0,0,0,0,15,15
Left of Boom | A Military.com Podcast,0,0,0,0,8,8
Mike Birbiglia's Working It Out,0,0,0,0,50,50
The Nifty Show: Digital Collectibles and NFTs Podcast,0,1,0,0,5,6
XO Higher Self,0,0,0,0,34,34
Cosmic Gestures : A Vedic Astrology Podcast,0,0,0,0,1,1
Robservations with Rob Liefeld,1,0,1,2,55,59
"THE FROTH with RHOD GILBERT, SIAN HARRIES & Friends - Comedy Podcast",0,0,0,0,5,5
Agents of Change Social Work Test Prep,0,0,0,0,1,1
The Knees Over Toes Podcast,0,0,0,0,7,7
The Iran Podcast,0,0,0,0,18,18
NBA Draft Junkies,0,0,0,0,5,5
Citizen Farmers,0,0,0,0,22,22
Lookin’ For Game w/ Freeway Ricky Ross,0,1,0,0,1,2
New Growth with Nikki Walton,0,0,0,0,9,9
Madison's Notes,0,0,0,0,5,5
Tuk Tuk Till I Die,0,0,0,0,1,1
Beyond Crafting: Creating Your Most Inspired Life.,0,0,0,0,50,50
"Tools of Titans: The Tactics, Routines, and Habits of World-Class Performers",10,6,1,0,17,34
Deep Cover: The Real Donnie Brasco,0,0,1,1,42,44
Stories Of Mahabharata ( From Beginning),0,0,0,0,2,2
Raw vs Nitro - Reliving The War,0,0,0,0,10,10
Nuclear Waste: The Whole Story,0,0,0,0,11,11
The Modesty Files,0,0,0,1,16,17
Speaking to Influence,0,0,0,0,45,45
Black Plant Chick Pod,0,0,0,0,13,13
The TBC Provoke Podcast,0,0,0,0,1,1
Donkey Podcaster,0,0,0,0,1,1
Deep Questions with Cal Newport,2,4,3,3,139,151
House on Fire,0,0,0,0,10,10
A Film and A Movie,0,0,0,1,20,21
The Consistency Project,0,0,0,0,29,29
Conspirituality,22,5,4,4,65,100
The Vanishing Act,0,0,1,0,10,11
HomeKit Insider,0,0,1,0,40,41
The Godfrey Audio Guide,0,0,0,0,3,3
The Electric Theater with Clown,0,0,0,0,2,2
"Deep Dives and Deep Cuts: the History of Punk, Post-punk and New Wave (1976-1986)",0,0,0,0,9,9
Hand Made,0,0,0,0,15,15
Running and Fitness With Raj,0,0,0,0,2,2
On the Edge with Andrew Gold,0,0,0,1,9,10
That Jiu Jitsu Podcast,0,0,0,1,1,2
Happy & Healthy with Jeanine Amapola,2,0,0,0,48,50
The Sabian Podcast,0,0,0,0,1,1
Type Talks,0,0,0,0,3,3
Fear the Talking Queers,0,0,0,0,8,8
Severed Studios,0,0,0,0,2,2
You've Heard It Said,0,0,0,0,10,10
African Folktales: Traditional Bedtime Stories for the Modern Kid,0,0,0,0,25,25
Untitled Beatles Podcast,0,1,0,0,3,4
The Render,0,0,0,0,7,7
Fit For Golf,1,0,0,0,4,5
MCU in Review - WandaVision and All Marvel Cinematic Universe,2,1,1,0,24,28
When Belief Dies,0,1,0,0,4,5
The Podcast of Power: A She-Ra Companion Podcast,0,0,0,0,7,7
Marathon Swim Stories,0,0,0,0,1,1
Glow Up with LaLa,0,0,0,0,5,5
So Much Pingle,0,0,0,0,14,14
The Wrestling Life Support Podcast,0,0,0,0,3,3
Hello Ranger,0,0,0,0,15,15
Rollin' With The Punches,0,0,0,0,1,1
"Sleep Calming and Relaxing ASMR Thunder Rain Podcast for Studying, Meditation and Focus",0,0,0,1,6,7
2 Cents FC,0,0,0,0,1,1
Burning Man LIVE,1,0,0,0,6,7
Real Dictators,0,1,0,0,8,9
Up to Par golf podcast,0,0,0,0,1,1
RC Scrap Pile,0,0,0,0,6,6
Judo No Mi,0,0,0,0,1,1
Terrible Lizards,0,0,0,0,8,8
Coffee and Cosleeping,0,0,0,0,15,15
Tap it In Podcast,0,0,0,0,3,3
The Bad Broadcast,1,0,0,0,49,50
Shonen Flop,0,0,0,0,50,50
Movement Podcast,0,0,0,0,20,20
GirlTrek's Black History Bootcamp,2,1,2,4,84,93
Sound Expertise,0,0,0,0,1,1
The Antithesis of Superwoman,0,0,0,0,3,3
The Saad Truth with Dr. Saad,0,0,1,0,34,35
Joe Bonamassa's Live from Nerdville Podcast,0,0,0,0,5,5
The Nick & Matt Show,0,0,0,0,34,34
The Turnbuckle Tavern,0,0,0,0,17,17
#IMOMSOHARD,0,0,0,0,50,50
The Joe Walsh Show,1,0,0,0,6,7
Kiss My Aesthetic Podcast,0,0,0,0,7,7
GI EndoCast,0,0,0,0,4,4
The XRP Bully Show,0,0,0,0,2,2
"Sports Talk with Jason, Ed & B-DOE",1,0,0,0,0,1
The Kojima Frequency,0,0,0,0,4,4
Krew Season Podcast,0,0,0,0,42,42
Muriendo de Bella,0,0,0,0,2,2
Hungry Generation Leadership,0,0,0,0,5,5
We Got The Runs,0,0,0,0,9,9
Double Century with Jarrod Kimber,0,0,0,0,5,5
DRONERESPONDERS,0,0,0,0,1,1
Cinematic Underdogs,0,0,0,0,1,1
Real Marriage with Mark & Grace Driscoll,0,0,0,0,31,31
10 Minutes With AY,0,0,0,1,2,3
Living Mirrors with Dr. James Cooke,0,0,0,1,3,4
Broadway Biz with Hal Luftig,0,0,0,0,1,1
"British History: Royals, Rebels, and Romantics",0,0,0,0,9,9
Will Run For...,0,0,0,0,26,26
The Jew Next Door,0,0,0,0,1,1
Un petit caoua? (French Podcast for beginners),0,0,0,0,2,2
Dune Pod,0,0,0,0,18,18
Norris Nuts Fan Podcast,2,1,0,0,2,5
Blow Your Mind (BYM S02),0,0,0,4,4,8
TRILLOQUY,0,0,0,0,6,6
The Car Throttle Podcast,0,0,0,0,8,8
"Makers, Figuring It Out",0,0,0,0,1,1
Ten Minutes in Scrapbooking,0,0,0,1,3,4
Late Night Shots,0,0,0,0,2,2
The Wintering Sessions with Katherine May,0,0,0,0,2,2
The Strangest Secret by Earl Nightingale,0,0,0,0,2,2
California City,5,5,2,3,35,50
Games To Play On Roblox!,4,0,0,1,3,8
The Institute of Black Imagination.,0,0,0,1,15,16
Long May You Young,1,0,0,0,25,26
The Hoffman Podcast,0,0,0,1,4,5
Unfinished,17,6,9,12,177,221
Audiolibros,0,0,0,0,3,3
The Coaches Network Podcast,0,0,0,0,2,2
Pathways - With the Free Jacks,0,0,0,0,3,3
Tennis Legend Podcast,0,0,0,0,1,1
9XM Song Secret,0,0,0,0,2,2
Biblical Meditations To Restore Your Soul,0,0,0,0,1,1
Get WIRED,1,2,0,0,12,15
The Pitchfork Review,6,3,1,2,9,21
Cuentos y Leyendas de Honduras,0,0,0,0,1,1
The Divine Messages Podcast,0,0,0,0,5,5
The PCOS Girls Podcast,0,0,0,0,9,9
Crying In Public,1,0,0,1,74,76
A Feminine Impression,1,1,0,2,28,32
Motivational Speeches,0,0,0,0,1,1
Ward Wrestling Live,0,0,0,0,2,2
Chesapeake Conversations,0,0,0,0,1,1
Aliens & Artists,0,0,0,0,6,6
"HammerCast - Fantasy Football, BBQ, Bourbon, and Beer",0,0,0,0,15,15
Back to Bayside,0,0,1,1,19,21
Meta Pod: A Pokemon TCG Podcast,0,0,0,0,24,24
Dadz,0,0,0,0,10,10
MCAT Modules - Review,0,0,0,0,1,1
Cafecito con Estrellita,0,0,0,0,35,35
Evanston Rules,0,0,0,0,15,15
Pathfinder,0,0,0,0,1,1
The Science of Personality Podcast,0,0,0,1,2,3
Wizarding World,0,0,1,0,3,4
Chasing Frets,0,0,0,0,6,6
The Rice Stuff,0,0,0,0,3,3
Law of Attraction Changed My Life,3,1,3,4,289,300
The Quackalope Podcast,1,1,1,1,35,39
Chomping Down the Dietetic Exam,0,0,0,0,22,22
The Paper Fold,0,0,0,0,3,3
How Did This Not Get Made,0,0,0,0,1,1
Here Lies Amicus,0,0,0,0,2,2
The Fresh and Fit Podcast,1,0,0,0,0,1
SolveItForKids's podcast,0,0,0,0,4,4
Purposeful Social Selling,0,0,0,0,66,66
Two Mikes with Michael Scheuer and Col Mike,0,0,0,1,3,4
TechNoBros,0,0,0,0,7,7
That Beauty Podcast,0,0,0,0,4,4
Two Messianic Jews,0,0,0,0,3,3
Morning Scoop: Daily Buckeye Show,1,0,1,0,13,15
Spanish Stories for Kids,0,0,0,0,15,15
The DK DFS Show,0,0,0,0,7,7
Dennis Prager Podcasts,3,0,0,0,31,34
"Richard Diamond, Private Detective",0,0,0,0,1,1
Within & Between,1,0,0,0,3,4
The Shadow,0,0,0,1,2,3
Hugh Hewitt Podcast,2,0,1,0,1,4
Extra Spicy,5,1,1,1,11,19
True To The Culture Podcast,0,1,0,0,32,33
90 Day Fiance Crazy In Love,1,0,1,2,27,31
Wear It Down: The Queer Killing Eve Podcast,0,0,0,1,2,3
The CPG Guys,0,0,0,0,17,17
Victory The Podcast,9,2,5,8,476,500
An Even Bigger Fly On The Wall,0,0,0,0,2,2
The Quash,2,0,1,1,48,52
Moontower Soccer: An Austin FC Podcast,0,0,0,0,4,4
Gone Flyin,0,0,0,0,2,2
EcoRight Speaks,0,0,0,1,24,25
The ultimate minecraft podcast,7,0,3,10,27,47
Smart Talks,0,0,0,0,6,6
FOOD TRUCK JOURNEY,0,0,0,0,5,5
"Girls Gone Healthy - Workout Motivation and Food Guide to Live a Cheap, Easy Healthy Lifestyle for C...",0,0,0,0,50,50
The Bright Morning Podcast,0,0,0,0,50,50
The Hypnobirthing Podcast,0,0,0,0,6,6
Makers of Maine,0,0,0,0,2,2
UNKUT KRITIKA,3,1,1,4,80,89
Spiritually Hungry,0,0,1,1,55,57
Park Predators,70,65,90,43,232,500
Colors: A Dialogue on Race in America,0,0,1,0,1,2
Uncommon Core,0,0,0,0,34,34
Gunsmoke,0,0,0,0,1,1
Behind The Skies,0,0,0,0,1,1
Long Shots,0,0,0,0,1,1
Dadville,0,0,0,0,50,50
Welcome to Your Fantasy,3,0,0,0,0,3
Bleav in Rugby Talk,0,0,0,0,11,11
Autism In Real Life,0,0,0,0,2,2
Chasing Justice,0,0,0,1,28,29
Sports Gambling w/ Moneyline Monaco,0,0,0,0,13,13
The Turn,0,0,0,0,3,3
Commute Internal medicine board review,0,0,0,0,1,1
Potwatchers,0,0,0,0,1,1
Coffee Break Conversations,0,0,0,0,1,1
Maino Presents: Kitchen Talk,0,0,1,2,9,12
Spy Stories,0,0,0,0,1,1
Blue Earth,0,0,0,0,1,1
Ask Away,0,0,0,0,1,1
Sound Mind Set,0,0,0,0,1,1
"McIntosh ""for the love of music…”",0,0,0,0,2,2
The Quilting Arts Podcast,0,0,1,1,12,14
SoFi Daily Podcast,1,0,0,0,4,5
Rotten Mango,1,0,0,3,22,26
Bare With Us,2,0,1,2,100,105
Swinging Flamingos,0,0,0,0,1,1
Talking Derry Girls,0,0,1,1,11,13
Salty Stories: The Ship's Log,1,0,0,0,4,5
What's Up with Docs Podcast,0,0,0,0,1,1
The Weekly Scrap,0,0,0,0,2,2
Complex Trauma Recovery; We Are Traumatized M***********s,0,0,0,0,11,11
Nani no Anime Podcast,0,0,0,0,50,50
The New Mom Boss Podcast,0,0,0,0,50,50
Dungeons & Drimbus,0,1,0,0,44,45
ocean sounds,1,0,0,1,1,3
Marketplace Minute,5,3,0,1,14,23
Plat Chat VALORANT,0,0,0,0,5,5
Let’s talk Gacha,0,0,0,0,2,2
Running Stitch - A QSOS Podcast,0,0,0,0,5,5
ROBLOX Piggy,10,1,1,1,10,23
"Should I Buy It, Though?",0,0,1,1,32,34
The Product Marketing Experts,0,0,0,0,6,6
Eyewitness Beauty,4,3,4,2,74,87
The Groupchat Golf Podcast,0,0,0,0,17,17
God & a Gram,0,0,0,0,5,5
The Harrowing,0,0,0,1,29,30
The Moving To Florida Show,0,0,0,0,2,2
History Is Dank,0,0,0,1,49,50
Prose in Practice,1,0,0,0,0,1
The Roast of Your Teenage Self,1,1,0,1,33,36
The Right Side with Doug Billings,7,1,0,0,22,30
Elevate Construction,0,0,0,0,8,8
Allerton Park Bird Club Podcast,0,0,0,0,6,6
Richest Men in Town,0,0,0,0,4,4
SENTINELS: POINT OF NO RETURN,0,0,0,2,12,14
The Voices of The Vic,0,0,0,0,1,1
We Suck At D&D,0,0,0,0,8,8
E-Ticket to Broadway,0,0,0,0,43,43
Savage Love,1,0,1,3,3,8
America The BREW-tiful,0,0,0,0,5,5
Kids Mindfulness Meditations. A Podcast for Kids,0,0,0,0,4,4
Dive Stories,0,0,0,0,28,28
The Last Hit,0,0,0,0,1,1
Alcohol-Free Lifestyle,0,0,1,0,36,37
The 42nd Stitch Podcast,0,0,0,0,2,2
When Calls The Heart Aftershow,0,0,0,0,2,2
Next Possession,1,0,0,0,7,8
2 Shots on a Barrel,0,0,0,0,2,2
Calming Music :),0,0,0,0,2,2
INXS: Access All Areas,0,0,0,0,2,2
Mackaroy Uncovered,0,0,0,1,49,50
Same Brain,1,0,0,4,355,360
Wilde On,0,0,0,0,13,13
The Tinsel Factory: A Film History Podcast,0,0,0,0,5,5
Wait A Damn Minute,0,0,0,0,9,9
The Birdy Bunch Podcast,0,0,0,0,9,9
Gacha Life Procasts,0,0,1,0,5,6
THE ANYTHING SHOW WITH JON FRANCOIS,0,1,0,4,294,299
Jungkook,0,0,0,0,2,2
Kids BedTime Stories,0,0,0,0,1,1
Script Apart,0,0,0,0,5,5
Generation Iron Podcast,0,0,0,1,3,4
Israel Daily News Podcast,0,0,0,0,7,7
Latinx Lens,0,0,0,1,13,14
The Anxious Love Coach,0,0,0,0,3,3
Grow Weed at Home with Homegrown Cannabis Co,0,0,0,0,2,2
HousingWire Daily,0,0,0,0,6,6
Digging in with Tripp,1,0,0,0,21,22
Trash Taste Podcast,0,0,1,3,46,50
Aghoreshwar's Pearls of Wisdom with Commentary By Baba Harihar Ram,0,0,0,0,1,1
Red Table Talk,10,2,1,4,74,91
Had I Known,0,0,0,0,3,3
Parenting Today's Teens,0,0,0,0,8,8
Six Minute Mile,0,0,0,0,3,3
Would You Rather...,0,0,0,0,3,3
Language Hacking,0,0,1,1,21,23
Ranking The Beatles,0,0,0,0,11,11
Full Time with Meg Linehan: A show about women's soccer,0,0,0,0,112,112
Notes From The Pen - Prison,0,0,0,2,27,29
Practice Disrupted with Evelyn Lee and Je'Nen Chastain,0,0,0,0,3,3
The Bob McCown Podcast,0,0,0,0,6,6
The Tip of the Cap Podcast,0,0,0,0,1,1
Blackpink,1,0,0,1,1,3
Guru: The Dark Side of Enlightenment,60,53,78,59,193,443
Cork'd Up: A Wine Podcast with a Splash of Baseball,1,0,0,1,3,5
Make Marriage Work,0,0,0,0,9,9
Where Optimal Meets Practical,0,0,2,0,15,17
Beauty Needs Me,0,0,0,0,8,8
Overcoming Betrayal & Addiction,0,0,0,0,2,2
The Dynasty Drive,0,0,0,0,2,2
The Bolin Alley,3,0,0,2,1,6
Your Most Obedient & Humble Servant,0,0,0,0,12,12
Spotify,0,0,0,0,1,1
LAMBTALK,0,0,0,0,3,3
Sasquatch Tracks,0,2,0,1,19,22
Tween Talk,0,0,0,0,2,2
MUSIC VIDEOS,1,1,1,5,26,34
TNA Cross The Line Podcast,0,0,0,0,1,1
Octavia's Parables,0,0,0,0,54,54
For the Love of Literacy podcast,0,0,0,0,6,6
Origins & Evolution,0,0,0,0,9,9
Are You Smarter Than a 5th Grader?,1,0,2,0,3,6
UPT Bound,0,0,0,0,3,3
Looking Up with Dr. Deepika Chopra,0,0,0,0,11,11
The Eben Flow,0,0,1,0,49,50
Pretty Lies & Alibis,4,1,2,3,30,40
Sleep and Relaxation Sounds,0,1,0,0,6,7
Stories Mother Told: African Folktales,0,0,0,0,2,2
HBO's I'll Be Gone In The Dark Podcast,3,1,0,2,18,24
Unconditionally Unfiltered,6,0,0,0,33,39
The Simple Nursing Podcast - The Simplest Way To Pass Nursing School,0,0,0,0,3,3
Raiders Of The Lost Podcast,1,2,4,3,393,403
The Naptime Hustle Podcast,0,0,0,0,28,28
The Inner Game with Lindsey Wilson,0,0,0,0,15,15
The Joe Show,1,0,0,0,2,3
Friends Who Talk About Money,0,0,0,1,5,6
Life Possible Podcast,0,0,0,1,2,3
Rating roblox games,5,1,3,6,34,49
Jokermen: a podcast about bob dylan,0,0,1,2,11,14
The Balanced Band Director,0,0,0,0,1,1
Honduras Now Podcast,0,0,0,0,4,4
The Running Pod,0,0,0,0,6,6
"Good Night, Black Child",0,0,0,0,3,3
Crime Countdown,67,32,28,24,197,348
Propagated Podcast,0,0,0,0,8,8
Conflict Radio,0,0,0,0,3,3
Pull Hitter Fantasy Baseball,0,0,0,0,37,37
10 to LIFE!,0,0,0,0,13,13
Hey Black Child: The Podcast,0,0,0,0,15,15
On The Issues With Michele Goodwin,0,0,0,0,20,20
Guides Gone Wild,0,0,0,0,5,5
Little Angles,0,0,0,0,1,1
NITE LIFE NATION - The Coon Hunter's Podcast,0,0,0,0,49,49
Rugby Wisdom,0,0,0,0,4,4
Unmasked History of Scooby Doo,0,0,0,0,3,3
Democracy Paradox,0,0,0,0,2,2
The Koren Podcast,0,0,0,0,1,1
The Goat Room Podcast,3,1,2,1,17,24
The Busy Latter-day Saint,0,0,0,0,8,8
School of the Rock,0,0,0,0,1,1
Eatrite Nutrition Podcast,0,0,0,0,17,17
"Food, Sex & Money",0,1,0,0,49,50
The Horse Traders Diary,0,0,0,0,3,3
Make More Art,0,0,1,0,2,3
Cherry Jam - A Gloucester Rugby Supporter Podcast,0,0,0,0,1,1
Pediatrics On Call,0,1,0,2,22,25
Driving the Green Book,1,0,1,4,67,73
The Power Hungry Podcast,0,0,0,0,8,8
The Longest Stride,0,0,0,0,12,12
FactSet Evening Market Recap,0,0,0,0,4,4
Your Dog Wants You To Know This!,0,0,0,0,15,15
The Cosmic Controversy Podcast,0,0,0,0,2,2
In the Red Clay,5,3,2,5,485,500
Unfuck Nation with Gary John Bishop,0,0,0,0,50,50
Bible Bedtime Stories with Blessing Afolabi,0,0,0,0,1,1
DIA Connections,0,0,0,0,4,4
The NanoPod,0,0,0,0,1,1
"Food, But We Digress...",0,0,0,0,10,10
The Back Row Redskins Show - A Washington Redskins Podcast,0,0,0,0,10,10
The Big Homies House,0,0,0,0,3,3
W.O.C. at Work,0,0,1,0,16,17
The Real Estate Rebel with Scott McGillivray,0,0,0,0,2,2
The Successful Screenwriter with Geoffrey D Calhoun: Screenwriting Podcast,0,0,0,0,7,7
Seizing Freedom,1,0,0,0,12,13
Songs for Life,1,0,1,0,10,12
Sincerely Unqualified,0,0,0,0,5,5
IMPACT: The Podcast,1,0,0,0,6,7
The Way the World Works: A Tuttle Twins Podcast for Families,1,0,2,3,22,28
Unscripted,0,0,0,0,18,18
Where Wine Takes You - A Paso Wine Podcast,0,0,0,0,27,27
Greg Brown: Cockpit Adventures from the Flying Carpet,0,0,0,0,5,5
10 Minute Murder,1,1,0,0,39,41
Act One Podcast,0,0,0,0,3,3
The Cribsiders,0,0,1,0,15,16
Shaped by Dog with Susan Garrett,0,1,0,0,49,50
Pounding The Table,0,3,3,0,36,42
What Had Happened Was,0,0,0,0,101,101
The First Ever Podcast,0,0,0,0,44,44
Kids Bible Stories & Songs,0,0,0,0,1,1
Flow Research Collective Radio,1,0,2,1,25,29
Drafted,0,0,0,0,15,15
The Jane Goodall Hopecast,0,0,0,0,17,17
The Bakari Sellers Podcast,10,0,4,2,68,84
The Outcomes Conference Podcast,0,0,0,0,1,1
Beyond Blathers,0,0,0,0,6,6
The Chop with Latrice Royale & Manila Luzon,10,4,5,4,74,97
Rebel Human Resources Podcast,0,0,0,0,1,1
The Man To Man With DB & AB,0,0,0,0,19,19
Three Black Halflings | A Dungeons & Dragons Podcast,1,0,0,0,28,29
Putt That Podcast,0,0,0,0,8,8
The Ancients,0,0,2,0,12,14
Hello Relationships,0,0,0,0,5,5
Jazz United: A Podcast From WBGO,0,0,0,0,3,3
Straight To Video,0,0,0,0,2,2
Sober Powered,0,0,0,0,35,35
Sequence with Trevor Plouffe,0,0,0,0,8,8
Sleep Tight Science,0,0,0,1,3,4
Intersect Ed,0,0,0,0,1,1
Big Facts No Cap,0,0,0,0,8,8
Design Time,3,0,4,1,46,54
What Could Possibly Go Right?,0,0,0,0,2,2
Vegan Abattoir,0,4,6,6,125,141
Turley Talks,2,1,2,1,49,55
Deep Cover: The Drug Wars,5,2,4,6,97,114
IN THE TREES PODCAST,0,0,0,1,9,10
One Next Step: Management Tips & Tools for Small Business Owners,0,0,0,0,11,11
Suburban Boys,0,0,0,0,11,11
The Old Kids Movies,0,0,0,0,5,5
The oursociallandscape's Podcast,0,0,0,0,1,1
JOLLYLAND,0,0,0,0,9,9
Get Behind Fanny,0,0,0,0,2,2
The CripesCast Podcast,2,1,0,1,46,50
CREEK DEVIL,1,0,0,0,1,2
Game Changers in Medicine,0,0,0,0,13,13
Anime in America,0,0,1,0,23,24
There Are No Girls on the Internet,16,0,1,1,76,94
"The Hiker Podcast | Day Hiking, Backpacking, Thru Hiking",0,0,0,1,26,27
Metrosource Minis: The LGBTQ World & Beyond,0,0,0,0,3,3
Rumpel and the Frog,0,0,0,0,11,11
The Decrypt Daily: Bitcoin & Cryptocurrency  News Podcast,0,0,1,1,32,34
CBS Radio Mystery Theater,0,0,0,0,2,2
The Johnny Mitchell Show,0,0,0,0,10,10
Radiant Rest  Podcast with Tracee Stanley,0,0,0,0,5,5
The Orange Tree,21,17,26,15,324,403
Holistic Life Navigation,0,0,0,0,10,10
Fullmetal Analysts,0,0,0,0,6,6
The Yacht Rock Show with Eddie Ganz,0,0,0,0,1,1
The Last Tapestry,0,0,0,0,10,10
Kids Meditation,0,0,1,0,14,15
The Mallory Bros Podcast,0,0,1,1,48,50
"GET REAL w/ Peniel, BM, and Ashley Choi",0,0,2,7,491,500
Authentic Obsessions,0,0,0,1,6,7
Fur the Culture,0,0,0,0,3,3
EuroSteppin Podcast,0,0,0,0,1,1
ABC Cryptozoology,0,0,0,0,4,4
Ship Chasing,0,0,0,0,59,59
Our Numinous Nature,0,0,0,0,10,10
Digging for Kryptonite: A Superman Fan Journey,0,0,0,0,3,3
The Yellowstone Podcast with Stef and Sheila,0,0,1,0,5,6
The Daily Mastery Podcast by Robin Sharma,0,0,2,4,58,64
Respect The Drive,0,0,0,0,2,2
High Stakes Heat,0,0,0,0,19,19
The Volleyball By Design Podcast,0,0,0,0,9,9
Secret Life,0,0,0,1,52,53
Can't Take the Heat,0,0,0,0,6,6
Dyslexia Mom Life,0,0,0,0,11,11
The StoryTinker,1,0,3,1,3,8
Omarhuss,0,0,1,0,6,7
An Oral History of The Office,10,3,5,4,109,131
Red Web,10,1,16,10,247,284
Middle Ground Podcast,0,0,2,1,147,150
Weekly Specials with Will Guidara,0,0,0,0,3,3
DVC Newscast by My DVC Points,0,0,0,0,4,4
Better Me with BodyByBree,1,0,0,0,39,40
Psychoanalysis: A Horror Therapy Podcast,4,0,2,3,41,50
Daily Rundown,0,0,0,0,2,2
Trawler Talk,0,0,0,1,4,5
The Iggy Parents,0,0,0,0,9,9
Off Track: Meeting of the Unknowing Minds,0,0,0,0,1,1
"Ready, Set, TEACH",0,0,0,0,9,9
Passing Judgment,1,0,0,0,36,37
Thomas & Friends™ Storytime (UK),0,0,0,0,3,3
American Songcatcher,0,0,0,0,6,6
Abuse of Power with David Rudolf and Sonya Pfeiffer,4,0,0,1,36,41
The Raincoat Report,0,0,0,0,1,1
Camping Out with Dan Camp,0,0,0,0,10,10
GameKeeper Podcast,0,0,0,2,17,19
Sistas with Sabers,0,0,0,2,14,16
The Dr. Epicopolis & 1102 Show of Shows,0,0,3,1,11,15
Make Shift Happen with Samantha Daily,0,0,0,0,22,22
Black Frasier,2,0,0,0,48,50
Ask a Matchmaker,3,1,2,0,27,33
Festival Circuit: New Orleans,0,0,0,0,30,30
Middle Market Mergers and Acquisitions by Colonnade Advisors,0,0,0,0,12,12
"Some Work, All Play",1,1,0,0,70,72
Into the Zone,1,3,2,5,53,64
The Shi Show,0,0,0,0,1,1
The Memo by Howard Marks,0,0,0,0,16,16
SmartLess,34,36,46,58,774,948
The Overland Philosopher,0,0,0,0,3,3
Your PA Mentor - From Physician Assistant Student to PA-C,0,0,1,0,43,44
BetweenNerds,0,0,0,0,5,5
Newsy Jacuzzi,0,0,0,0,16,16
You Can Sit With Us,3,0,4,8,35,50
The Mom Room Podcast,0,0,0,1,49,50
EYELASH EXCELLENCE - THE LASH CHAT,0,0,0,0,1,1
Rounds to Residency (from MedSchoolCoach),0,0,0,0,3,3
The Nateland Podcast,0,0,0,0,50,50
Charting The Territories Podcast,0,0,0,0,7,7
The Two Tall Jews Show,0,0,0,0,31,31
"""So Look Bro"" Podcast",1,1,0,2,162,166
Soul on Ice: The Podcast,0,0,0,0,7,7
99 Potions,0,0,0,0,5,5
Theories of Everything with Curt Jaimungal,1,0,0,0,5,6
unCUT - The Makers' Podcast,0,1,0,0,3,4
The One Stars,0,1,0,0,8,9
Kota Embassy Podcasts,0,1,0,1,12,14
The Screen Forum,0,0,0,0,3,3
Lyrics Of Their Life,0,0,0,0,1,1
Catching Up With Boruto,0,0,0,0,4,4
Astronomy Minute,0,0,0,0,1,1
Know Thyself,0,0,1,1,14,16
Single Best Scene,0,0,0,0,2,2
Independent Filmmaker's Guide,0,0,0,0,7,7
The Daily Juice,8,4,3,12,473,500
Late Era,1,0,0,0,3,4
Running Times,0,0,0,0,11,11
The Gift of Forgiveness,9,1,3,4,41,58
NICU Grad Podcast,0,0,0,0,3,3
The Perfect Drink,0,0,0,0,3,3
Live From My Office,1,0,0,0,12,13
Nurse Becoming,0,0,0,0,21,21
UltraRunning Magazine Podcast,1,0,0,0,1,2
Bravo While Black,0,0,0,1,24,25
"Fans On The Run: A Podcast Made By, For And About Beatles Fans",0,0,0,0,4,4
Italiano Bello,0,0,0,0,6,6
Food Freedom and Fertility Podcast,0,0,0,2,36,38
Full Release with Samantha Bee,9,0,0,5,36,50
Nursing School Week by Week,0,0,0,0,15,15
Beyond the Clubhouse,1,0,0,0,3,4
Protecting Your NEST with Dr. Tony Hampton,1,0,0,0,8,9
Dirty Diana,2,2,1,3,42,50
Believing the Bizarre: Paranormal Conspiracies & Myths,0,0,0,0,30,30
The Firsts,0,0,0,0,1,1
The Environmental Transformation Podcast,0,0,0,0,7,7
For Heaven's Sake,0,0,0,0,2,2
Intergenerational Politics,0,0,0,3,47,50
Conservation Queens,0,0,0,0,2,2
Run O’clock Podcast,0,0,0,0,1,1
Screenagers Podcast,0,0,0,0,23,23
Apartment 4D: A New Girl Podcast,0,0,1,0,10,11
Djy Jaivane,0,0,0,1,22,23
Be Right,0,0,0,0,14,14
California Love,7,1,2,5,152,167
NYCFC Forever Podcast,0,0,0,0,5,5
Empowered to Connect Podcast,0,0,0,0,10,10
"High on Home Grown, The Cannabis Podcast",0,0,0,0,1,1
Fade The Chalk,1,1,0,2,107,111
The Eva Effect Podcast,0,0,0,0,1,1
Altar Call: A Married At First Sight Podcast,0,0,3,2,49,54
History In The Mix: The Reboot,0,0,0,0,3,3
Build a Business Success Secrets,0,0,0,0,24,24
Learn To French,0,0,0,0,1,1
The Ear Responsible Podcast,0,0,0,0,1,1
Coffey & Code,0,0,0,0,12,12
The Delve,0,0,0,0,4,4
Learn English Vocabulary,0,1,0,0,3,4
Mr.Creeps,1,0,0,0,2,3
"PET TALK TODAY with Will Bangura: Dog Trainer, Dog Training, Cat Training, Pet Health, and Wellbeing...",0,0,0,0,4,4
The Filmumentaries Podcast,0,0,0,0,5,5
Heart Of Witchcraft,0,0,0,1,0,1
Rain Sounds,0,0,0,0,15,15
The Max Lucado Encouraging Word Podcast,0,0,0,0,42,42
Critical Role,0,0,0,1,20,21
A Heart For All Students,0,0,0,0,5,5
Blue's Clues & You: Story Time with Josh & Blue,6,1,0,1,42,50
PURIJAGANNADH,2,1,1,3,87,94
Mike Up In Your Business Podcast with Mike Michalowicz,0,0,0,0,18,18
Pawnee Public Radio: A Parks and Rec Rewatch Podcast,1,1,2,2,72,78
Three — A Tennis Show,0,0,0,0,4,4
The Rugby Rant,0,0,0,0,2,2
Keepin’ It Real,0,0,0,0,2,2
Designer Shopping Spree,0,0,0,0,14,14
The Off The X Podcast,0,0,0,0,1,1
Culture Wars – with Andrew Doyle,2,0,0,0,11,13
In The Barn,0,0,0,1,7,8
Women & the Wilderness,0,0,0,0,3,3
It's A Hawaii Thing,0,2,1,0,3,6
Inside Comfort with Jerry Navarra,0,0,0,0,2,2
GOOD OL' GRATEFUL DEADCAST,0,1,0,2,111,114
JOSPT Insights,0,0,0,0,2,2
The Mystery Kids Podcast,1,1,1,0,10,13
Doc Halligan Unleashed with Joey Villani,0,0,0,0,3,3
Flight Assist,0,0,0,0,1,1
Miracles & Atheists,0,0,0,0,6,6
Breaking Doctrine,0,0,0,0,4,4
Unloose the Goose Agorist and Libertarian Solutions Podcast,2,0,0,1,23,26
Wings of Fire Fanwingz by WOF Girlz,0,0,0,1,19,20
Warcraft Reloaded – WoW Classic and Community,0,0,0,2,23,25
Roll for Weird | A Monster of the Week Actual Play,0,0,0,0,7,7
Academy Blasting,0,0,0,0,1,1
The Poor Prole's Almanac,0,0,0,0,2,2
hoopoecast,0,0,0,0,1,1
Talking Dogs with Graeme Hall,0,0,0,2,57,59
Extra Dynamic with ur mom ashley,0,0,1,1,40,42
Serious Butt Funny,0,0,0,1,49,50
Taxgirl,0,0,0,0,1,1
BRING IT IN,0,0,0,0,1,1
chats with che,0,0,0,0,2,2
Paleo Nerds,0,0,1,0,23,24
Fashion Crimes Podcast,0,0,0,0,3,3
Healthy Eating For Busy Women,0,0,0,0,8,8
Dominican Spanish 101,0,0,0,1,9,10
The Music That Made America,0,0,0,0,5,5
Uphill Athlete Podcast,0,0,1,2,5,8
What Else Is Going On? With Taria S. Faison,5,0,0,0,43,48
Hypercritical from Professional Awesome Racing,0,0,0,0,14,14
MANEATER,0,0,0,0,4,4
Bob & Eric Save America,0,0,1,0,7,8
Clotheshorse,0,0,0,0,44,44
Gundam Book Club,0,0,0,1,1,2
The Homebrew | A DND Play Podcast,0,0,0,0,2,2
The Elder Scrolls Podcast with FudgeMuppet,0,0,0,0,18,18
Pennies: Going in Raw,9,5,1,2,183,200
Scientology: Fair Game,13,15,34,41,397,500
Travel Tales by AFAR,1,0,0,0,76,77
Why This Universe?,0,0,0,0,7,7
Biblical Nutrition Academy Podcast,0,0,0,0,7,7
Inside the Cap with Joel Corry,0,0,0,0,4,4
Dear Therapists,3,2,2,4,155,166
Do Less God Bless,0,0,2,0,48,50
A Smaller Life,0,0,0,0,2,2
PlanBri Uncut,14,2,5,6,215,242
What To Expect,6,1,4,3,8,22
Straight Fire with Jason McIntyre,15,1,1,2,108,127
FTN Fantasy Baseball Podcast,0,0,0,1,28,29
Palmetto Cats LIVE,0,0,0,1,1,2
Daily News Brief,0,0,0,0,1,1
CrossPolitic Show,0,0,0,0,1,1
The Mash Pit!,0,0,0,0,3,3
The Toilets to Titles podcast,0,0,0,0,8,8
Million Bazillion,3,0,3,2,41,49
Wisecracker,0,0,0,0,6,6
Don't Ask Tig,0,0,0,0,50,50
Old Friends Catch Up,0,0,0,0,3,3
Reptilian Ramble,0,0,0,0,3,3
Shots to the Dome,0,0,0,0,7,7
The Piketon Massacre,61,65,98,60,99,383
PDX Story Project,0,0,0,0,2,2
Kind thoughts for Meghan Markle,0,0,0,0,3,3
"The Dumb, Found Dead",0,0,0,0,30,30
Where It Went Podcast,1,0,1,2,29,33
In Machines We Trust,0,0,1,2,11,14
The Bloodybits Horror Show,0,0,0,0,9,9
The Gimme,1,0,0,0,11,12
Beauty & The Beast Podcast,0,0,0,0,10,10
This is The Revolution,0,0,0,0,2,2
The Mud Peddlers: Ceramic Art Behind the Scenes,0,0,0,0,14,14
The Ethical Rainmaker,0,0,0,0,12,12
Kinda Funny Xcast - An Xbox Podcast,0,4,1,1,44,50
The Walk-In,3,0,0,0,47,50
The TeaTok Podcast,3,0,1,0,5,9
rodrickrules,0,0,0,1,1,2
Seforimchatter,0,0,0,1,13,14
WW Weight Loss & Recovery With Sheila Jane,0,1,1,0,29,31
Ramsey Call of the Day,0,0,0,1,8,9
Upside Down Tulips - A Garden Podcast,0,0,0,0,9,9
Public Books 101,0,0,0,0,7,7
A Glass For Every Palate,0,0,0,0,11,11
Sloydcast,0,0,0,0,5,5
Within Our Gates,0,0,0,0,3,3
Slow Cast Lounge,1,0,0,2,28,31
American Shadows,9,11,6,9,15,50
My Momma Told Me with Langston Kerman,2,0,0,0,48,50
Search Party: The Podcast,4,0,1,0,16,21
The Ringer Fantasy Football Show,1,1,3,2,42,49
Barron's Live,1,3,0,1,2,7
Leo Terrell: America's Fair Minded Civil Rights Attorney,2,0,0,3,182,187
Weird Candy,0,0,0,0,1,1
Is We Dumb?,1,0,2,1,46,50
Lewis Black's Rantcast,1,0,0,3,26,30
Ask Any Buddy,1,0,0,0,3,4
Taskmaster Talks with Kevin Sullivan,0,3,2,1,7,13
Outliers with Daniel Scrivner,0,0,0,0,4,4
Mentors on the Mic,0,0,0,0,78,78
lowkey,0,0,0,0,4,4
Witness to Love Podcast,0,0,0,0,3,3
OSI Today,0,1,0,0,1,2
Obsessed With the Weather,0,0,0,0,9,9
Think Like An Economist,1,3,3,6,13,26
"MY PODCAST PERSONAL, DONT LISTEN OOOOOOK *WINK*",0,0,0,0,4,4
Supreme Myths,0,1,0,0,5,6
Bitcoin Fixes This,0,0,0,0,2,2
The OutCast Presented by Outfest,0,0,0,0,11,11
Indie Film Academy: A Filmmaking and Screenwriting Podcast,0,0,0,0,1,1
corporate flight attendant podcast,0,0,0,0,2,2
Awesemo UFC DFS,0,0,0,0,2,2
Two Guys Talking Rush,0,0,0,0,1,1
The Make An Impact Podcast,0,0,0,0,13,13
Extra Paint - The @Muralists Podcast,0,0,0,0,13,13
Be Effective Podcast,0,1,0,0,5,6
"Gym, Tan, Laundry.",0,0,0,0,4,4
Patrice O’Neal Archive,0,0,0,0,15,15
The 20 Million Club,0,0,0,0,1,1
The Odds Couple,1,0,0,0,0,1
Amazing Animal Facts,0,0,0,0,1,1
Nice White Parents,62,12,16,16,82,188
Real Kyper at Noon,0,1,0,2,29,32
Wild 'Til 9,15,2,4,7,472,500
Black in Appalachia,1,0,0,1,25,27
Dungeons &  Dipshits,0,0,0,0,1,1
Big Boy’s Dynasty Fantasy Football League Podcast,0,0,0,0,1,1
"The Good, The Bad & The Rugby",3,6,6,1,32,48
You Don't Know Jack,0,0,0,0,1,1
The AoT Chronicles (an Attack on Titan Podcast),2,2,0,0,47,51
Aftermath Philadelphia,0,0,0,0,4,4
"Rossifari Podcast - Zoos, Aquariums, and Animal Conservation",0,1,0,0,9,10
Unearthed - Mysteries from an unseen world,0,0,0,0,4,4
The Anxiety Chicks,0,1,2,4,43,50
Fingers Crossed,7,14,3,5,77,106
Goodnight Sleepyhead 😴🌙🌟Bedtime Stories,1,0,0,0,3,4
Married at First Sight Divorced in Two Months,0,1,3,1,7,12
Future Generations Podcast with Dr. Stanton Hom,2,0,0,0,29,31
Empty Inside,4,2,6,10,156,178
Zack to the Future,34,22,28,37,241,362
Niners Nation: for San Francisco 49ers fans,1,0,0,0,9,10
Divorced Not Dead,12,7,1,2,90,112
Swings & Studies,0,0,0,0,2,2
THE NETCHICKS,0,0,1,2,37,40
No Laying Up: Crash Course,0,0,0,0,13,13
Adventures In Black Cinema With Desmond Thorne,0,0,0,0,17,17
The George Farmer Podcast,0,0,0,0,22,22
The Brief with Gregg Jarrett,1,0,0,0,8,9
Sound the Foghorn,0,0,0,0,2,2
"Breezy Babies- Mom, Parent, Pregnant, Baby, Breastfeeding, Family, Postpartum",0,0,0,0,10,10
We’re The Weird Ones Podcast,0,0,0,0,28,28
Dynasty Underdog,0,0,0,0,2,2
Halftime Report,2,0,1,0,14,17
nya talks about object shows,0,0,0,0,1,1
Al Madrasatu Al Umariyyah,0,0,0,0,4,4
The Max EFX Podcast:  An Insider Look at the Special Effects Industry & Sci-Fi Fandom,0,0,0,0,4,4
Junior to Senior with David Guttman,0,0,0,0,1,1
Reddit adult stories. Reddit erotic sex stories. Reddit gonewildstories.r/gonewildstories.,7,0,0,0,10,17
What's Missing,3,2,4,1,11,21
Corked Stats,0,0,0,0,22,22
Tough as Nails Recaps on Rob Has a Podcast,3,0,0,0,5,8
THE TAKEAWAY GOLF,0,0,0,0,1,1
Let's Talk Yoga,0,0,0,0,48,48
The Ma and Pa Cast.,0,0,0,0,7,7
Toothbrush Stories,1,0,0,0,4,5
THIS IS REVOLUTION >podcast,0,0,0,0,4,4
Convos with Costume Designers hosted by Mandi Line,0,0,0,0,7,7
NSW Police State Crime Command – Investigations,2,3,1,5,18,29
10 Years of One Direction - The Podcast,0,0,0,0,2,2
HousePod,0,0,0,0,36,36
Tanya's Table Podcast,0,0,0,0,10,10
Ask A Black Person,0,0,0,0,1,1
Pleasant Good Evening,0,0,0,0,2,2
Accessible Yoga Podcast,0,0,1,1,10,12
The Fifth Edition by Infinite Banking Authorized Practitioners,0,0,0,0,2,2
Talking Nonprofits with Tephanie,0,0,0,0,3,3
Murder In Your Ear-The Murder Mystery Podcast,1,0,0,0,9,10
Cleaning Up. Leadership in an age of climate change.,0,0,0,0,2,2
Sleep Meditation for Women,1,2,0,0,7,10
The Magic Sash,0,0,2,0,10,12
Bring Back Bronco: The Untold Story,5,1,6,3,29,44
Awesemo PGA DFS,0,0,0,0,1,1
Awesemo NASCAR DFS,0,0,0,0,1,1
Awesemo MLB DFS,0,0,0,0,4,4
Hockey IQ Podcast,0,0,0,0,3,3
"The Nursing School Simplified Podcast with Cynthia Primavera, RN CCRN",0,0,0,0,3,3
Godzilla Roundtable,0,0,0,0,1,1
Extra Points with Cousin Sal & Dave Dameshek,9,6,8,7,74,104
Laugh Lines with Cousin Sal & Rachel Bonnetta,0,0,1,0,9,10
The Bomb,13,14,8,8,7,50
Official Man City Podcast,0,0,0,0,2,2
Well...I Liked It!,0,0,0,0,13,13
Crossing The Lane Lines,0,0,0,0,1,1
The Sorority Nutritionist Podcast,1,0,0,0,14,15
Wonder And Awe,0,0,1,0,1,2
The Yes Theory Podcast,3,1,2,3,125,134
The Pit Presents: LAST WORDS,0,0,0,0,4,4
Misters of the Dark,0,0,0,0,1,1
The Matthew West Podcast,1,0,0,3,157,161
Lauren Lake's Paternity Court,0,0,0,1,7,8
Big Drive Energy,0,0,0,0,8,8
New Polity,0,0,0,1,5,6
Big Ass Runner Trail Running Podcast,0,0,0,0,42,42
On the Ear: An Audiology Podcast,0,0,0,0,5,5
Sassquad Trail Runners,0,0,0,0,1,1
Handle with CARE: Breast Cancer & Beyond,0,0,0,0,16,16
The Success Lift Podcast,0,0,0,1,38,39
Weird Christian Twitter - The Podcast,0,0,0,1,10,11
Indiecast,1,1,0,1,30,33
The Burn Bag Podcast,0,0,0,0,1,1
Fridays at Five,2,2,0,2,19,25
Brawl Stars,6,0,1,0,2,9
Home Skool w/ Andrew Rivers and Cory Michaelis,0,0,0,0,6,6
Conservation Conversations with Sean O'Brien,0,0,0,0,8,8
Nights of Eveningstar,0,0,0,0,14,14
Unprotected Sets,0,0,0,0,1,1
Second Print Comics Podcast,0,0,0,0,25,25
DARK - A Companion To The Netflix TV Series,0,0,0,0,5,5
Dan O Says So,0,0,0,1,1,2
Always and Forever l A One Tree Hill Podcast,0,0,0,0,10,10
The Distraction: A Defector Podcast,6,2,1,4,108,121
ATN - Teaching To Thrive,1,0,0,0,16,17
Motherhood in Black & White,0,0,0,0,38,38
Quilting Stories podcast,0,0,0,0,1,1
Very Amusing with Carlye Wisel,7,2,2,3,486,500
Saving Lives Podcast: Critical Care w/eddyjoemd,0,0,0,0,15,15
P.K. Subban's Ugly Duck Podcast,0,0,0,0,20,20
AmphibiCast,1,0,0,0,7,8
Prepper News and Survival Tips with Duff & Dale,1,2,0,1,12,16
The Sideline,0,0,0,0,3,3
Relationships and Relationshits,0,0,0,0,8,8
The Catmaste Chronicles Podcast,0,0,0,0,1,1
Generative Energy Podcast,0,0,0,0,3,3
Soccer Cards United,0,0,0,0,14,14
Thompson 2 Clark - A Giants Podcast,0,0,0,0,10,10
Legal Docket,0,0,0,0,50,50
The Lisa Ann Experience,0,0,0,0,11,11
Pawd Pod,0,0,0,0,6,6
Locked On MLB Prospects,0,0,0,0,18,18
The Aristotle Project,0,0,0,0,1,1
TEMIPREACHES,0,0,0,0,1,1
The Business Growth Pod with Allan Draper,0,0,0,0,29,29
R2C2 with CC Sabathia and Ryan Ruocco,2,1,0,5,28,36
CEO School,0,0,0,0,96,96
The Judge Jeanine Tunnel to Towers Foundation Sunday Morning Show,1,0,0,0,6,7
CushVlogs Audio - Matt Christman - Chapo Trap House,2,0,0,0,26,28
The Journey On Podcast,0,0,1,0,27,28
Scooter & The Big Man,1,0,0,0,8,9
Snake Talk,0,0,0,0,3,3
The Old Man and the Three with JJ Redick and Tommy Alter,8,1,1,7,341,358
VIN Foundation: Veterinary Pulse,0,0,0,0,6,6
Better Call Daddy,0,0,0,0,63,63
NBA Gambling Podcast,0,0,0,0,18,18
Best Laid Plans,0,0,0,0,50,50
How to Waste your Time,0,0,0,0,1,1
The Honkytonk Jukebox Show,0,0,0,0,1,1
The Wilhelm Team,0,0,0,0,1,1
In Deep,0,0,1,0,5,6
The Weekly Streamer Dynasty Baseball Podcast,0,0,0,0,3,3
Chess Knowledge With H1,0,0,0,1,3,4
Everything Dog Training!,0,0,0,0,2,2
"Mr. Chazz's Leadership, Parenting and Teaching Podcast",1,0,0,1,8,10
The Hidden Djinn,0,0,0,2,48,50
The Sesh Podcast,1,2,0,0,47,50
The Uncomfortable Podcast,0,0,0,0,14,14
Very Presidential with Ashley Flowers,205,41,28,18,207,499
The Bubba Army Podcast,2,0,0,2,46,50
Let's Get Uncomfy Podcast!,0,0,0,0,50,50
Walking is Fitness,0,0,0,0,1,1
Trashy Trashy,0,0,1,0,48,49
Social Worker's Break Room,0,0,0,0,3,3
Devy Marketplace,1,0,2,0,20,23
Sexy Stories with Chantelle Otten Sexologist,1,0,0,0,5,6
Soccer Gambling Podcast,1,1,0,1,95,98
Tennis IQ Podcast,0,0,0,0,1,1
The Desert Dirt Biker Podcast,0,0,0,0,2,2
Just King Things,0,0,1,0,14,15
"Midnight, On Earth",0,0,0,0,3,3
The E-Spot With Camille,0,0,0,0,1,1
High Action,0,0,0,0,3,3
Against All Odds with Cousin Sal (Extra Points Edition),3,0,1,1,16,21
Bedtime Stories - Mrs. Honeybee,1,0,1,1,6,9
Pantry Chat,0,0,0,2,48,50
Far From Par,0,0,1,2,11,14
The Bunkered Golf Podcast,0,0,0,0,1,1
Geology Bites By Oliver Strimpel,0,0,0,0,2,2
Mars Technica,0,0,0,0,1,1
Constructed Resources,0,0,0,0,12,12
Biologists Being Basic,0,0,0,0,1,1
Chewing the Gristle with Greg Koch,0,0,0,0,12,12
mymaria777,3,1,0,0,46,50
Malevolent,0,0,0,0,5,5
Geeta Girl: Evolving Through the Bhagavad Geeta,0,0,0,0,14,14
Strange New Worlds of Dimension X Minus One OTR,0,0,0,0,1,1
Aotearoa Rugby Pod,0,0,0,0,1,1
Rock Logic with Sean Kenny,0,0,0,0,1,1
Awakened to Reggio,0,0,0,0,4,4
Stories we could tell,1,0,0,0,5,6
Ask Lisa: The Psychology of Parenting,0,1,0,0,21,22
Talking Dirty,0,0,0,0,1,1
Quick Spin,0,0,1,1,5,7
Awesemo NBA DFS,0,0,1,0,41,42
Embodied,0,0,0,0,22,22
Mostly Superheroes,0,0,0,0,4,4
Peanut Butter Jelly Time,0,0,0,3,37,40
Daughters of DC,1,0,4,2,18,25
VICE News Reports,2,0,0,0,40,42
Bald Talk,1,0,0,1,15,17
Suuuper Anime Podcast,0,0,0,0,1,1
Dear Shandy,0,2,1,0,102,105
Billionaire Boys Club,29,27,21,15,75,167
BONSAI POPcast,1,0,0,0,7,8
Sounds Good by Harish Shankar,0,0,0,1,5,6
Hair Goals Podcast,1,0,1,0,2,4
People I (Mostly) Admire,5,1,2,2,51,61
Learn Spanish with Live Lingua,0,0,0,1,14,15
Uforia Music,0,0,0,0,1,1
The Bones Zone,2,0,0,0,18,20
Baking with House of Bread,0,0,0,0,5,5
Ideas of India,1,0,1,0,0,2
The Stars Made Me Do It,0,0,0,0,11,11
How to Save a Planet,6,4,4,4,173,191
The Unfinished Print,0,0,0,0,1,1
Leaving Eden Podcast,0,1,0,0,7,8
Virtual Production,0,0,0,0,2,2
The Kennedy Assassination,1,0,0,0,5,6
Swiss and Lali Hijack HOLLYWOOD!,0,0,0,0,5,5
Up and Away,0,0,0,0,1,1
A brush with...,0,0,0,0,4,4
Jesus  Freaks: Vinyl to Digital,0,0,0,0,1,1
Awesemo NHL DFS,0,0,0,0,1,1
The Queer Quadrant,0,0,0,0,9,9
Farthouse,0,0,0,0,18,18
Designing Hollywood Podcast,0,0,0,0,6,6
The Power of Now - A Guide to Spiritual Enlightenment with Linda and Barbara,0,0,0,0,3,3
The Broken Record Player Podcast,0,0,0,0,1,1
Literary Joe's Inner Child Podcast,0,0,0,0,2,2
White on Rice,0,0,0,0,7,7
The Side Track,1,0,0,0,16,17
Dreamy,1,0,2,4,43,50
Sexual Heroes with Robert Black,0,0,0,0,4,4
Post-Credit Podcast,1,1,1,1,27,31
Vixen: Black Beauty and Pop Culture,0,0,0,0,10,10
Lovecraft Country Radio,30,13,16,27,409,495
Locked On Blue Jackets - Daily Podcast On The Columbus Blue Jackets,0,0,0,0,2,2
Bacon Bets Podcast,0,0,0,1,16,17
Just Been Revoked,1,0,0,1,8,10
Chain Clankers Disc Golf,0,0,0,1,15,16
The Steady Stater,0,0,0,0,1,1
Remember Me,0,0,0,0,8,8
Comes A Time,1,1,2,2,35,41
Diamond & Silk: The Podcast,4,0,0,1,156,161
Dave's 5 Hot Takes,0,0,0,0,57,57
NW Fish Passage,0,0,0,0,7,7
"Savannah, Georgia: Anything But Ordinary",0,0,0,0,4,4
In VOGUE: The 1990s,1,1,3,2,19,26
The High Performance Zone,0,0,0,0,7,7
Going Plus Ultra With Zach Stroes,0,0,0,0,1,1
Always Be Birdin',0,0,0,0,10,10
90 Day Fiance RHAP-ups,1,0,0,0,19,20
Better Than I Found It,0,0,0,0,16,16
Kev Hick Talks Everything,0,0,0,0,5,5
Chilling True Tales - True Ghost and Paranormal Stories,0,0,0,1,0,1
No Suga On Dee Rim,0,0,0,0,6,6
D&D: Optimized,0,0,1,0,3,4
Modern Classrooms Project Podcast,0,0,0,0,3,3
White Sox Nation Podcast,0,0,0,0,1,1
She Rates Dogs: The Podcast,12,0,0,1,234,247
SpaceX,0,0,0,0,2,2
Garden Parties FC,0,0,0,0,1,1
on the floor,0,0,0,1,20,21
Old Crazy Runners - the Podcast,1,0,0,0,8,9
Pass-Through Frequencies,0,0,0,0,19,19
The Department:  a podcast about trends.,0,0,0,0,18,18
Sounds Like Hate,2,0,1,0,37,40
The Dime Store Cowgirls,0,0,0,0,45,45
Heirs of The Pandavas,0,0,2,1,10,13
Smash Accept Dynasty Trades,0,0,0,0,31,31
The Bulwark Goes to Hollywood,0,0,0,0,36,36
Sew Mindful Podcast,0,0,0,0,1,1
Wake N Jake,0,0,0,0,50,50
Life and Books and Everything,0,0,1,0,40,41
The World Wars,1,0,1,0,2,4
Relatos de la Noche,0,0,0,0,15,15
Pendulum Land Podcast,0,0,0,0,11,11
Witch and Goddess,0,0,0,1,5,6
"Love, Sex, and Applied Behavior Analysis",0,0,0,0,6,6
One Strange Thing,4,0,3,3,27,37
Relative Unknown,3,7,18,18,382,428
Lean Leadership for Ops Managers,0,0,0,0,7,7
It's Solid Food,0,0,0,0,6,6
Why Satan,0,0,0,0,1,1
TLDR Daily Briefing,0,0,0,1,1,2
Halfway Cray Podcast,0,0,0,0,1,1
Paper Ghosts,42,44,55,38,202,381
What's Going On With AABE?,0,0,0,0,1,1
Homeschool Together Podcast,0,0,0,0,8,8
Trish Intel Podcast,2,0,0,1,47,50
Enjoy the Podcast,0,0,0,0,42,42
Stitch Talk,0,0,0,0,1,1
"TLC Barrels, Barrel Racing Coach",0,0,0,0,1,1
Let’s Talk CP,0,0,0,0,1,1
Talent Stacker,0,0,0,0,11,11
Everyone is Terrible,0,0,0,0,58,58
SpyHards Podcast,0,0,0,0,24,24
Random Number Generator Horror Podcast No. 9,0,0,1,1,9,11
Bunga Bunga,69,57,56,32,237,451
Justice Matters with Glenn Kirschner,0,0,0,0,50,50
What Will She Do Next?,0,0,0,0,12,12
Hot Tea Hot Takes,0,0,0,0,7,7
The Vampire Diaries,0,1,0,0,1,2
Tom and Jerry Show,0,0,0,0,1,1
Sleepover Cinema,0,0,0,0,21,21
SUBTEXT Literature and Film Podcast,0,0,0,1,30,31
Blurry Creatures,3,0,2,1,55,61
Killed by Desk,0,0,0,0,8,8
Missin Curfew,3,0,8,3,46,60
The World Is Wrong,0,0,0,0,1,1
A Special Take with Sid and Tyler,0,0,0,0,1,1
Where the Bodies Are Buried,32,19,17,9,127,204
ScrapHappier,0,0,0,1,20,21
Guided Audio Runs - Get Fit Done,0,0,0,0,4,4
BardsFM,1,1,1,1,63,67
Kentucky Daily,0,0,0,0,20,20
Habitual Routine,0,0,0,0,3,3
To See Each Other,1,0,0,0,12,13
The Ravens - a One Tree Hill Podcast,0,0,0,0,14,14
Brown Petri Dish,0,0,0,0,1,1
Nba_youngboy,4,0,0,0,3,7
UNmuted,0,0,0,0,5,5
Homies of Horror,0,0,0,0,9,9
Risk of Ruin,0,0,0,0,5,5
Debt Free Degree,0,0,0,0,15,15
Think On Your Faith,0,0,0,0,3,3
YOU ARE WORTHY with LilMookieB,0,0,1,1,39,41
The Opinionated Sixth Man Podcast,0,0,0,0,8,8
Beck Did It Better,0,0,0,0,5,5
Starcastic Remarks-The Only Dallas Stars Fan-Led Podcast,0,0,0,0,2,2
Andy Raymond #UNFILTERED,0,0,0,0,2,2
MMWR Weekly COVID-19 Briefing,2,1,0,0,3,6
The Deal,0,0,0,1,15,16
Truth Doctor Podcast,1,0,0,1,48,50
Sparkle Stories Podcast,1,0,0,0,1,2
The Best Soccer Show,0,0,0,2,99,101
2HotWives - A Girl's Guide to Unconventional Sex,0,0,0,0,16,16
Medical Murders,16,15,17,10,79,137
Pelo Buddy TV,2,2,0,0,2,6
Go Deep in the Shallow,0,0,0,1,15,16
StoryLearning Spanish,0,0,0,0,50,50
Natural Health for People and Pets Podcast,0,0,0,0,1,1
NN/g UX Podcast,0,0,0,0,3,3
Battle of the Bands,0,0,0,0,2,2
Dingles & Dangles: A Dungles & Dongles Podcast,0,0,0,0,3,3
Lightning Insider,1,0,0,0,35,36
Wrestling History 101,0,0,0,0,6,6
It Was Said,10,4,0,3,33,50
Breaking Conservatarian,0,0,0,0,1,1
Hillbilly  HazBenz,0,0,0,0,9,9
Verzuz,0,0,0,0,1,1
Off Grid Pros,0,0,0,0,3,3
No Turning Back,1,0,0,0,10,11
Cancelled for Maintenance,0,0,0,0,10,10
Conserving Torah with Rabbi Mark Gottlieb,0,0,0,0,2,2
Human Powered,0,0,0,0,1,1
We Are For Good Podcast - The Podcast for Nonprofits,0,0,0,1,28,29
“Use your inside voice”,0,0,0,0,4,4
CNN Political Briefing,2,1,2,0,8,13
Composed,0,0,0,0,24,24
Passions for Life,0,0,0,0,29,29
Let's Be Cleere,0,0,0,0,79,79
The Queen Podcast,0,0,0,0,20,20
The Marketing Millennials,0,0,0,0,10,10
Sippin' On Sweet Tea,0,0,0,0,1,1
Matis Zelman Nach shiur,0,0,0,0,2,2
The Evolving Angler,0,0,0,0,3,3
The American Compass Podcast,1,0,0,0,2,3
Carl Jung's Red Book + Astrology,0,0,0,0,16,16
Rules of the Game: The Bolder Advocacy Podcast,0,0,0,0,2,2
Cyber Security Headlines,0,0,0,0,4,4
The Narcissistic Abuse Recovery Podcast,0,0,0,0,28,28
Tendy Talk,0,0,0,0,1,1
A Year of Zen,0,0,0,0,4,4
Business on the Bright Side,0,0,0,1,49,50
The SI Fantasy & Gambling Podcast,0,0,0,1,5,6
Bonsai Wire,0,0,0,0,7,7
Polar Conversations,0,0,0,0,1,1
Bent,30,11,11,5,123,180
The Keks Podcast,0,0,0,0,5,5
Plant School,1,0,0,0,2,3
The Mid•Point with Gabby Logan,0,2,0,2,40,44
Speed and Power Podcast,0,0,0,0,2,2
The Boone Podcast,0,0,0,0,7,7
Women Of Project Management,0,0,0,0,18,18
Flip Your Lid with Kim Honeycutt,0,0,0,0,4,4
Dimes and Dozens,1,0,0,0,15,16
The Nani Network,0,0,0,0,11,11
Greeny,50,11,2,2,33,98
The Dr. John Delony Show,5,1,3,2,39,50
Peacock and Williamson NFL Show - Daily Podcast Powered by Locked On,2,0,2,2,48,54
The Pearl Jam Stories,0,0,0,0,1,1
The Crafty Gemini Podcast,0,0,0,0,6,6
The Hangar Z Podcast,0,0,0,0,8,8
The Shared Shutter,0,0,0,0,27,27
All Indians Matter,3,1,0,0,1,5
Escaping NXIVM,4,2,1,6,17,30
Stories from China's History for Kids,0,0,0,1,0,1
Spencer & Vogue,9,3,0,3,63,78
Unjust & Unsolved,12,0,7,8,375,402
RiverSpeak: stories that ripple,0,0,0,0,1,1
"Grow it, Minnesota",0,0,0,0,1,1
The Interview,2,0,0,0,13,15
The BrewDeck Podcast,0,0,0,0,1,1
MIND your hormones,0,0,0,0,18,18
The Strology Show,0,0,0,0,24,24
Life with Fire,0,1,0,0,4,5
Redspin Sports,0,0,0,0,3,3
Friends to Lovers,1,0,0,0,56,57
Bigfoot’s Wilderness Podcast,0,0,1,0,6,7
Hye Jams Radio,0,0,0,0,8,8
This Ends at Prom,0,0,0,0,21,21
The Girly Girl Podcast,0,0,0,1,30,31
The Folk Podcast,0,0,0,0,4,4
Paws & Reward Podcast,0,0,0,0,9,9
Orange Pill Podcast,2,0,1,0,47,50
Romancing the Pod,0,0,0,0,78,78
FTN NBA Podcast,0,0,0,0,11,11
Beekeeping For Newbees,0,0,0,0,7,7
Why Are Dads?,1,0,1,1,47,50
Intimate Covenant Podcast,0,0,0,0,10,10
The Jeremy White Podcast,0,0,0,0,1,1
Jewish History Uncensored,0,0,0,0,4,4
Lux Radio Theatre,0,0,0,0,1,1
Grandstand Golf,0,0,0,0,2,2
Ketogenic Bodybuilding Podcast,0,0,0,0,12,12
After Mash,0,0,0,0,11,11
Rob Goldstone is an Englishman in ...,0,0,0,0,46,46
Super Scary Stories Pod,0,0,0,0,2,2
Name 3 Songs,0,0,0,0,34,34
Establish the Edge,1,0,0,0,10,11
The Danger Room: A Marvel Crisis Protocol Podcast,0,0,0,0,1,1
Tom Brown's Body,17,11,26,24,318,396
Aquadocs,0,0,0,0,7,7
Slappin' Glass Podcast,0,0,0,0,4,4
Timber Wars,1,2,3,1,74,81
A Cottagecore Life,0,0,0,1,0,1
Be Createfull,0,0,0,0,15,15
The Air Up There,0,0,0,1,4,5
Pawareness Podcast,0,0,0,0,12,12
Simms Getz It,0,0,0,0,4,4
Papal Aspirations,0,0,0,0,4,4
The Hollow,0,0,0,4,46,50
American Coyote,33,5,9,6,78,131
Ruined with Alison Leiby and Halle Kiefer,0,0,0,0,81,81
The Artscroll Studios' Podcast,0,0,0,0,3,3
Geology On The Rocks,0,0,0,0,2,2
Twin Beds,0,0,0,0,5,5
EWN - Engineering With Nature,0,0,0,0,1,1
GMS Thundercast,0,0,0,0,2,2
Sunny 16 Presents,0,0,0,0,2,2
La latina con baja autoestima con Rosie Mercado,0,0,0,0,1,1
Gate 7 International Podcast,0,0,0,0,6,6
The GreatBase Tennis Podcast,0,0,0,0,23,23
New Real Estate Agent Mindset,0,0,0,0,3,3
Fnaf And Undertale Songs,2,0,0,0,0,2
Laugh Tracks Legends of Comedy with Randy and Steve,0,0,0,0,1,1
The Bloody Disgusting Podcast,0,0,0,0,15,15
Locals Know Best,0,0,0,0,12,12
Horse Training in Harmony,0,0,0,0,54,54
Dad Strides,0,0,0,0,4,4
Tay To Z: A Taylor Swift Podcast,1,0,0,0,28,29
Fantasy Football Confidential,0,0,0,0,25,25
Dodgers Nation: Dodgers Dougout,0,0,0,0,5,5
Chulbuli Tales Podcast,0,0,0,1,3,4
SIKE WARD,0,0,0,0,25,25
Bottle Ship Adventures,0,0,0,0,48,48
Awesemo NFL DFS & Fantasy Football,0,1,0,0,3,4
Market Mondays,1,0,1,0,198,200
21st & Prime,3,2,3,0,45,53
Market Meditations,0,0,0,0,3,3
Oxventure - A Dungeons & Dragons Podcast,0,1,0,0,49,50
Sway,38,8,26,16,110,198
Funny Stories w/ Ocean Glapion,0,0,0,0,4,4
The Village,0,0,0,0,2,2
The Let’s Talk About It Show,0,0,0,0,2,2
The Athletic Football Show: A show about the NFL,7,0,4,2,214,227
Fantasy Football Today in 5,0,1,0,0,55,56
It's a Material World,0,0,0,0,1,1
FutMexNation,0,0,0,0,2,2
Generation Green New Deal,8,0,1,1,40,50
Today with Claire Byrne,0,0,0,0,1,1
Bad Counsel,0,0,0,0,50,50
Toy Anxiety,0,0,0,0,13,13
Ringtones,0,0,0,0,1,1
Rob Smith is Problematic,0,1,2,1,46,50
NTD News Today,0,0,0,0,4,4
The Business of Data Podcast,0,0,0,0,1,1
Praia dos Ossos,0,0,0,0,4,4
Spanish in 5 minutes - Beginner,0,0,0,0,1,1
The Great American Urban Legend,0,0,0,0,9,9
Who's That Girl? A New Girl Podcast,1,2,0,1,3,7
The Webtoon Room Podcast,0,0,0,0,1,1
Your Cardano Update,0,0,0,0,2,2
WKRP-Cast,0,1,0,1,13,15
Sly Flourish's Lazy DM Prep,0,0,0,0,1,1
PlanetGeo,0,0,0,0,15,15
Comptia Network+ --- Computer Networking for Cybersecurity,1,0,0,0,1,2
Dude! Nature,0,1,0,0,21,22
Runner Moms,0,0,0,1,3,4
Film at Fifty,0,0,0,0,5,5
The Study,1,0,0,0,30,31
Stories for Wonderful Children,0,0,0,0,6,6
Temptation Island RHAPup Podcast,2,1,0,0,34,37
TrainBrave Podcast,0,0,0,0,1,1
Build a Career in Data Science,0,0,0,0,3,3
Department of Homelander Security,0,0,1,1,1,3
Anesthesia Guidebook,0,0,0,0,6,6
Goofin' with Luke Gaston,0,0,0,0,4,4
I Don't Know With Jojo & KevOnStage,0,0,0,1,31,32
You Can Do It with JEFF GALLOWAY,0,0,0,1,5,6
Seminole Wrap: A Florida State Football Podcast,1,0,2,1,16,20
The Town Whispers,5,2,2,0,6,15
The Powers of Math,0,0,0,0,1,1
In Play with Craig Mattick,0,0,0,0,2,2
"Have Kids, They Said…",0,0,1,0,22,23
The Severin Films Podcast,0,0,0,0,16,16
Time Warp Radio: The Rocky Horror Picture Show Movie-by-Minute Podcast,1,0,0,0,10,11
The Co-op Show,0,0,0,0,11,11
Carcerem,0,1,0,0,32,33
Realfoodology,0,0,1,0,14,15
Oprah’s Book Club,18,1,2,4,76,101
All The Asians On Star Trek,0,0,0,0,7,7
Recall: How to Start a Revolution,0,0,0,0,4,4
Life On Purpose with Erica Layne,0,0,0,0,27,27
Blindspot: The Road to 9/11,0,0,0,7,43,50
Girl F You,0,0,2,1,34,37
The Yoga Nidra Podcast,0,0,0,0,3,3
Windowsill Chats,0,0,0,0,42,42
Metro Detroit Golfers Podcast,3,1,0,0,60,64
Behind The Rose,6,1,0,4,54,65
Horror In Session,0,0,0,0,5,5
T.Rex Talk,0,0,0,1,22,23
Journey With Me Through ADHD: A Podcast for Kids,0,0,0,0,15,15
Potted Together,0,2,1,1,25,29
Podcast Intermediate French,0,0,0,0,2,2
The Dairy Download,0,0,0,0,2,2
"Mindful Dog Talk | Dog Training, Dog Behavior, and Dog Psychology",0,0,0,0,1,1
Lets Grow Pulling,0,0,0,0,1,1
Talks from the Hoover Institution,0,0,0,0,1,1
Hank the Cowdog,0,1,3,1,45,50
The Ba-Dum-Ching! with Carl,0,0,0,0,6,6
JEW-ISH,0,0,0,0,2,2
Sparkleside Chats with Magical Girl Ayu,0,0,0,0,2,2
That's So Mets Podcast,1,0,0,0,75,76
Le French Rugby Podcast,0,0,0,0,3,3
Taylored Talks,0,0,0,0,5,5
Our Gifted Kids Podcast,0,0,0,0,1,1
Green with Envy,0,0,0,0,3,3
City on a Hill: Kansas City,0,0,0,0,5,5
No Mans Land,0,0,0,0,11,11
Bio Eats World,3,0,0,0,8,11
The Investopedia Express with Caleb Silver,1,0,0,1,12,14
Story time with Philip and Mommy!,0,0,0,0,4,4
Shooting For Grand,0,0,0,0,3,3
New England Hockey Journal’s The Rink Shrinks,0,0,1,0,22,23
Divine Living,0,0,0,2,245,247
Unpacking Israeli History,0,1,0,1,18,20
One By Willie,0,0,0,2,48,50
Let's Be Single Together with Big Al,0,0,0,2,33,35
Hell & High Water with John Heilemann,2,3,1,6,188,200
Not Your Papa's Podcast,1,0,0,0,3,4
Melanie martinez,0,0,0,1,5,6
What's Her Story With Sam & Amy,1,0,0,0,18,19
Greg Bedard Patriots Podcast with Nick Cattles,2,1,1,0,36,40
Kevin Kietzman Has Issues,12,3,0,3,32,50
The Plant a Trillion Trees Podcast,0,0,0,0,3,3
The Underworld Podcast,2,0,0,0,28,30
Confident Collective,0,0,1,0,33,34
Dog or Pass Podcast,0,0,0,0,96,96
D100 Talk,0,0,0,1,8,9
Our Love Journey With Mpoomy & Brenden,0,0,1,2,46,49
Dread and Breakfast,0,0,0,0,5,5
A Pinball Podcast,0,0,1,0,2,3
Lean Six Sigma Bursts,0,0,0,0,1,1
The Bushwick Bears Petty Crime Review,0,0,0,0,6,6
TRAFFICKED,0,0,0,1,12,13
The Daily Sun-Up,0,0,0,1,12,13
B2B Marketing Leaders,1,0,0,0,29,30
Castzilla VS The Pod Monster's podcast,0,0,0,0,4,4
Naturalist Kids Podcast,0,0,0,0,9,9
We're Going There with Bianca Juarez Olthoff,0,0,0,2,225,227
Run For Something,1,1,0,0,9,11
The Phenomenon Report,0,0,0,0,1,1
EmPowered Radio,0,0,0,0,50,50
Push The Envelope: Unfiltered Conversations With And About Hollywood,0,0,0,0,7,7
Cricket Nagaram - A Telugu Podcast,0,0,0,0,2,2
Another Podcast Tonight!,0,0,0,0,24,24
Politely Rude With Abby Johnson,5,0,0,2,40,47
Ghost Notes,0,0,0,0,3,3
The Super 6 Podcast,0,0,0,0,1,1
CEREBRO,0,1,0,2,17,20
The Wadeoutthere Fly Fishing Podcast,0,0,0,0,13,13
No Compromise,39,7,8,11,90,155
"THE BETTER BELLY PODCAST - Gut Health Transformation Strategies for a Better Belly, Brain, and Body",0,0,0,0,12,12
Pediatric Meltdown,0,0,0,1,3,4
Who We Are: A Chronicle of Racism in America,8,2,2,0,26,38
The Recovery Atheist,0,0,0,0,1,1
The Safety Struggle,0,0,0,0,7,7
Who's There? A Podcast About Horror Fans,0,0,0,0,6,6
Eden Grove: An Improvised Podcast,0,0,0,0,2,2
Obsessed With The Best w/ Alex & Tina,0,0,0,0,12,12
Ice Cold Takes: A New York Rangers Hockey Podcast,0,0,1,0,20,21
The Leangains Podcast,0,0,0,0,3,3
FREAKY TALEZ PODCAST,0,0,0,0,4,4
Four Corners Fantasy Podcast,0,0,0,0,10,10
The Thyroid Fix,0,0,0,0,29,29
Double Barrel Gaming,0,0,0,0,7,7
Film Crew 101,0,0,0,2,80,82
Krystine's FLR Podcast,0,0,0,1,4,5
Aging Otakus: A Retro Anime Podcast,0,0,0,0,5,5
Is This Anything?,0,0,0,0,5,5
Missing the Point with Myles David,0,0,0,0,4,4
The Spiritual Academy,0,0,0,0,4,4
Sex Outside,0,0,0,0,7,7
TechPresso,0,0,0,0,5,5
Recovering Gleek: A Glee Podcast,0,0,2,6,188,196
Battleground with David Plouffe & Steve Schmidt,3,0,0,1,46,50
Suplexes and Cervezas with Chavo Guerrero Jr.,0,0,0,0,10,10
The Cashflow Contractor,0,0,0,0,3,3
Baby Steps,2,0,0,2,46,50
This Is Important,0,0,0,1,49,50
Nutrition with Judy,0,0,0,0,2,2
Good Mourning,0,1,0,0,5,6
Turn Down for Walt,0,0,0,0,4,4
WUSSY Movie Club,0,0,0,0,3,3
Design Lab with Bon Ku,0,0,0,0,12,12
The Verywell Mind Podcast with Amy Morin,1,0,0,2,47,50
El Santo Rosario,0,0,0,0,2,2
Russell Wilson's DangerTalk Podcast,8,2,4,7,54,75
Seven & Seven Is Radio,0,0,0,0,3,3
Geek No Evil featuring The DOPE NERDS,0,0,0,0,4,4
We Are Not the Virus,0,0,0,0,2,2
The Pet Healer,0,0,0,0,1,1
Exploded View,0,0,0,0,1,1
Back Again with Troopz,6,0,1,2,80,89
Reel Abstractions,0,0,0,1,4,5
Classical Kids Corner,0,0,0,0,1,1
Improv is Dead,0,0,0,0,50,50
Real Estate by Relationship™,0,0,0,0,12,12
Tig and Cheryl: True Story,0,0,0,2,48,50
Lone Star Keto,0,0,0,0,1,1
Devilfruit,0,0,0,0,3,3
Closing Crawl,0,0,0,0,6,6
Unexpected Points,0,0,0,0,2,2
What's Your Secret,0,0,0,0,18,18
The Limitless Canine Podcast,0,0,0,0,4,4
The Not So Simple Life,0,0,1,0,41,42
Poke the Bear,0,0,0,0,6,6
Celebrity Salute,0,0,0,0,1,1
Unconditional Healing with Jeff Rubin,0,0,0,0,5,5
Tangible Remnants,0,0,0,0,1,1
The Shit No One Tells You About Writing,0,0,0,0,6,6
Brainwashed,2,0,1,1,7,11
The Super Secret Hive,1,0,1,1,30,33
The Fire You Carry,0,0,0,0,18,18
Ranting Rangers: A NY Rangers Podcast,0,0,0,0,1,1
Hablemos de Mascotas con Dr.B Vet,0,0,0,0,25,25
This Is Hardcore Podcast,0,0,0,0,18,18
The A Team - A Pretty Little Liars Podcast,0,0,0,0,5,5
Bronco Talk,0,0,0,1,15,16
Shit 90s Shows Taught Me | Boy Meets World / Dawson's Creek/90s TV,0,0,0,0,7,7
Haptic & Hue,0,1,0,0,8,9
The Walk Around,0,0,0,0,2,2
Service Business Mastery - Business Tips and Strategies for the Service Industry,0,0,0,0,6,6
Real Gamer Hour,0,0,0,1,9,10
NY Denim Hangs Podcast,0,0,0,0,5,5
The SB Nation NFL Show,1,0,0,1,62,64
Beyond Measure with Christina Whitlock,0,0,0,0,9,9
Paint The Medical Picture Podcast,0,0,0,0,4,4
GoodMusicThursdays Podcast,0,0,1,0,3,4
Rediscovering the Indies,0,0,0,0,1,1
Mesivta of Waterbury,0,0,0,0,2,2
Colourful,0,0,0,0,1,1
Weather Wise Guy Podcast,0,0,0,0,1,1
Weather with Cliff Mass,0,0,1,1,21,23
Kids Opinion Sport Talk,1,0,0,1,5,7
Mea Culpa with Michael Cohen,4,2,4,2,38,50
Rotten Tomatoes is Wrong (A Podcast from Rotten Tomatoes),3,2,0,0,13,18
The Checkpoint,0,0,0,0,3,3
Inside Java,0,0,0,0,3,3
Shonen Tapes,0,0,0,0,7,7
The Millennium Microphone - A Yu-Gi-Oh! Podcast,0,0,0,0,4,4
Rockonteurs with Gary Kemp and Guy Pratt,0,0,0,0,15,15
Know That: A Real Housewives Podcast,0,0,0,0,24,24
Rudimental Mindset Podcast,0,0,0,0,3,3
The Sip with Ryland Adams and Lizze Gordon,25,6,2,2,15,50
The U.N.A.S.S. Midwatch,0,0,0,1,3,4
interMISSION @ the CSO,0,0,0,0,7,7
Sarde After Dinner Podcast,0,0,0,0,12,12
A Simple Podcast,0,0,0,0,8,8
Lady Justice: Women of the Court,0,0,1,0,2,3
TinyHalls,1,0,0,0,1,2
Speaking Torah,0,0,0,0,1,1
The Kevin Malone podcast,0,0,0,1,1,2
The FPL Wire,1,0,0,0,3,4
Higher Battle,0,0,0,0,4,4
Back Points,0,0,0,0,6,6
Smell Ya Later,0,0,0,1,14,15
Ska Boom - An American Ska & Reggae Podcast,0,0,0,0,3,3
W.C.A.B. Podcast: a podcast about tech,0,0,0,0,2,2
The Greatest Stories Never Told,0,0,0,0,3,3
Same Old Spurs,0,0,0,0,1,1
The Sith Council with Kristian Harloff,0,1,0,0,187,188
All My Movies with Dan Murrell,1,0,0,1,187,189
The New Englandah,0,0,0,0,16,16
Mother Daughter Earth: an Environmental Sustainability Podcast,0,0,0,0,8,8
BAIR Podcast,0,0,0,0,1,1
The Genius Recipe Tapes,0,1,1,0,6,8
Giving Done Right,0,0,0,0,14,14
Tales by the Fireside - Bedtime stories and sleep meditation,2,0,0,1,1,4
Ten Eight Podcast,0,0,0,0,16,16
Weeb x Weeb,0,0,0,0,4,4
Golden Age of Cardboard | A vintage sports card podcast,0,0,0,0,10,10
Brad & Steve Do Pods,0,0,0,0,5,5
The Pin Pod,0,0,0,0,15,15
Shop Talk with the Sheriff,0,0,0,0,2,2
The Crew Review,0,0,0,0,3,3
The Drop,0,0,0,0,7,7
Just B with Bethenny Frankel,2,0,0,4,49,55
Upstream International,0,0,0,0,2,2
Psychosocial Distancing,0,0,0,0,1,1
ABCD:TOS,0,0,0,0,6,6
Club Shay Shay,3,0,1,6,237,247
Wellness Your Way with Megan Lyons,0,0,0,1,26,27
Podcasts,0,0,0,0,2,2
Mooch FM,2,0,0,1,10,13
Salt Cast: The stories behind Rocket League Esports,0,0,0,0,5,5
Tiny Urban Homesteading,0,0,0,0,1,1
Wheelman Podcast,0,0,0,0,1,1
The Dime Package,9,3,5,2,112,131
The Millionacres Podcast,0,0,1,0,7,8
Bad Faith,40,6,6,10,285,347
CHARLI AND DIXIE: 2 CHIX,8,0,0,0,42,50
The Dragon Ball Virgin,0,0,0,2,7,9
The Third Person with Darrell Hammond and Chris Millhouse,1,0,0,0,16,17
TCAP It Off: The To Catch a Predator Podcast,2,1,0,0,1,4
Film Vs Film,0,0,0,0,2,2
Ranger Bill,0,0,0,0,3,3
PaintTalks's podcast,0,0,0,0,13,13
Retail Reborn from The Business of Fashion,0,0,0,0,2,2
Thoughts From Cami,0,0,0,0,2,2
SOLD OUT: Rethinking Housing in America,1,2,1,1,36,41
First Date Follow Up - The Jubal Show,1,0,0,0,8,9
Idiots in the News - The Jubal Show,0,0,0,0,1,1
Cherokee Tribune-Ledger Podcast,0,0,0,0,2,2
Friends & Fiction,0,0,0,0,3,3
So This Is What Happened...,0,0,0,0,2,2
Too Hot For Hockey,1,0,0,0,0,1
Appearances,0,2,1,0,69,72
Everything Fab Four,0,2,0,1,2,5
Adopt Me Podcast (Roblox),0,1,2,4,29,36
Drag Us To Hell,0,0,0,0,4,4
Your Bird Story,0,0,0,0,1,1
How to Play Siri Audio Briefs,1,0,0,0,0,1
Pause/Play,0,0,0,0,4,4
The Directors Series with Cameron Beyl: A Film History Podcast,0,0,0,0,1,1
XS - The Science & Supernatural Podcast,0,0,0,0,31,31
Press 4 to Defuse | Your Weekly Valorant Competitive News,0,0,0,1,0,1
Art Bound,0,0,0,0,5,5
The Plain Truth !,2,0,0,0,0,2
F-14 Tomcat ATG Radio show/Podcast,0,0,0,0,5,5
Love Nature: The Biophilia Podcast,0,0,0,0,2,2
Between The Lines with Melissa Reddy,2,0,0,0,2,4
The Fatty Joe Show,0,0,0,0,6,6
No Grey Zone Podcast,0,0,0,0,1,1
American Consequences With Trish Regan,5,0,0,0,5,10
Unbiased Science,0,0,0,2,19,21
"Witches, Magic, Murder, & Mystery",0,1,0,2,20,23
OCS Field Guide: A PT Podcast,0,0,0,0,17,17
China In Focus,0,0,0,0,1,1
Allure: The Science of Beauty,1,2,4,3,18,28
Sports Cards Nonsense,13,9,6,4,36,68
With Gourley And Rust,0,1,3,2,67,73
Dipped In Tone,0,0,0,0,14,14
Mr Gratitude Presents the living with Gratitude podcast,0,0,0,0,13,13
Birdie Dads: A Golf Podcast For Dads,1,0,0,0,13,14
The Anna Bey Podcast,6,1,2,7,475,491
SlashU,0,0,0,0,10,10
All Things Covered with Patrick Peterson and Bryant McFadden,1,0,0,0,54,55
The Private Medical Practice Academy,0,0,0,0,7,7
Today’s Lucky Winner,0,0,0,0,7,7
The Simple Low Carb Lifestyle Podcast,0,0,0,0,1,1
The APsolute RecAP: Physics 1 Edition,0,0,0,0,1,1
Cup of Three,0,1,0,0,3,4
Wrestling With My Partner Podcast,0,0,0,0,1,1
Moms and Baseball,0,0,0,0,3,3
Therapy Gecko,0,0,0,0,13,13
Open World,1,0,0,0,12,13
Cinedicate,0,0,0,0,1,1
Best Whatever Ever! Stories for Kids,0,0,0,0,13,13
BewilderBeasts,0,0,0,0,3,3
The Glitch In The Code Show,0,1,0,0,7,8
Gameplay,1,0,0,1,23,25
How Didn't This Get Made?,0,0,0,0,1,1
life i design: The Podcast,0,0,0,0,2,2
The STOL Collective,0,0,0,0,2,2
Y Nada Mas | A Real Madrid Podcast,0,0,0,0,3,3
From Negative to Positive with Pitbull,0,1,1,0,30,32
Development Hell,0,0,0,0,2,2
Goodbye Crop Top,1,3,0,0,15,19
You and Me Both with Hillary Clinton,107,3,1,9,380,500
Safiq’s Corner,0,0,0,0,2,2
Andy In The Morning - Majic 95.1,0,0,0,0,1,1
Fairy Tale Fix,0,0,0,0,20,20
The Dershow,35,2,4,2,103,146
The Root Presents: It's Lit!,0,0,1,0,7,8
SABACC TALK,0,0,0,0,18,18
Living & Learning with Reba McEntire,0,0,0,2,73,75
History of Africa,0,0,0,1,9,10
Competition Diaries,0,0,0,0,3,3
Sweetbitter | A Sappho Podcast,0,0,0,0,26,26
"The Fault Line: Bush, Blair and Iraq",1,0,0,0,8,9
Brave New Planet,2,4,3,0,27,36
Fly Cool Shit - An Aviation Podcast About Flying Cool Shit,0,0,0,0,2,2
Getting My Act Together,0,0,0,0,3,3
Zoology Ramblings,0,0,0,0,1,1
The Outcasters,0,0,0,0,1,1
The Blachelorettes,0,0,0,0,4,4
Suspicious Activity: Inside the FinCEN Files,26,5,4,1,14,50
Relationship Theory,0,0,0,0,2,2
Ask This Old House,0,2,0,2,4,8
City of Town: An Improvised DnD Adventure!,0,0,0,0,18,18
If You Can't Handle The Heat,0,0,0,0,7,7
Transnatural Perspectives Podcast,0,0,0,0,1,1
That Halloween Podcast,1,0,0,0,15,16
Super Creative,0,0,0,0,14,14
Locked On Boston College - Daily Podcast On Boston College Eagles Football & Basketball,0,0,0,0,26,26
Abby talks about anime!,0,0,0,0,3,3
Real Time with Prince Blue,3,0,0,0,6,9
The Murders at White House Farm: The Podcast,10,4,3,0,14,31
Humans Growing Stuff,4,0,1,2,21,28
The ETCs with Kevin Durant,3,2,0,4,97,106
ScaryCrit,0,0,0,0,2,2
PMP Industry Insiders,0,0,0,0,14,14
Oklahoma Appeals - The Podcast,0,0,0,0,4,4
FTN FAABcast,0,0,0,0,24,24
Hemmings Hot Rod BBQ Podcast,1,0,1,1,1,4
Louder Than A Riot,17,5,4,5,182,213
Baby Mamas No Drama with Kail Lowry & Vee Rivera,15,6,11,26,442,500
Creator Chat,0,0,0,2,3,5
Dear Liisphyra,0,0,0,0,41,41
Click Bait with Bachelor Nation,105,31,40,28,265,469
The World As You'll Know It,0,0,0,0,4,4
Vision of a Champion with Anson Dorrance,0,0,0,0,7,7
Theme Time Radio Hour with your host Bob Dylan,0,0,0,2,10,12
The Lonely Pipette : helping scientists do better science,0,0,0,0,1,1
Unlocking Greatness Podcast with Zenja Glass,0,0,0,0,28,28
Gagging With Jason Lee,0,0,1,0,6,7
Newbie Star Trek,0,0,1,0,3,4
Grouse,2,0,0,2,3,7
NowThis Brief,1,0,0,1,1,3
Honeydew Me,0,0,0,0,19,19
Success Hotline With Dr. Rob Gilbert,1,0,0,0,2,3
The American Craftsman Podcast,0,0,0,0,5,5
The Hockey House,0,0,0,0,3,3
Growing with Letty & Lucy,0,0,0,0,1,1
The Scoop Cricket Podcast,0,0,0,0,1,1
Applesauce Penguin,0,0,0,0,1,1
Canary: The Washington Post Investigates,9,3,2,2,196,212
Chameleon: Hollywood Con Queen,19,19,26,18,351,433
Kings of Con: The Podcast,0,0,1,2,21,24
Believe It! A Naruto Podcast,0,0,0,0,2,2
Dirt - An Audio Drama,0,0,0,0,11,11
Haunted Places: Ghost Stories,4,3,1,4,30,42
Classic Car Corner,0,0,0,1,12,13
The Dave Portnoy Show with Eddie & Co,11,2,2,4,180,199
The News with Shepard Smith,7,1,1,1,25,35
The Builder Nuggets Podcast,0,0,0,0,6,6
51 Strokes,0,0,2,4,240,246
NP Pulse: The Voice of the Nurse Practitioner (AANP),0,0,0,0,2,2
Morning Meeting,0,0,1,1,18,20
Fast To Heal Stories,0,0,0,0,12,12
The Midlife Sex Coach for Women Podcast,0,0,1,0,18,19
Resilient Farming,0,0,0,0,4,4
The Art of Asking Everything,1,0,1,0,26,28
The PokeTower Podcast,0,0,0,0,21,21
Amazing War Stories,0,0,0,0,10,10
Run It BAC%,0,0,0,0,8,8
AppleInsider Daily,2,0,0,0,0,2
The Emotion Motion Podcast,0,0,0,1,42,43
The Ship-it Show,0,0,0,0,7,7
Uniquely Human: The Podcast,0,0,0,0,12,12
Spilling the Paint Water with Chloe Rose,1,0,1,1,103,106
And THAT'S That!,1,0,0,0,6,7
Baby Animals,0,0,1,0,0,1
The Birding Tools Podcast,0,0,0,0,5,5
4OURPLAY - A Swinger Podcast,1,0,0,0,5,6
Kamala: Next in Line,42,0,1,0,7,50
Superstitions,14,8,4,1,21,48
The Late Night Flight,0,0,0,0,2,2
Parkdale Haunt,1,6,3,6,34,50
The Way Forward,1,0,0,0,11,12
Disney Stories For Kids,2,1,1,0,0,4
The Science of Birds,1,0,0,0,16,17
Wayward Guide For The Untrained Eye,0,2,1,0,47,50
Hearties Hotline,0,0,0,0,7,7
Check Your Aesthetic Podcast,0,0,0,0,26,26
Garthology - A Study of Garth Brooks,0,0,0,0,4,4
Scream!,12,11,4,11,104,142
The Hifi Podcast with Darren and Duncan,0,0,0,0,6,6
Unrestricted with Ben Leber,1,0,0,0,35,36
Moms and Margs,2,0,0,0,20,22
"Learning How to See with Brian McLaren, Jacqui Lewis and Richard Rohr",0,2,0,1,18,21
New Jack's Safe Space,0,0,0,0,6,6
Fully Vetted from the National Corvette Museum,0,0,0,0,3,3
Marketing & Influence Podcast,0,0,0,0,50,50
The GOAT: Tom Brady,3,5,5,2,19,34
There She Rose,0,0,0,0,2,2
CoinDesk Reports,0,0,0,0,1,1
Track World News,0,0,0,0,3,3
U.S. National Privacy Legislation Podcast,0,0,0,0,1,1
The Photographer's Eye with Omar Gonzalez,0,0,0,0,1,1
The 90th Percentile: An Unconventional Leadership Podcast,0,0,0,0,56,56
CLE Rocks,0,0,0,0,2,2
The Bald and the Beautiful with Trixie Mattel and Katya Zamo,2,0,2,3,43,50
The Josh Potter Show,2,0,0,1,47,50
"It's Sedimentary, My Dear: A Geology Podcast",0,0,0,0,1,1
Split Zone Duo,2,1,2,3,198,206
Modern Musician,0,0,0,1,49,50
Equivalent Exchange: A Fullmetal Alchemist Podcast,0,0,0,0,1,1
Sacred Text Messages,0,0,1,0,23,24
For The Reef Podcast,0,0,0,0,2,2
No Time To Die: The Official James Bond Podcast,1,1,0,0,5,7
Anatomy of Murder,22,0,10,16,132,180
Water Flying,0,0,0,0,1,1
Finshots Daily,0,0,0,1,27,28
The ProPhysique Code,0,0,0,0,2,2
Let's Jaws For a Minute,0,0,0,0,8,8
Hard Candy & Fruit Snacks,0,0,0,0,39,39
Mean Streets with Chris Meaney,0,0,0,0,8,8
Coordinated,0,0,0,0,16,16
Leadership Lessons from the Fast Lane with Gary Heil,0,0,0,0,2,2
Apple Talk,3,1,1,0,54,59
La Cuenterapeuta: la terapeuta que cuenta cuentos.,0,0,0,0,1,1
Kelly Corrigan Wonders,1,0,0,4,224,229
Must Watch: Netflix Edition,0,0,0,0,9,9
The Michelle Obama Podcast,116,0,4,4,256,380
Animal Wise,0,0,0,0,5,5
Haunting Season,0,0,0,0,9,9
The Megyn Kelly Show,20,6,24,10,938,998
Ever After with Jaleel White,0,0,0,0,27,27
Two Designers & A Builder Walk Into A Bar,0,0,0,0,3,3
Van Life with Tom Green,0,0,0,0,48,48
Street TV,0,0,1,0,27,28
Film Feast,0,0,0,0,2,2
Who Can Relate?,0,0,0,0,50,50
The Quest with Justin Kan,0,0,0,0,22,22
The Real Sisters of Sobriety,0,0,0,0,6,6
Stories from Flying the Nest,0,1,1,1,57,60
Contrary To Popular Wrestling with Carmine DeSpirito and James Southard,0,0,0,0,1,1
The WandaVision Podcast by Phantastic Geek,1,0,2,3,35,41
Super Great Kids' Stories,1,1,0,0,23,25
Raven Careers Aviation Podcast,0,0,0,0,7,7
Central Division,0,0,0,0,1,1
Resistance,2,0,0,0,68,70
The Sarah Silverman Podcast,21,2,6,13,451,493
PartnerUp The Partnerships Podcast,0,0,0,0,2,2
Hollywood-ography,0,0,0,0,6,6
Human Seeking Human,0,1,0,4,83,88
"The 4 Ms with Molly--Macros, Mindfulness, Movement, & Meditation",0,0,0,0,2,2
Criterion CULT Film Podcast,0,0,0,0,2,2
The John Clay Podcast,0,0,0,0,2,2
BRAVE COMMERCE,0,0,0,0,9,9
The Bathroom Wall,0,0,0,0,2,2
Getting It Done with Kai Greene,0,0,0,0,14,14
Enthusiast!,0,0,0,0,7,7
The BiGGz Show,0,0,0,0,5,5
Do The Work,2,0,0,1,28,31
The UX Kitchen Podcast,0,0,0,0,5,5
CREEPYPASTA - True scary horror stories & paranormal podcast,0,0,0,0,4,4
Abide Bible Sleep Meditation for Kids,0,0,0,0,3,3
After Hours With Amanda,0,0,0,0,50,50
Scratch Stories: A Scratch Golf Tips Podcast,0,0,0,0,5,5
Olivia Rodrigo Brasil,0,0,0,0,7,7
The Shadow Diaries,1,1,2,7,39,50
RugbyPass Offload,0,0,0,0,1,1
My 90s Playlist,2,2,0,2,42,48
Altitudes by Etihad,0,0,0,0,1,1
Kawaii Desuppointment,0,0,0,0,4,4
The Industry of UX,0,0,0,1,4,5
FreedHearts,0,0,0,0,8,8
The Deduction,0,1,0,0,3,4
PROOF: A Pre-Election Special,1,0,0,0,11,12
Who Smarted?,1,0,1,3,44,49
La advertencia,0,0,0,0,5,5
Fish Bytes,0,0,0,0,1,1
The Hopeful,0,0,0,0,11,11
The Not Before Podcast,0,0,0,0,12,12
Texas Devil Running Talk Show,0,0,0,0,1,1
Jalen Rose: Renaissance Man,1,0,1,0,38,40
Speaking for the Trees,0,0,0,0,1,1
The Heart of Jacks Podcast,0,0,0,0,12,12
Survive and Advance,0,0,0,0,4,4
Anime Junkies: Three Weebs and a Podcast,0,0,0,0,2,2
Podpah,0,0,0,0,1,1
Food by Design: an IDEO Podcast,0,0,0,0,59,59
Guitar Villains,0,0,0,0,50,50
Guys That Golf,0,0,0,0,4,4
The Cris Collinsworth Podcast featuring Richard Sherman,2,2,0,1,30,35
The Artist Business Plan,0,0,0,0,5,5
Let Me Back Up,0,0,0,0,5,5
Winter of Discontent - A Beatles Podcast,0,0,0,0,1,1
The Film Scorer,0,0,0,0,5,5
The TARN Conspiracy,0,0,0,0,1,1
Jar of Rebuke,0,0,0,0,15,15
Brett Finch Uncensored,0,0,2,2,54,58
"Girl and The Gov, The Podcast",0,0,0,0,29,29
The Nurse,26,10,14,18,88,156
That Gaby Roslin Podcast,0,0,0,3,59,62
The Lost Mountain Saga,0,0,0,0,37,37
Heart at Home with Farm Life Outfitters,0,0,0,0,3,3
The Other Side of Midnight with Frank Morano,0,0,1,0,11,12
Misfits and Mysteries,0,0,0,0,17,17
War of the Roses - The Jubal Show,0,0,0,0,8,8
Agents: Declassified,0,0,0,1,10,11
Dishin' Dirt with Gary Pickren,0,0,0,0,2,2
Game Theory Today with Eric Garland,1,0,0,0,28,29
The Doctor’s Crossing Carpe Diem Podcast,0,0,0,0,35,35
True Crime & Cocktails,0,0,1,0,196,197
First Team Second String,0,0,0,0,4,4
Because Mom Said So,5,1,2,9,137,154
Celebrity Book Club with Chelsea Devantez,2,2,0,3,97,104
Total Car Score,0,0,0,0,2,2
Hipsterocracy,0,0,0,0,9,9
Tower 4,2,4,5,4,25,40
The Talegate Podcast,0,0,0,0,4,4
The Dark Parts,0,1,4,0,45,50
Let's Go To War,0,0,0,0,2,2
Leah's Fieldnotes,0,0,0,0,12,12
Rolling on 3,0,0,0,0,3,3
Capital University,6,0,0,1,193,200
We Got You,0,0,0,0,8,8
The Promised Land,0,0,0,0,10,10
Sofia with an F,13,1,0,1,35,50
Reiter Than You,0,0,0,0,1,1
Cryptography FM,0,0,0,0,1,1
On The Forecheck: for Nashville Predators fans,0,0,0,0,1,1
Why is Everyone Yelling?,0,1,0,0,37,38
The Carl Nelson Show,0,0,0,0,3,3
The Fly Angle: The Official RDU Airport Podcast,0,0,0,0,1,1
Real Science Exchange,0,0,0,0,2,2
The Weak-Side Podcast,0,0,2,1,16,19
New Ice City: A Podcast About The New York Rangers,0,0,0,0,12,12
Live With Lil: Marvel's Agents of Shield Rewatch,0,0,0,0,109,109
Mythoholics,0,0,0,0,12,12
Mid-Am Crisis: A Golf Discussion,0,0,0,0,4,4
Bed Wed or Behead,0,0,0,0,4,4
Good Neighbors,0,0,0,0,2,2
DEM TIMES,0,0,0,0,1,1
Children of the Stones,1,0,0,1,1,3
The Confused Breakfast,0,0,0,0,17,17
"The Deep Dish - The ""Julie and the Phantoms"" Podcast",0,0,0,0,8,8
The Drone Pro Podcast,0,0,0,0,2,2
The Adventures of Power Dog in Dogland!,0,0,0,0,9,9
Q Clearance: The Hunt for QAnon,21,9,6,6,57,99
13 Days of Halloween,5,4,3,5,33,50
Tentpole Trauma,0,0,0,0,3,3
The c4 podcast,0,0,0,1,0,1
Grueter Golf Presents: Low Expectations,0,0,1,0,9,10
A Spoonful of Podcast,0,0,0,0,1,1
"The Joy Filled Mama - Christian Motherhood, Self Care, and Faith Based Encouragement for Moms",0,0,0,0,48,48
Holtecast - An Aston Villa Podcast,0,0,0,1,3,4
Native Film Talk,0,0,0,0,8,8
Pregnancy Pearls Podcast,0,0,0,0,3,3
Connecting with Dr. Kim Swales,0,0,0,0,34,34
The Real Moms Podcast,0,0,0,0,13,13
"""See, The Thing Is...""",19,8,15,12,158,212
Creator Economics,0,0,0,0,6,6
My Modern Met Top Artist Podcast,0,0,0,0,3,3
Myprotein's The Scoop,2,1,0,0,41,44
Bearded Bettors - Sports Betting Podcast,0,0,1,0,65,66
90210MG,19,11,19,19,335,403
the GUSSIE,0,1,0,0,27,28
We Should Talk,0,0,0,0,9,9
Adkins Undisputed: The Most Complete Scott Adkins Podcast in the World,0,0,0,0,5,5
IF YOU DON'T LIKE THAT WITH GRANT NAPEAR,14,2,0,7,185,208
Blooddice,0,0,0,0,2,2
Goat Gab,0,0,0,1,2,3
Jewish Ancestral Healing Podcast,0,0,0,0,4,4
Digital Health Unfiltered,0,0,0,0,2,2
Fantasy Best Ball Exclusive,0,0,0,0,22,22
Out & About,1,1,0,0,27,29
Digging a Hole: The Legal Theory Podcast,0,0,0,0,2,2
Moonbeaming,0,1,1,1,302,305
Colubrid Corner,0,0,0,0,1,1
How Soccer Explains Leadership Podcast,0,0,0,0,3,3
"Shotgun Sports USA Podcast | Sporting Clays, Trap and Skeet Shooting",1,0,1,0,6,8
The New 52 and You!,0,1,1,0,9,11
UNTOLD RADIO AM,0,0,0,0,3,3
Hamish & Andy’s Remembering Project,0,4,5,6,66,81
The Lupe and Royce Show,2,2,3,4,128,139
The Monsters That Made Us,0,0,0,0,1,1
The Official Trial of the Chicago 7 Podcast,1,0,0,0,6,7
The Light Diet,0,0,0,0,3,3
BFFs featuring Josh Richards and Dave Portnoy,21,1,2,5,121,150
Sales School with Jordan Belfort,0,0,0,0,6,6
Only You: A One and Done Podcast,1,1,0,1,4,7
Beau Knows,0,0,0,0,9,9
Biohacking Superhuman Performance,1,0,0,0,22,23
Right on Radio,1,1,0,0,2,4
Chuck Rewind,0,0,0,0,1,1
Polyganometry,1,0,0,0,1,2
The Better Days Podcast,0,0,0,0,2,2
Surgeons In 3D Printing,0,0,0,0,4,4
Diet Culture Rebel Podcast,0,1,0,0,5,6
Grant Writing Simplified,0,0,0,0,1,1
FML Talk,0,0,0,0,48,48
Church News,0,0,0,0,15,15
Nicky And Moose The Podcast,0,0,0,1,88,89
The Direct Podcast,0,1,0,1,11,13
THE FEDPOST,1,0,1,0,6,8
All Consuming,1,1,0,0,18,20
ART'S COOL with Ken Goshen,0,0,0,0,8,8
The City in the City in the City,0,0,0,0,32,32
What if it's True Podcast,0,0,0,1,41,42
Lit Century,0,0,0,0,2,2
The Missing Chapter: History's Forgotten Stories,0,0,0,0,5,5
Chili Dip Pod,0,0,0,0,11,11
Never Too Old For Agoodspankin,0,0,0,0,4,4
Russell Gets Revenge,0,0,0,0,9,9
Experiences Unexplained,1,0,0,0,3,4
Billy Bob the Podcast,0,0,0,0,10,10
Wednesday Wake-Up with Gregory Maloof,0,0,0,0,6,6
The Official MS5 Podcast,0,0,1,0,10,11
"Two Guys, A Girl and a Podcast",0,1,0,1,25,27
UNDISTRACTED with Brittany Packnett Cunningham,0,0,0,0,50,50
Climate Curious,0,0,0,0,1,1
Out of the Woods,0,0,0,0,3,3
The Future of Fashion by Vogue Business,1,0,0,0,0,1
Bobbo Supreme,1,0,0,1,10,12
Bringing Chemistry to Life,0,0,0,0,1,1
Web DM Talks,0,1,0,0,12,13
That's Totally Normal!,0,0,0,0,15,15
Pinkalicious & Peterrific,2,1,3,1,21,28
Transmissions: The Definitive Story of Joy Division & New Order,0,1,0,1,7,9
More Than A Muse,0,0,0,0,3,3
Playing The Odds NASCAR Style,0,0,0,0,1,1
Into the Mother Lands,0,0,0,0,3,3
Talking Feds: Women at the Table,0,0,0,0,5,5
The Exotic Pet Collective,0,0,0,0,1,1
Growing With The Flow,0,0,0,1,34,35
Days Like These,0,0,1,3,49,53
Broken By Concept,0,0,0,0,3,3
Steeevin’s Sentiments,0,0,0,0,11,11
TEEN GIRL TALK,1,0,0,0,0,1
Lost Trade,0,0,0,1,34,35
Bioethics for the People,0,0,0,0,9,9
Talking to the opening,0,0,0,1,0,1
Thryfty: Unchained,0,0,0,0,1,1
BiggerPockets Daily,1,0,0,0,25,26
Hey Spirit! With Theresa Caputo,2,1,1,1,126,131
Writer's Block,0,0,0,0,9,9
Ensign College Devotionals,0,0,0,0,1,1
Fuel For Thought,0,1,1,1,1,4
Fiasco: Bush v. Gore,0,1,1,0,13,15
Dauster and Da'Sean,2,0,0,0,10,12
Chairside Live Dental Insights,0,0,0,0,1,1
Orange Slices,0,0,0,0,19,19
SVG Business Boss Podcast,0,0,0,0,2,2
The Greg Kelly Podcast,1,0,0,0,50,51
Dead and Gone,24,26,36,18,396,500
Margaret's Garden,1,1,1,0,5,8
Out of Place,0,0,0,0,3,3
Resonate: 10 Years of Brooke Fraser's Flags,0,0,0,0,4,4
Stock Market Investing with Giovanni Rigters,0,0,0,1,1,2
Standig Room Only: A show about the Washington Football Team and D.C. sports,0,0,0,0,40,40
A Matter of Degrees,1,0,1,0,43,45
NYC VIDEO PODCAST,0,0,0,0,2,2
Design Nerds Anonymous,0,0,0,0,1,1
The Friendship Rewind–A 10 Year Retrospective of My Little Pony: Friendship is Magic,0,0,0,0,4,4
Bougie Adjacent,0,0,0,0,4,4
Golden Ducks Cricket Podcast,0,0,0,0,2,2
Football 24/7 with John McMullen,0,0,0,0,1,1
The Steve Mags Muscle Car Show,0,0,0,0,9,9
Modulus,0,0,0,1,9,10
The World to Come,0,0,0,0,18,18
The Miami Chronicles,0,1,1,0,24,26
Specimens,0,0,0,0,10,10
Ripstop on the Record,0,0,0,0,2,2
OUT HERE,0,0,0,0,6,6
Getcha Rocks Off with Mick Wall,0,0,0,1,5,6
Al-Anon Reading,0,0,0,0,1,1
American Prodigy: Freddy Adu,1,2,2,5,300,310
Breaking Down: Collapse,0,0,0,0,9,9
Flirting With Failure,0,0,0,0,3,3
Dr.Sky / Episode #1,0,0,0,0,1,1
The Marvel Guys,0,0,0,0,2,2
Bedtime Stories For Kids Hindi|English,0,0,0,0,3,3
The Plant KiKi,0,0,0,0,11,11
Taskmaster The Podcast,3,4,4,5,41,57
100 000 ans,0,0,0,0,1,1
Ship-Talking | Podcast,0,0,0,0,3,3
The Big Foodies,0,0,0,0,9,9
Theory of DFS - Daily Fantasy Sports Strategy,1,0,0,0,20,21
Elvis Right Now,0,0,0,0,1,1
Behind the Dish with John Buck,0,0,0,0,5,5
Ghoul,1,1,2,1,70,75
Creating Consciousness: A Spiritual & Intuitive Tarot Podcast For Self-Growth,0,0,0,0,34,34
Jews Control The Media,0,0,0,0,3,3
The Pro's List,0,0,0,0,2,2
Bush's Board Game Thing,0,0,0,0,1,1
The Fat Joe Show,0,0,0,0,5,5
The Golden Age of Baseball with Eddie Robinson,0,0,0,0,10,10
"OTHERtone with Pharrell, Scott, and Fam-Lay",0,0,1,0,22,23
Walk You Out with Johnno and Richelle,0,1,2,1,42,46
Morning Invest,0,0,0,0,20,20
The Goddess Pod,1,0,0,0,4,5
FANtastic Tennis,0,0,0,0,19,19
Unf*cking The Republic,0,0,0,0,16,16
The Capital Building Podcast With Rob Carlin,0,0,0,1,37,38
Anything For Selena,3,4,3,6,105,121
The Sisyphus 55 Podcast,0,0,0,0,5,5
In Search of Soil,0,0,0,1,12,13
The Resistible Rise of J. R. Brinkley,0,0,0,0,2,2
Reality Unfiltered with Meghan and Harry,6,0,0,1,20,27
Stream of Blood,0,0,0,0,10,10
The Remedial Film Class Podcast,0,0,0,0,1,1
Unshaken Saints,0,0,0,1,63,64
Art of Homeschooling Podcast,0,0,0,0,6,6
Another Podcast,0,2,1,1,4,8
Kontent Queens,0,0,0,1,27,28
Ruthless,16,3,1,1,29,50
Reactivaders,0,0,0,0,21,21
Light The Way,0,0,0,0,5,5
Lost Terminal,0,0,0,0,1,1
Dark Downeast,1,0,1,2,186,190
A Century in Cinema,0,0,0,0,9,9
Clearer Thinking with Spencer Greenberg,0,0,1,0,3,4
Maintenance Phase,8,3,4,4,333,352
StaleMates,0,0,0,0,1,1
The Disney Beat,1,0,0,0,15,16
The Eldritch Review,0,1,0,0,4,5
Drunk Black History,0,0,0,0,2,2
Dead Ideas in Teaching and Learning,0,0,0,0,1,1
The WAR RAW Podcast hosted by Wayne Allyn Root,0,0,0,0,3,3
The Truthiest Life,0,1,2,3,44,50
ALTER Weekly,0,0,0,0,18,18
Why or Why Not with the Watsons,0,0,0,0,48,48
PODCAST ON A POLE,0,2,0,0,33,35
Scrambling with Dylan Otto,0,0,0,0,1,1
The Rundown,11,2,8,3,474,498
Dumpster Fyre,14,4,3,0,16,37
WWE Setting The Stage,0,0,0,0,2,2
Beer Mile Podcast,0,0,0,0,21,21
"TV, I Say w/ Ashley Ray",0,0,0,0,6,6
The Anime Movie Podcast,0,0,0,0,1,1
EMT Course Review,0,0,0,1,0,1
Chronic Table with the Portland Cannabis Tasting Society,0,0,0,0,2,2
Run Matters,0,0,0,0,5,5
Fossil Bonanza,0,0,0,0,2,2
SIMPLE ITALIAN PODCAST | LEARN ITALIAN WITH PODCASTS | IL PODCAST IN ITALIANO COMPRENSIBILE,0,0,0,0,2,2
Power of X-Men,0,0,0,0,14,14
The Alan Watts Audio Experience,0,1,1,1,24,27
ORB,0,0,0,0,30,30
Unbothered Blondes,1,1,1,10,95,108
On The Number,0,0,0,0,4,4
The Big Uglies Podcast,0,0,0,0,4,4
Engineering and Physics Theories in our World,0,0,0,0,2,2
Best Camp of My Life with Fernanda Prates,0,0,0,0,2,2
The Bones Booth: A Bones Podcast,0,0,0,0,9,9
The Blue Todd Cast,0,0,0,0,2,2
Crimes of the Centuries,4,4,5,9,174,196
The Joe Budden Podcast with Rory & Mal,9,2,1,4,311,327
From The Bachelor To The Burbs,0,0,0,0,7,7
Cocktails at Table 7- Inside New York’s Joe Allen,0,0,0,0,4,4
MindFrame Podcast,0,0,0,0,50,50
Inside The Mind Of Miles,0,0,0,0,8,8
Out for Blood: The Story of Carrie the Musical,0,0,0,2,24,26
Fresh Invest,2,0,1,0,3,6
Platinum Performance® Podcast,0,0,0,0,1,1
Growing Cut Flowers,0,0,0,0,16,16
The Stuff Dreams Are Made Of,0,0,0,0,25,25
Jacked,2,3,2,7,171,185
The Doodler,1,3,7,2,6,19
In Depth,0,0,0,0,3,3
ART-SOMETHING  TATTOO PODCAST,0,0,0,0,2,2
One Drink In,0,0,0,0,32,32
The Teacher Career Coach Podcast,0,0,0,1,49,50
Halfback Dynasty Football,1,0,0,0,0,1
What Women* Want,0,0,0,0,2,2
Secondary Lead,0,0,0,0,13,13
Tropicana Yams,0,0,0,0,2,2
Drink About It,0,0,0,0,2,2
Ooh You're In Trouble,2,0,0,0,11,13
Kellofaplan- Planning a Life I Love,0,0,0,0,10,10
Tiny Victories,1,1,0,0,30,32
The Marianne Williamson Podcast: Conversations That Matter,3,1,1,0,45,50
Ghost Tape,16,7,11,1,15,50
Knowledge Is Your Superpower,0,0,0,0,1,1
Thorn's Jungle,0,0,0,0,1,1
Reading Time with the Wise Owl - Children's Stories,1,0,0,0,1,2
Good Faith Effort,0,0,0,0,18,18
Creatives Are The Worst,0,0,0,0,4,4
Strength Changes Everything,0,0,0,0,6,6
The Mobile Notary Business Expert Secret Show,0,0,0,0,4,4
I Saw What You Did,1,3,0,2,451,457
Akashavani Hindi News,0,0,0,1,5,6
Akashavani English News,0,0,1,4,7,12
"Oh, I Like That",0,0,0,0,25,25
The Rant Live - Chicago Cubs Podcast,0,0,0,0,2,2
AdamCast,0,0,0,0,6,6
Unpopular with Jacques Peterson,2,0,0,1,46,49
10 for Tweens,0,0,0,0,4,4
As The Curtain Rises - Broadway’s First Digital Soap Opera,0,0,0,0,3,3
We Don't Wanna Grow Up,0,0,0,0,17,17
Your Fave’s Faves,1,2,0,0,6,9
American Party Podcast,6,1,0,0,264,271
"""The Bigger Picture"" By Lil Baby",0,0,0,1,1,2
Unseen,0,0,0,4,46,50
Giggly Squad,57,10,8,9,414,498
The Rematch with Etan Thomas,0,0,0,0,2,2
Everything Sports Cards,0,0,0,0,1,1
Neutral Cider Hotel,1,0,0,0,3,4
Tea At No. 5,0,0,0,0,8,8
Video Game History Hour,0,0,0,0,4,4
Elevating Their Impact,0,0,0,0,4,4
NITE DRIFT with Jim Perry,0,0,0,0,8,8
The Ketogenic Nutritionist,0,0,0,0,1,1
Outweigh,0,0,0,1,16,17
The Age Old Question,0,0,0,0,6,6
305 Takes,0,0,0,0,1,1
The Challenge: Redditors React,0,0,0,0,1,1
Running is Cheaper Than Therapy,0,0,0,0,19,19
When Life Gives You Layovers,0,0,0,0,1,1
The Pure Drive Golf Podcast,0,0,1,0,7,8
Smuggler's Galaxy,0,0,0,0,2,2
Hoe And Tell Podcast,0,0,2,0,3,5
House Of Hoosier with A.J. Guyton,0,0,0,1,73,74
Primordial Deep,0,0,3,1,9,13
The Jasmine Dragon Tea Hour,0,0,0,0,1,1
DancEscape,0,0,0,0,2,2
Among Us 200IQ,4,0,0,3,10,17
Sentimental Men,0,0,0,0,6,6
The Court Jesters,0,0,0,0,3,3
The Decision Education Podcast,0,0,0,0,6,6
Talk to Chuck with Chuck Wicks,1,2,6,7,271,287
68 Shining Moments: Reliving the greatest moments in NCAA tournament history,0,0,0,0,5,5
Wandering with the Dead,0,0,0,1,6,7
Criticism Is Dead,0,0,0,0,6,6
Don't Break the Rules,0,0,0,0,2,2
Kyle's Wild World,0,0,0,0,2,2
Next Level Running,0,0,0,0,1,1
The CXM Experience,0,0,0,0,1,1
Rough Magic,0,0,0,0,2,2
More Than Athletes Podcast,0,0,0,0,4,4
Encuentros Explosivos,0,0,0,0,1,1
Enough,11,0,0,1,432,444
Go For Set Dec,0,0,0,0,4,4
Kennedy Saves the World,3,1,1,1,33,39
Vital Signs,0,0,0,0,3,3
The Fleet,0,0,0,0,8,8
OutSpoken,0,0,0,0,101,101
Positively Gam,0,0,0,3,90,93
WULFF DEN Podcast,0,0,0,0,2,2
Behind the Greens: Serving with Purpose,1,0,0,0,1,2
Muckville Radio Podcast,0,0,0,0,3,3
My Dream Log Cabin- Log Cabin Construction Discussion and Stories of How Others Achieved The Log Cab...,0,0,0,0,2,2
System Check with Melissa Harris-Perry and Dorian Warren,0,0,1,1,26,28
The Payton Years,0,0,0,0,9,9
Lolita Podcast,1,0,3,6,168,178
Data Driven Strength Podcast,0,0,0,0,9,9
Cast Party: A Dungeons & Dragons Podcast,0,0,0,0,50,50
DeathShifter,0,0,0,0,2,2
Are You Green? Business & Stock Market News with Swing Trading Insights,2,0,0,0,1,3
Getting Magnetic with Sandy & Wade,0,0,0,0,100,100
Anthony P. Richards,0,0,0,0,3,3
The Pet Care Podcast,0,0,0,0,1,1
Direct to VHS,0,0,0,0,4,4
The Dishcast with Andrew Sullivan,6,2,4,4,25,41
The Socially Distant Craft Club Podcast,0,0,0,0,1,1
Actors in Conversation: Slice of Life with Margie Haber,0,0,0,0,28,28
Tribe of Two - A podcast for The Mandalorian,0,0,2,1,4,7
The Genius Generation,1,0,1,0,0,2
Cocky and Lucky Vegas Golf Show,0,0,0,0,2,2
"The Carolina Conversation, with Shammond Williams",0,0,0,0,9,9
Lead Now,0,0,0,0,4,4
Penny Royal,0,1,0,2,10,13
The 401 Podcast with Kevin McNamara,0,0,0,0,2,2
Source Material,1,0,1,0,6,8
Runnin' With the Dweezil,0,0,0,1,4,5
The Cane Corso Experience,0,0,0,0,8,8
Bad Chaperones,0,0,0,0,1,1
SWAY WAY,2,0,0,0,54,56
Fear Noir,1,0,0,1,17,19
Maybe I’m Manic,0,0,0,0,1,1
Drinking and Drashing: Torah with a Twist,0,0,0,0,6,6
Live from Pawnee: A Parks and Recreation Fan Rewatch Podcast,1,1,1,0,2,5
Killer Casting,0,0,0,0,14,14
Dr. Creepen's Dungeon,0,0,0,0,14,14
"Work Life Glue - Creating Balance that Sticks for Busy Working Moms || Time Management, Productivity...",0,0,0,0,11,11
Monday Night Beers,0,0,0,0,13,13
Geological Expeditions of Yore,0,0,0,0,4,4
Geology Podcast Network,0,0,0,1,24,25
The Low Level Hell Podcast,0,0,0,0,13,13
Cinenauts,0,0,0,0,8,8
Lasting Looks,0,0,0,0,8,8
The Piper,1,0,0,1,3,5
Paranormal Playboy,0,0,0,0,3,3
POOG with Kate Berlant and Jacqueline Novak,0,0,0,3,47,50
Swipe Fat,0,0,0,1,19,20
Crux Media presents Pass The Remote,0,0,0,0,2,2
Play Me a Recipe,0,0,0,0,7,7
The Do Good Project,0,0,0,0,4,4
Rock & Roll Hall of Fame Induction Vault,0,0,1,0,1,2
Divorce Sucks with Laura Wasser,0,0,0,0,3,3
"Teaching, Reading, and Learning: The Reading League Podcast",0,0,0,0,2,2
Les Be Gay,0,0,0,0,2,2
The METRO Podcast,0,0,0,0,2,2
Arcane,0,0,0,2,6,8
The Unexplainable Disappearance of Mars Patel - Owens Podcast Reviews,0,0,0,1,0,1
The Stand,1,0,1,0,7,9
Bed of Lies,1,0,0,0,23,24
The Twelfth House,0,0,0,0,68,68
Books N' Betches,0,0,0,0,3,3
Coin Bureau,0,0,0,1,4,5
SPEAK! A Dogcast,0,0,0,0,4,4
Locked On NBA Draft - Daily Podcast On The NBA Draft And College Basketball,0,0,0,0,4,4
NASM Master Instructor Roundtable: A Show for Personal Trainers,0,0,1,0,0,1
BetUS UNFILTERED,0,0,0,0,1,1
DollyWould,0,0,0,0,1,1
Coffee Talks Wellness with Ryann Nicole,0,0,0,0,3,3
Stories Are Soul Food,0,0,0,0,35,35
The Punch Out with Eugene Puryear - Your Daily Socialist News Hit,1,0,0,0,5,6
Midnight Burger,0,0,0,0,3,3
Ladies First with Laura Brown,0,0,0,0,7,7
Red Flags,6,3,1,0,18,28
Backyard Ecology,0,0,0,0,2,2
Golf Gambling Podcast,0,0,0,0,20,20
Illusion Pod,2,0,0,0,11,13
Lift Me Up,0,0,0,0,1,1
Maine Oyster Aquaculture - Stories of Resilience and Innovation,0,0,0,0,1,1
The Fellas,1,2,0,0,71,74
Disology Podcast,0,0,0,0,8,8
"Cricket, Et Cetera",0,0,0,0,2,2
Fair Shake Football,0,0,0,1,9,10
The Rest Is History,2,0,3,2,38,45
Steve & Captain Evil: The Podcast,0,0,0,1,11,12
That Sex Chick,1,0,0,0,49,50
I AM Athlete Podcast,2,0,0,2,60,64
Left Bitches (who are right),0,1,2,0,8,11
Do No Harm,14,14,12,6,140,186
Sweet Boys,2,0,0,0,48,50
PR Yourself with Leah Frazier,0,0,0,0,5,5
Bringing the Human back to Human Resources,0,0,0,0,8,8
Jersey Swap,0,0,0,0,7,7
The unexplainable disappearance of Mars Patel,0,1,0,0,0,1
The Clone Cast,0,0,0,0,3,3
Pardon My American,2,0,0,0,22,24
Behind the Wheels,0,0,0,0,2,2
Sunday Golds: A Florida State Baseball Podcast,0,0,0,0,11,11
Golf Rx,0,0,0,0,7,7
The Shattered Window,5,3,4,1,32,45
The Burg Boys,0,0,0,0,6,6
"The Forward Thinking Podcast, Powered by FCCS",0,0,0,0,2,2
Having A Blast,0,0,0,0,1,1
The Vault By Access Hollywood,1,0,0,0,2,3
Join The Ranks,0,0,0,0,10,10
Le Grand Fromage,0,0,0,0,1,1
The Uncensored Anime Podcast,0,0,0,0,2,2
Life After Hockey with Brad Leeb,0,0,0,0,1,1
Anime Noise,0,0,0,0,1,1
Behind The Maker Podcast,0,0,0,0,2,2
Millennial Esthetician,0,0,0,0,1,1
The Weekly Kvetch,0,0,0,0,3,3
Tenfold More Wicked,8,10,6,11,380,415
The Job Interview Podcast,0,0,0,0,10,10
The Oyster,6,8,10,4,22,50
Life with Marianna,4,1,2,2,191,200
Fiber Coven Podcast,0,0,0,0,1,1
Hello From The Hallowoods,0,0,0,0,2,2
Areeka Podcast,0,0,0,0,11,11
Self Care and Chill With Maui,1,2,0,0,264,267
UPIKE Baseball,0,0,0,0,2,2
FAILUROLOGY,0,0,0,0,1,1
I’m Not As Think As You Drunk I Am,0,0,0,0,21,21
THE GRAIL with Dean Delray,1,0,0,0,57,58
Make It Simple,1,0,0,0,49,50
Get into the Groove,0,0,0,0,2,2
Parenting Decolonized,0,0,0,0,6,6
Bourbon Birds & Brews Podcast,0,0,0,0,3,3
The Mindful Podcast,0,0,0,0,2,2
Women that talk Back,0,0,0,0,1,1
Going Dark: A Netflix's Dark Podcast,0,0,0,0,2,2
EDDY OUT with Natali Zollinger,0,0,0,0,2,2
OMfG podcast: jewish wisdom for unprecedented times,0,0,0,0,2,2
House Cats,0,0,0,0,28,28
Devy Debate,0,0,0,0,29,29
Add to Cart with Kulap Vilaysack & SuChin Pak,1,1,1,1,75,79
Chasing Hope with Katherine Abraham,0,0,0,0,1,1
The DIIV Podcast,0,0,0,1,19,20
The Valley of the Dolls Podcast,0,0,0,0,1,1
The Woman of Wellness Podcast,0,0,0,0,16,16
Bedtime With Bunny,0,0,0,0,50,50
Barstool Bench Mob,142,15,7,7,327,498
A New Untold Story,0,0,0,1,49,50
Sellout Talks,0,0,0,0,2,2
Street Cop Podcast,1,0,0,2,29,32
Spanish for Beginners Easy,0,0,0,0,2,2
First Person Plural: EI & Beyond,0,0,0,1,1,2
Dog Training with Leah of Dog Gone Good,0,0,0,0,9,9
Converging Dialogues,0,0,0,0,4,4
Electrify This!,0,0,0,0,2,2
Porsha4Real with Porsha Williams,2,0,0,1,123,126
The Weekly Forecast,0,0,0,0,1,1
The Only Nets Fans You Know: A Brooklyn Nets Podcast,0,0,0,0,8,8
Guerra de chistes,1,0,0,0,0,1
The SciManDan Podcast,0,0,1,0,21,22
Life Lessons,0,0,0,1,39,40
The Arts of Murder,0,0,0,0,4,4
Filmmaking Confidential,0,0,0,0,2,2
SuperFlex City,0,0,0,0,1,1
Daddy Issues with Jon and Bron,3,0,0,1,51,55
The Athlinks Podcast,0,0,0,0,7,7
The Sales Management. Simplified. Podcast with Mike Weinberg,0,0,0,0,50,50
crushing doubt,0,0,0,0,3,3
The Applied Dungeoneering Podcast,0,0,0,0,1,1
The Unstoppable Podcast,0,0,0,1,51,52
The Untitled GenX Podcast,0,0,0,0,11,11
Get Your Marriage On! with Dan Purcell,0,0,0,0,2,2
HELL HAS AN EXIT Podcast with Bryan Alzate,0,0,0,0,43,43
Suite Run,0,0,0,0,30,30
Inside The Album with Don & Tommy,0,0,0,0,4,4
Tech Refresh from Komando.com,0,0,0,0,1,1
Hudi The Foodie,0,0,0,0,10,10
Say Yas to the Guest,1,0,1,0,31,33
Socially Modern with Stephanie Mainville & Jessie Lockhart | A Show for Real Estate Agents and Small...,0,0,0,0,7,7
Random Fit Powered by NASM,0,0,0,0,1,1
Finding Soul Rest,0,0,0,0,1,1
AfroNoodles w/ Willie Macc & Danny Plom,0,0,0,0,3,3
Good Game Nice Try,0,1,2,0,32,35
It's All Clutter,0,0,0,0,5,5
Quest for Healing,0,0,0,0,14,14
Carl Landry Record Club,0,0,0,0,50,50
Below Average Gentlemen's Fantasy Football Podcast,0,0,0,0,6,6
Escaping 1980,0,0,0,0,7,7
Anthony Plog on Music,0,0,0,0,2,2
The Ladylorians Show,0,0,0,0,6,6
PODCAST 20.21,0,0,0,1,0,1
The Vampire Diaries After Show Podcast,0,0,0,0,2,2
Pastafarian Truths,0,0,0,0,2,2
Whatahockey Podcast,0,0,0,0,2,2
The Old Fashioned Car Audio Pod,0,0,0,0,9,9
Race at Work with Porter Braswell,0,0,0,0,4,4
Topics Under The Stairs,0,0,0,0,2,2
Volume Up by The Tease,0,0,0,0,1,1
The Unwritten Playbook,0,0,0,0,2,2
LD AND THE MC,0,0,0,1,7,8
American Contingency,2,0,0,0,44,46
The Socialist Program with Brian Becker,0,0,0,0,14,14
House of Broken Dreams: The Jennifer Kesse Story,103,11,13,7,90,224
Tea and Conversations,0,0,0,0,2,2
Backyard Geology,0,0,0,0,1,1
Carrots 'N' Cake Podcast,4,0,1,3,34,42
Cobbler's Gulch,0,0,0,0,50,50
Fresh&Fit Podcast,13,0,0,0,10,23
To My Sisters,1,0,0,0,7,8
Secure the Gag,0,0,0,0,9,9
Guerrilla History,0,0,0,0,5,5
Who Needs Sleep?,0,0,0,0,1,1
The Anthony Iannarino Show,0,0,0,0,5,5
Nonprofit Investment Stewards,0,0,0,0,3,3
MinistrySmart Talks,0,0,0,0,1,1
Como yo lo Veo con Claudia Valdes,0,0,0,0,50,50
SOUNDFOOD,0,0,1,1,10,12
Jill Scott Presents: J.ill the Podcast,1,0,0,1,109,111
The Priesthood Restored,1,0,0,0,12,13
Administrative Static Podcast,0,0,0,0,1,1
Opera Bluffs The Podcast,0,0,0,0,1,1
the Podcast Without a Cool Acronym,0,0,0,0,2,2
True Crime Arizona,0,0,0,2,15,17
Motivational Quotes for true Happiness words of love to Empower you with positive Vibe for Day &Week,0,0,0,0,1,1
The Bible in a Year (with Fr. Mike Schmitz),8,4,0,4,344,360
The Big Intermission,0,0,0,0,12,12
PillaTalk Podcast,0,0,0,0,10,10
Lifestyle by Real Estate Podcast,0,0,0,0,32,32
Carefully Reckless,0,0,1,1,48,50
Checking In with Michelle Williams,0,0,0,1,25,26
Dawkins On Duke,0,0,0,0,5,5
Patients at Risk,4,0,0,1,9,14
The Prototype,0,0,0,0,1,1
High Handicappers Club,0,0,0,0,1,1
Voice of America,1,0,0,0,0,1
Criminally Listed Presents: Into the Killing,15,6,6,1,35,63
The Daily 10 with Matt Chernoff,0,0,0,0,8,8
The Bouquet Toss - A Wedding Planning Podcast,0,0,0,1,7,8
Official Unofficial Reddit Podcast,0,0,0,0,2,2
Two Guys From Hollywood,0,0,0,1,16,17
Comedian v Economist,0,0,0,0,15,15
Bow Ties & Sweatshirts,0,0,0,0,7,7
Explorations,0,0,0,0,3,3
Special Grade Snax,0,0,0,0,1,1
The Wild Fly Podcast,0,0,0,0,11,11
The Authentic Hotwife Podcast,0,0,0,0,2,2
Hunting Ghislaine with John Sweeney,14,12,16,6,73,121
Reveal Presents: American Rehab,0,0,0,0,12,12
Over and In: The Ultimate Volleyball Podcast,0,0,0,0,1,1
My Side Of The Bag podcast,0,0,0,0,5,5
Recipe Club,2,4,2,6,186,200
Classy Trashy,0,0,0,0,8,8
Zuri Hall's Hot Happy Mess,0,0,0,0,87,87
The World According To Ben Stein,0,1,0,2,34,37
NCLEX High Yield,1,0,1,0,8,10
Infusing Beauty,0,0,0,0,2,2
The Research Evangelist,0,0,0,0,1,1
Mini Magic : A Witchcraft Podcast for Kids,0,0,0,0,13,13
The Debate Ya Maw Podcast,0,0,0,0,8,8
English Kids Story with Katrina,0,0,0,0,2,2
The Golf & Fitness Show,0,0,0,0,3,3
The Clown and the Candyman,17,4,5,4,40,70
MINDBOX,0,0,0,0,1,1
Doubles Only Tennis Podcast,0,0,0,0,10,10
Satanic Panic,0,0,0,1,0,1
Greetings from Somewhere,3,1,0,2,23,29
Goodwind Podcast w/ Niko LaPelusa,0,0,0,0,7,7
Jean Jacques Machado : No Gi Required,0,0,0,0,4,4
Real Conversations with Jacob Young,0,0,0,0,1,1
Champaign On Ice: Illinois basketball with Deon Thomas,0,0,0,0,4,4
Montessori Babies,0,0,0,0,1,1
Live at the Roxy,0,0,0,1,29,30
"The First In, Last Out Lifestyle Podcast",0,0,0,0,3,3
InForum Minute,0,0,0,0,2,2
"Truth, Lies and Puppy Mills",0,0,0,0,15,15
Etched In Stone,0,0,0,0,3,3
Fast Radio Burst!,0,0,0,0,6,6
That's Messed Up: An SVU Podcast,71,23,17,20,369,500
The SeedPod for Kids,0,0,0,0,5,5
Shaking Out the Numb,0,0,0,0,11,11
Now That I'm Not Your Teacher,0,0,0,0,7,7
Coming Down The Aisle,0,0,0,0,7,7
The Flight Attendant Podcast,0,0,0,0,1,1
Making Media Now,0,0,0,0,2,2
The blu3collaroffroad's Podcast,0,0,0,0,1,1
Running with Coach Jay,0,0,0,0,3,3
Night Sky Tourist,0,0,0,0,7,7
The SeedPod for Beginners,0,0,0,0,5,5
The Alexei Sayle Podcast,0,1,1,1,24,27
Bad Advice with Chris Cubas,0,0,0,0,16,16
Tales From the Band Room Podcast,0,0,0,0,1,1
The Anxious Filmmaker with Chris Brodhead,0,0,0,0,19,19
Andrew Scheps Talks to Awesome People,0,0,0,0,1,1
The Psychedelic Leadership Podcast,0,0,0,0,10,10
My Family Thinks I'm Crazy,0,0,0,0,6,6
SmackTalk Presents: The People’s Podcast,0,0,0,0,1,1
Lizard Brain Radio,0,0,0,0,2,2
The Spring Legion Podcast,0,0,0,0,7,7
VT Podcast,0,0,3,1,12,16
BBC Gardeners’ World Magazine Podcast,1,0,2,1,15,19
The Integral Principles of the Structural Dynamics of Flow,0,0,0,0,8,8
EveryBodhi Podcast,0,0,0,0,7,7
Warbirds - Tales From Above,0,0,0,0,8,8
Coaches on the Run,0,0,0,0,4,4
Third Act with Liz Tinkham,0,0,0,0,9,9
Bright Wings: Children’s Books to Make the Heart Soar,0,0,0,0,4,4
Crime Weekly,12,10,20,14,270,326
Ransom Experience,0,0,0,0,3,3
Spectre 001,0,0,0,0,5,5
Field Of 68 Best Bets,1,1,1,0,9,12
The Watershed,1,0,0,0,0,1
"Mama Trauma- Christian Trauma Recovery, Healing, & Empowerment After Narcissistic Abuse For Daughter...",0,0,0,1,38,39
She's a Woman with Miz Cracker,1,1,0,0,24,26
Little Stories Everywhere,9,0,3,1,17,30
The Luxury Weekly,0,0,0,0,11,11
I/O,0,0,0,0,5,5
make good: a knitting podcast,0,0,0,0,13,13
The Story of Jesus,0,0,0,0,1,1
Small Medium at Large,0,0,0,0,9,9
Get Reworked,0,0,0,0,1,1
The Ultra Running Guys,0,0,0,0,1,1
Wolf and Owl,1,0,1,3,112,117
Star Wars: A Long Time To Go,0,0,0,0,2,2
Coupla Goofs,0,0,0,0,13,13
Rasslin' with Brandon F. Walker,36,1,3,0,457,497
Prodigy,2,0,2,1,29,34
Mind Over Body with Hypnosis,0,0,0,0,4,4
The Business Brew,0,0,0,0,23,23
Mommy Doomsday,120,72,42,60,426,720
Ic2us: The Evolving Conductor,0,0,0,0,3,3
"It's Not Me, It's You",0,0,0,0,26,26
@lexie,4,2,0,1,43,50
VUHSPEAKS,0,0,0,1,16,17
Planet 2000's,0,0,0,0,3,3
Coffee with the Chicken Ladies,0,0,0,0,24,24
Bogey Society Golf,0,0,0,0,2,2
Lost River Legends,0,0,0,0,4,4
KooperKast,0,0,0,0,1,1
The Brides Of Long Island Podcast,0,0,0,0,19,19
Real estate exam prep,0,0,0,0,4,4
Odd Squadcast,1,0,0,0,17,18
Kids Learn Careers,0,0,0,0,8,8
Not Another Nutrition Podcast,1,0,1,0,18,20
Greenhouse,0,0,0,0,8,8
Death of a Starlet,3,6,8,5,79,101
MTV's Official Challenge Podcast,16,6,16,11,140,189
The BoardRoom,1,0,0,0,5,6
Play Piano By Ear,0,0,0,0,2,2
The Football Podcast,0,0,0,0,1,1
TV. Watch. Repeat.,0,0,0,0,9,9
Commissioner's Office,0,0,0,0,6,6
Get Wellthy,0,0,0,1,49,50
Journey into polymers,0,0,0,0,1,1
COMPETITION PLUS POWER HOUR,0,0,0,0,1,1
The Sound of Change,0,0,0,0,20,20
SOFcast,0,0,0,0,9,9
Trafficked with Mariana van Zeller,0,0,0,2,29,31
Salute the Songbird with Maggie Rose,0,0,0,0,7,7
Drinks After Work,0,0,0,0,15,15
Phil Vassar's Songs from the Cellar,0,0,0,0,3,3
Major World Order,0,0,0,0,12,12
The Chess Underground,0,0,0,0,1,1
Jacksepticeye's Undertale Play-through,0,0,0,0,3,3
TraegerMethod Podcast,0,0,0,0,4,4
Sales Velocity,0,0,0,0,1,1
A Hopeless Endeavor: The Joanna Newsom Podcast,0,0,0,0,2,2
More Muse Podcast,0,0,0,1,1,2
Duck Call Room,0,0,0,2,48,50
Siempre Positivo: A Barcelona podcast,0,0,0,1,1,2
Red Collar,50,50,80,65,350,595
NewEarth Project,0,0,0,0,1,1
Talk About It Outdoors Podcast,0,0,0,0,5,5
Getting Pretentious,0,0,0,0,6,6
The Endurance House,0,0,0,0,1,1
Smarter Markets,4,1,0,0,28,33
"The ""What is Money?"" Show",0,0,0,0,8,8
Pursuit of the Paranormal,0,0,0,0,1,1
Reggaeology - The Reggae History Experience,0,0,0,0,2,2
Left Behind: An Experience in Sound and Drama,0,0,0,0,1,1
The Fateful Tale of Chesapeake Bay,0,0,0,0,1,1
Sacred Steps Podcast,0,0,0,0,2,2
Compassion In Action,0,0,0,0,1,1
Brooklyn Magazine: The Podcast,0,0,0,0,4,4
Gumdrop Readers,0,0,0,0,5,5
Design Mind frogcast,0,0,0,0,1,1
The Historic Present,0,0,0,0,3,3
Public Health Out Loud,0,0,0,0,1,1
AMONGus,1,0,0,1,1,3
The Pictures Got Small,1,1,0,0,2,4
"Real, Smart People",0,0,0,0,1,1
The Intro with MDV,0,0,0,0,50,50
Nutrition Made Simple,0,0,0,0,4,4
Baby Mouth,0,0,0,0,21,21
Trey Wingo Presents: Half-Forgotten History,1,2,1,0,21,25
Sunday Service,0,0,0,0,2,2
McTako,0,0,0,0,1,1
Champs App Podcast,0,0,0,0,1,1
DARK LIGHT DUGAN,0,1,0,0,2,3
Jesse Nyberg Podcast,0,0,0,0,9,9
Ramsay's Recaps,0,0,0,0,1,1
Anime Ultra,0,0,0,0,6,6
Little Talk in Slow French : Learn French through conversations,0,0,0,0,2,2
Wilderness Wonders Podcast,0,0,0,0,1,1
"Bands, Beers & Buzzwords",0,0,0,0,1,1
Dream a Little Deeper,0,0,1,0,3,4
The Jay Jay French Connection: Beyond the Music,5,2,1,3,6,17
Da Bear Essentials™ - A Chicago Bears Podcast,0,0,0,0,6,6
SassCast with Sarah and Amber Podcast,0,0,0,0,3,3
Ball Breaking with Mike and Steve,0,0,0,0,1,1
To Whom Shall We Go? Podcast,0,0,0,0,2,2
Dinosaur George Kids - A Show for Kids Who Love Dinosaurs,0,0,0,0,5,5
Tall Tails,0,0,0,0,11,11
Slices of Wenatchee,0,0,0,0,2,2
How to Fall in Love the Hard Way,0,0,0,0,2,2
Drained,0,0,0,0,1,1
TOP 5 with JOEY CASSATA,0,0,0,0,2,2
Catfish: The Podcast,3,2,4,2,4,15
TRACK THE VAX,0,1,0,0,8,9
Conspiracy Randy,0,0,0,0,10,10
Hot Cakes Fresh Takes — Fantasy Football Podcast,0,0,0,0,2,2
Razib Khan's Unsupervised Learning,0,0,0,0,3,3
RyR Endurance Team podcast,0,0,0,0,3,3
After Bark,1,0,0,1,14,16
LEGO® Bits N’ Bricks,1,0,0,1,13,15
"Life Untapped - Helping women in midlife rediscover themselves. Support to level up, and get a clear...",0,0,0,0,27,27
Triplicates,0,0,0,0,2,2
Wildlife Health Connections,0,0,0,0,1,1
The Hitchhiker's Guide to the Galaxy,0,0,0,1,3,4
What the F*ck is Sea Moss? Debunking the Wild World of Wellness,0,0,2,1,45,48
TLDR,0,0,0,0,6,6
"Middle Please, Umpire - a Cricket Podcast",0,0,0,0,1,1
Desperately Seeking Paul : The Paul Weller Fan Podcast,0,0,0,0,3,3
Discovering Forestry,0,0,0,0,1,1
Vanlis Presents,0,0,0,1,13,14
The Kleio Files,0,0,0,0,3,3
The Tommy Tiernan Podcast,0,0,0,1,3,4
Adeptus Ridiculous,0,0,0,0,14,14
The Council Men,0,0,0,0,2,2
Trosky Tuesday,0,0,0,0,2,2
Running It with Nate Sexton,0,0,0,1,28,29
NFP,0,0,0,0,1,1
Sal and Chris Present: Hey Babe!,12,2,4,6,160,184
Sal Vulcano & Joe DeRosa are Taste Buds,1,1,1,5,42,50
911 Lone Star Round-Up,0,0,0,0,1,1
Rave to the Grave,0,0,0,0,5,5
Non-Technical,0,0,0,0,14,14
FIREFIGHTER SUCCESS PODCAST,0,0,0,0,7,7
In Strange Woods,2,2,0,2,44,50
Blueprint Athletes Basketball Podcast,0,0,0,0,6,6
Teens Talk Tech,0,0,0,0,1,1
Doggy Dojo,0,0,0,0,8,8
Dog Training Is My Passion,0,0,0,0,4,4
Companions of the Message,0,0,0,0,12,12
The Class Podcast,0,0,0,0,6,6
Pepp Talk Podcast,2,0,0,2,37,41
Up On Game,1,1,0,1,14,17
Time To Kill,0,0,0,0,2,2
Heartbreak to Happiness,0,0,0,0,12,12
Break Fast,0,0,0,0,23,23
The Great Indian Marketing Show,0,0,0,0,7,7
Breaking Glass,0,0,0,0,29,29
Headwaters,0,1,0,0,22,23
Moms of Tweens and Teens,0,0,0,1,8,9
Adventures: Bible Truths in Action,0,0,0,0,4,4
DogLogical: Making Sense of Your Dog's Behavior,0,0,0,0,4,4
WOE.BEGONE,0,0,0,0,5,5
She Runs Ultras,0,0,0,0,4,4
BuckTown Beauties,0,0,0,0,3,3
OpTic Podcast,0,0,0,0,5,5
Habitat University,0,0,0,0,3,3
My Dark Path,0,0,0,0,18,18
3 GIRLS 1 KITCHEN,4,4,2,2,106,118
"You Know It’s Fake, Right?",0,0,0,0,6,6
The ClownCast with Niles Abston & Harper-Rose,1,1,0,0,11,13
Gimme Danger Radio,0,0,0,0,2,2
Awakening OD,0,0,1,0,57,58
America's Past Time,0,0,0,0,9,9
The Cellar Letters,0,0,1,0,10,11
Non-Rev Lounge,0,0,0,0,11,11
WorldAroundEwe's podcast,0,0,0,0,2,2
Sparrows Point: An American Steel Story Podcast,0,0,1,1,3,5
The Charles Mizrahi Show,0,0,0,1,34,35
HOT WIDOWED MESS,0,0,0,0,2,2
Magic Locker,0,0,0,0,4,4
One Shot Dungeons,0,0,0,0,3,3
NFL Total Access: The Locker Room,0,0,0,2,2,4
The Early Edge: A Daily SportsLine Betting Podcast,10,2,2,1,388,403
The Andrew Price Podcast,0,0,0,0,2,2
Taking Alex,0,1,2,0,14,17
Norco 80,51,21,17,10,57,156
Understanding Congress,0,0,0,0,1,1
Predators I've Caught With Chris Hansen,0,0,0,1,50,51
Abundant Living and Gardening,0,0,0,0,2,2
The Catfish on Ice Podcast,0,0,0,0,1,1
The Costume Plot,0,0,0,0,4,4
Because We Got High,5,0,2,7,36,50
Human & Holy,0,0,0,0,19,19
Behind The U,0,0,0,0,5,5
HACK IT OUT GOLF,4,2,1,0,31,38
The Union of the Unwanted,3,1,1,0,15,20
Meeting Tom Cruise,4,0,0,2,36,42
Off The Hook with Jimmy Bullard,0,0,0,2,52,54
King Kirby,0,0,0,0,3,3
The William Hall Show,0,0,0,0,7,7
Tom Talks,0,0,2,0,68,70
The Table with Anthony ONeal,1,0,0,1,48,50
Another Dooley Noted Podcast,0,0,0,0,14,14
Unraveled: Long Island Serial Killer,56,26,42,52,824,1000
Geek Giant Podcast,0,0,0,0,6,6
Invoking Witchcraft,0,0,0,0,16,16
The Houston Running Zone,0,0,0,0,1,1
Parental Advisory Podcast,1,1,1,0,101,104
Queer Movie Review,0,0,0,0,1,1
Parenting After Trauma with Robyn Gobbel,0,0,0,0,1,1
IDC - Future Enterprise,1,0,0,0,0,1
A Second Helping of Hannibal,0,0,0,0,1,1
Tempo Talks Podcast,0,0,0,0,11,11
A History Of Sonic The Hedgehog,0,0,0,0,3,3
Tabletop Time,0,0,0,0,11,11
Women & ADHD,0,0,0,0,7,7
Pro Wrestling History Nerds,0,1,1,0,2,4
Friends With A Twist: A Swinger Podcast,0,0,0,1,1,2
Worldwide Exchange,1,0,0,0,0,1
All Things Physical Therapy Podcast,0,0,0,0,5,5
Bettors Delight,0,0,0,1,16,17
Not Your Father's Autobot: A Transformers: Generation Two Comic Book Podcast,0,0,0,0,1,1
Muslims Doing Things,0,0,0,0,49,49
Kindred Conversations,0,0,0,0,37,37
Brand New Dad Podcast,0,0,0,0,5,5
Paranormal Radius,0,0,0,0,2,2
A New Life in Italy,0,0,0,0,1,1
Lil Flip & DJ Hard Hitta Presents The Truth Shall Set You Free Podcast,0,0,0,0,2,2
Heading For Home,0,0,0,0,9,9
Today I Am Grateful,0,0,0,0,9,9
Build Your Copywriting Business,0,0,1,1,188,190
Blood Origins,0,0,0,0,11,11
The Definitely Not Simple Life,0,0,1,0,35,36
Rugby Revealed,0,0,0,0,2,2
Humans Are Divine,0,0,0,0,1,1
Pay to Play,0,0,0,0,2,2
We Were Christian Kids with Justin Randall and Calvin Arsenia,0,0,0,1,20,21
Rolling with the Punches with Rabbi Eli Portal,0,0,0,0,10,10
Pandemic Puppy Podcast,0,0,0,0,3,3
Slouch Theory by Andre D. Thompson,0,0,0,0,2,2
Pooch & Rabold,0,0,0,0,2,2
SongTown on Songwriting,0,0,0,0,3,3
Tales From Yaya's: The Your Honor Podcast,0,0,0,0,3,3
That's Loaded,2,0,0,0,74,76
Are You My Podcast?,0,0,0,0,50,50
90 Day The Melanated Way with Linda Antwi,0,0,4,0,1,5
The Chavrusa,0,0,0,0,1,1
The Cipher,0,0,0,1,6,7
Cultural Competence,0,0,0,0,2,2
The CBB Grind Podcast with Cutri and Stills,0,0,0,0,1,1
The Tabletop Tales,0,0,0,0,6,6
The Positivity Xperience,0,0,0,0,3,3
The Smallmouth Crush Podcast,0,0,0,0,16,16
CONSPIR-A-THEORIA,0,0,0,0,1,1
Treehouse- Alex G,0,0,0,0,8,8
Big Time Golf Guys - A Golf Equipment Podcast,0,0,0,0,1,1
Fantasy Magazine - Fantasy Story Podcast (Audiobook | Short Stories),0,0,0,0,1,1
PFF NFL Daily,1,0,0,2,22,25
The Gestalt Education Show,0,0,0,0,4,4
Moore to the Story,0,0,0,0,6,6
Modern Direct Seller Podcast,0,0,0,0,2,2
Paige's Pod,0,0,0,0,20,20
The Bass Report,0,0,0,1,4,5
The How To Podcast,0,0,0,0,1,1
A Court of Fandoms and Exploration - A Podcast.,0,0,0,0,4,4
Understanding Human Design Podcast,0,0,0,0,2,2
Jobsolete,9,5,8,4,14,40
PEOPLE Every Day,0,0,0,1,7,8
Under the Influence with Jo Piazza,3,0,1,1,32,37
Stacey King's Gimme the Hot Sauce Podcast with Mark Schanowski & Friends,0,0,0,0,3,3
The Gathering Pod,0,0,0,0,8,8
PORQUE YES!,0,0,0,0,2,2
Juan Ep Is Dead,0,0,0,0,50,50
Come To Find Out,0,0,0,0,2,2
In Loco Parent(i)s,0,0,0,0,6,6
From Now,2,3,3,2,40,50
The Baseline Podcast,0,0,0,0,6,6
Pain-Free Performance Podcast,0,0,0,0,14,14
ShoOT the Breeze,0,0,0,0,1,1
The Ouachita Chronicles,0,0,0,0,1,1
The Buffet,0,0,0,0,2,2
HGTV Obsessed,0,0,0,0,24,24
The Living Soil Podcast,0,0,0,0,3,3
A-Z of Phil Collins,0,0,0,0,18,18
The Tayler Yarish Show,0,0,0,0,8,8
What's Left of Philosophy,0,0,0,0,3,3
Health Freedom for Humanity Podcast,1,0,0,0,20,21
Chillin' With Kofie,0,0,0,0,10,10
Godcast,7,2,0,0,41,50
DX Daily,1,0,0,0,10,11
Runner's University,0,0,0,0,2,2
Ty & That Guy,1,0,0,0,31,32
Elbows And Jumpers,0,0,0,0,1,1
Dolly Parton Fan TV - The Podcast with Andy Crust,0,0,0,0,2,2
Febrile,0,0,0,0,1,1
SHOW ME THE MONEY HOCKEY PODCAST,0,0,0,0,5,5
Hell Gate City Companion,0,0,0,0,4,4
The Grass is Greener with Paul Greene,0,0,1,1,48,50
The Trust Me When I Tell You Podcast,0,0,0,0,2,2
Forever on the Fly,0,0,0,0,9,9
Warzone Amateur Hour Podcast,0,0,0,0,3,3
"The Dad, Dilly, & Link Show",0,0,0,0,7,7
League of Scumbags,0,0,0,0,2,2
CHATS WITH SWEETIE,1,0,0,0,3,4
Our Thing with Sammy The Bull,2,0,0,0,48,50
Plantaholics Podcast,0,0,0,0,1,1
Zedcast - The Tyler Zed Podcast,1,0,1,0,57,59
The Goldmine,0,0,0,0,7,7
For a Better World,0,0,0,0,13,13
THESPINUP,0,0,0,0,50,50
The3Muslims,0,0,0,0,3,3
Unearthed Gems,0,0,0,0,2,2
Gaining Ground: The New Georgia,12,1,0,0,37,50
I Learned About Flying From That,0,0,0,0,1,1
The Terrific Teacherpreneur,0,0,0,0,6,6
NASTY KNUCKLES PODCAST,0,1,0,0,23,24
Improv On Tape,0,0,0,0,17,17
Keeping Records,1,0,0,0,32,33
Mella Moment,0,0,0,0,11,11
Let’s Shag,0,1,1,0,26,28
First Down with Dave,0,0,0,0,2,2
Cold Weather Bats,0,0,0,0,7,7
The Way I Taught It,0,0,0,0,2,2
Film Maker Podcast,0,0,0,0,1,1
Every Plant Story | Gabriella Plants,0,0,0,0,2,2
Wrestling With The Week,1,0,0,0,24,25
The Official Leeds Utd Podcast,0,0,0,0,2,2
Call Your Grandmother,0,0,0,0,50,50
AMA COVID-19 Update,0,0,0,0,1,1
The Story of Heidelberg,0,0,0,0,30,30
Best Bets with Kate & Betsy,0,0,0,0,4,4
The Right View with Lara Trump,1,0,0,0,12,13
Animal of the Day Podcast,0,0,0,0,3,3
Creepypasta,1,0,0,0,1,2
Mack's World,0,0,0,0,14,14
The Modern Extractor,0,0,0,0,8,8
FIFA Dads,0,0,0,0,2,2
RedCard Radio with Austin Robillard,0,0,0,0,2,2
Through The Cracks,5,6,4,5,58,78
Modern Creator,0,0,0,0,3,3
Kai's Korner,0,0,0,0,2,2
Defining Duke: An Xbox Podcast,2,2,0,2,44,50
On The Tape,0,0,1,1,14,16
Attack on Attack on Titan,0,1,0,0,1,2
Hubris: A 24-Hour Podcast Project,0,0,0,0,1,1
To Etsy and Beyond,0,0,0,0,3,3
DVMT: Doctors of Veterinary Medical Television,0,0,0,0,2,2
The Apology Line,118,132,138,60,546,994
One-Over presented by THE Breakfast Ball Media Network,0,1,0,0,2,3
Self Taught Artist,0,0,0,0,8,8
Wildlife Stories,0,0,0,0,1,1
Planner Talk Podcast,0,0,0,0,7,7
Crosscut Escapes,0,0,0,0,3,3
Big Daddy Graham’s Countdown,0,0,0,0,4,4
Pathogen Perspectives,0,0,0,0,3,3
"Follow Him: A Come, Follow Me Podcast with Hank Smith & John Bytheway",0,0,1,0,167,168
That's So Much Brian Mcknight!,0,0,0,0,1,1
College Hoops Mania,3,0,0,0,13,16
The Bianca Del Rio Podcast,4,0,0,4,554,562
Gusgri Podcast,0,0,0,0,2,2
Fisher Family Ghosts: A Six Feet Under Companion Podcast,0,0,0,0,3,3
Probably a Podcast,6,1,3,4,36,50
Food Network Obsessed,1,0,0,1,38,40
Hazards of the Roll,0,0,0,0,1,1
The Truth About Recording & Mixing,0,0,0,0,3,3
How to Tell Stories to Children,0,0,0,0,1,1
Beat the Shift,0,0,0,0,12,12
Stellar Teacher Podcast,0,0,0,0,10,10
Eat Train Prosper,0,0,0,0,2,2
Evil By Design,3,2,0,1,32,38
Talking Body with Amy Porterfield,0,1,0,0,34,35
Mad Women,0,0,0,0,2,2
A More Civilized Age: A Clone Wars Podcast,1,0,1,0,102,104
Checkers or Wreckers,0,0,0,0,4,4
The FANgals Podcast,0,0,0,0,21,21
Dark Horse Live!,0,0,0,0,1,1
God Help the Troubadour: The Eternal Voice of Phil Ochs,0,0,0,0,4,4
Drafting Archetypes,1,0,0,0,12,13
Amira & Tree After Dark,0,0,0,1,8,9
Crime Analyst,1,0,0,2,120,123
Dishing Drama with Dana Wilkey UNCENSORED,5,2,2,0,24,33
The Messy Masterpiece with Tori & Chad,0,0,0,0,6,6
Brotaku Block,0,0,0,0,2,2
Tales From The Dark,0,0,0,0,10,10
Divorce Matters,0,0,0,0,10,10
Baby Got Bach,5,6,5,4,78,98
RBaseball Weekly,0,0,0,0,2,2
Huberman Lab,0,0,0,0,875,875
The Stormchaser Improv Podcast Show,0,0,0,0,17,17
Tea with Publyssity,2,0,0,1,154,157
THIS LEAGUE,168,3,0,1,37,209
Friday Night Pints,0,0,0,0,50,50
Let's Sleep On It: Reclaiming Parenthood,0,0,0,0,14,14
"Sex, Lies & Parenthood",0,0,0,0,7,7
The Nosleep Radio,0,0,0,0,12,12
Red Pill Tamales,0,0,0,1,8,9
Funny Running Stories,0,0,0,0,1,1
Business Movers,2,1,0,2,27,32
High Turnout Wide Margins,0,0,0,0,2,2
Life After Sugar,0,0,0,0,3,3
Just the News A.M. with Carrie Sheffield,0,0,0,0,3,3
No F*cks Given Podcast,15,2,3,2,40,62
RELAX! with Colleen Ballinger & Erik Stocklin,0,0,0,0,50,50
GM Files,0,0,0,2,2,4
Beatles vs. Stones,0,0,0,0,4,4
Ben and Glenn's After Hours,0,0,1,3,14,18
The Mindset Mile,0,0,0,0,18,18
Dog Edition,0,0,0,0,2,2
Difference Makers,0,0,0,0,1,1
Third Fleet Podcast,0,0,0,0,10,10
An Open Water Swimmer's Podcast,0,0,0,0,2,2
why are we still talking,0,0,0,0,3,3
Ketchup With The Freys,0,0,0,0,40,40
Lasso Cast,0,0,1,0,6,7
Mi Puck Drop,0,0,0,0,1,1
Morning Announcements,5,2,3,4,137,151
Conversations with Elizabeth Johnston,18,0,0,1,23,42
The CoVax Files,0,0,0,0,6,6
Matthias J Barker Podcast,0,0,0,1,49,50
Curse of Civilization,0,0,0,0,5,5
Million Dollar Esthetician,0,0,0,0,1,1
The Athletic Hockey Show: A show about the NHL,6,2,3,1,8,20
Squawk 5353 - The Private Pilot Podcast,0,0,0,0,2,2
Livin' The Dream,0,0,0,0,12,12
ModelGeek's Podcast,0,0,0,0,5,5
Linda Marigliano's Tough Love,1,0,0,0,26,27
Prank Calls with Leon Haberdashery,0,0,0,0,2,2
Chicano Squad,11,4,2,4,103,124
The Elmwood Strain,2,0,1,0,16,19
Balls Deep,0,0,1,1,48,50
Inside The Hits,0,0,0,0,3,3
The Cutting Room Floor,0,0,0,0,3,3
Mayim Bialik's Breakdown,1,1,0,0,18,20
Bear with Us Grrl,0,0,0,1,5,6
"The Women of Regenerative Ag: Transforming the Health of the Soil, Land & People",0,0,0,0,4,4
Only Fans Secrets,0,0,0,0,2,2
Anatomy of an Artist,0,0,1,0,33,34
The Best Minutes Podcast,0,0,0,0,2,2
Friends with Dogs Podcast,0,0,0,0,2,2
Cram The Pance,0,0,0,0,9,9
The Fly Good Podcast,0,0,0,0,2,2
Hardcore HonesTEA,8,0,0,0,20,28
Kraig Adams,0,0,0,0,2,2
Morning Meditation for Women,0,0,1,0,1,2
The Last Storm - OKC Thunder Podcast NBA,15,0,0,0,17,32
STOURIES: An All Access Podcast,0,0,0,0,7,7
Boss Better Now with Joe Mull,0,0,0,0,33,33
The Patriotically Correct Radio Show with Stew Peters | #PCRadio,0,0,0,0,3,3
Reflections,1,0,0,1,224,226
The Jesus Show (not that one),0,0,0,0,3,3
A Change of Brand,0,0,0,0,22,22
A Fools Errand,0,0,0,1,9,10
below the influence(R),0,0,0,0,50,50
The CopDoc Podcast: Aiming for Excellence in Leadership,0,0,0,0,1,1
Meddling with Monsters,0,0,0,0,6,6
The Our Strange Skies Podcast Archive,1,0,0,0,8,9
CrochetingWorlds,0,0,0,0,2,2
Slapshot Sweethearts,0,0,0,0,4,4
Race to 270,1,0,0,1,48,50
Bridgerton Fancast,1,0,0,1,22,24
The Diversity Gap Academy,0,0,0,0,1,1
Hoe With A Bro,0,0,0,0,1,1
Normal Frum Women,0,0,0,0,8,8
Breaking Down Patriarchy,1,1,0,0,25,27
Ernestly Speaking! with Ernest Owens,1,0,0,0,15,16
Looking For The Todt Family,2,3,4,4,32,45
Thirty Minutes of Hell with Pat Bradley,0,0,0,0,3,3
Tomorrow's Monsters,2,3,1,1,34,41
Bouncing Forward with Amy Purdy,0,0,0,0,40,40
Householders: American Life as Zen Practice,0,0,0,0,5,5
Why Am I Telling You This? with Bill Clinton,10,1,0,0,23,34
Foreward Podcast,0,0,0,0,42,42
State Of The Marauders,0,0,0,0,1,1
Excellently Executed: Bret Hart Matches,0,0,0,0,1,1
You're Still Here?!?,0,0,0,0,12,12
The Swimmer Strength Podcast,0,0,0,0,3,3
Undressing Bridgerton,0,2,0,5,160,167
The Canine Condition,0,0,0,0,2,2
Gotta Get It Podcast!,0,0,0,1,14,15
No Focks Given,1,0,0,2,47,50
Just Add Dogs Podcast,0,0,0,0,4,4
Tales from the Crawlspace,0,0,0,0,2,2
All It Takes Is A Goal,0,0,0,2,48,50
K-Drama School,0,0,0,0,5,5
Anything Better?,0,1,1,0,48,50
The Man Card Podcast,0,0,0,0,5,5
Prop History Podcast,0,0,0,0,2,2
"Hey, Stranger!",0,0,0,0,6,6
The D&D Fitness and Nutrition podcast,0,0,0,0,10,10
Krystal Kyle & Friends,1,0,3,3,68,75
White Sox Weekly,0,0,0,0,2,2
Root2Seed,0,0,0,0,2,2
Grimerica Outlawed,0,0,0,0,14,14
Dogish Podcast,0,0,0,0,2,2
3 Minutes of Leadership,0,0,0,0,3,3
Newly Erupted,0,0,0,0,1,1
MI Take,0,0,0,1,4,5
Real WW Talk,0,0,0,0,9,9
One More Drink,0,0,0,0,15,15
The Glow Show,0,0,0,0,11,11
Behind The Weather Forecast,0,0,0,0,2,2
She Talks Birdie,0,0,0,0,2,2
"Fuel Her Awesome: Food Freedom, Body Love, Intuitive Eating & Nutrition Coaching",0,0,0,0,50,50
Sturdy For 30,0,0,0,0,3,3
Drew and Sam Talk Training,0,0,0,0,1,1
Case Craze,0,0,0,0,17,17
The NeverEnding Movie Marathon,0,0,0,0,8,8
Stall Stories,0,0,0,0,2,2
Ask Carson James,0,0,0,0,8,8
Come Follow Me for Young Families,0,0,0,0,7,7
Hooked on Looming,0,0,0,0,2,2
Inquisikids Daily,0,0,0,1,3,4
The Silt Verses,0,0,0,1,12,13
Into The Grey Zone,4,2,4,4,13,27
The Graham Norton Podcast,0,1,1,0,8,10
Africa Daily,1,0,1,0,0,2
Bangalore In Stories,0,0,0,0,4,4
UNQUALIFIED,0,0,1,0,23,24
Subie & YOU!,0,0,0,0,15,15
P. T. S. D - Pressure Talks with Single Dads,5,1,2,1,12,21
ARCHITECTING Podcast - Career + Lifestyle Mentoring for Architects looking to move beyond overwhelm ...,0,0,0,0,2,2
Power: The Maxwells,19,12,9,9,32,81
MAFS Mamas,0,0,1,0,7,8
The Daily Crime,12,2,8,3,34,59
Millionaire Girls Club Podcast,0,0,0,0,11,11
College Admissions Real Talk with Dr. Aviva Legatt,0,0,0,0,2,2
Behind the Page: The Eli Marks Podcast,0,0,0,0,2,2
Get Knit Done,0,0,0,0,2,2
The Home Birth After Cesarean Podcast,0,0,0,0,3,3
Rookie Big Board Fantasy Football Podcast,0,0,0,0,10,10
Sweep the Floor,0,0,0,0,3,3
Acoustic Voices: A Guitar Podcast,0,0,0,0,1,1
The Think Stupid-Simple Podcast,0,0,0,0,9,9
The Hango Show,0,0,0,0,2,2
From the Cheap Seats,0,0,0,0,3,3
The Aesthetic Report,0,0,0,0,14,14
MorWrestling,0,0,0,0,5,5
Talking It Out,2,1,3,4,80,90
The WorkSmart Podcast With Morgan DeBaun,0,0,0,0,22,22
LongDays with Yannis Pappas,0,0,0,1,49,50
Unapologetic Parenting,0,0,0,0,4,4
Talking Time With Tim,0,0,0,0,2,2
FEICES,0,0,0,0,1,1
The Resource Room,0,0,0,0,1,1
FIFA PlayOn,0,0,0,1,8,9
Higher Sex,0,0,0,0,3,3
Alternate Shot,0,0,0,0,4,4
Preschool All Stars,0,0,0,0,50,50
Seek Learning,0,0,0,0,3,3
Longshot: Return Man,2,3,3,1,15,24
Attention to Detail: The Podcast,0,0,0,0,4,4
It Still Slaps,0,0,0,0,3,3
Ask Deer Abby,0,0,0,0,3,3
The Ace Metaphor Audio Experience,0,0,0,0,2,2
Inside the Breakthrough - How Science Comes to Life,0,2,0,1,1,4
Zen of Dog Ownership,0,0,0,0,1,1
Double Date with Marlo Thomas & Phil Donahue,0,0,0,0,12,12
The Porrada Podcast,0,0,0,0,11,11
The Secret Life Of Cookies,1,0,0,0,10,11
Live from Mount Olympus,0,0,0,0,25,25
Lightweights Podcast,1,0,1,1,47,50
Talking Trees with Davey Tree,0,0,0,0,1,1
AJ and Sara,1,0,0,0,46,47
The Tipping Point with Jimmy Evans,0,0,0,0,10,10
Tea with Ms. McGill Show,0,0,0,0,1,1
The Fanco Wrestling Show,0,0,0,0,13,13
Twinning at Life,2,0,0,1,86,89
The Spiritually Sassy Show,0,0,0,0,28,28
JOSH MAT SEVAN,0,0,1,1,30,32
The Robbie Fowler Podcast,1,0,0,5,27,33
The Dinesh D'Souza Podcast,37,1,2,6,445,491
Honest UX Talks,0,0,0,0,2,2
Tornado Trackers,0,0,0,0,9,9
Doing Justice,0,0,1,0,76,77
H2OME,1,1,1,0,6,9
The First Mint :: NBA Top Shot Podcast,2,0,0,0,22,24
Missing Maura Murray,4,2,1,0,3,10
Intermittent Fasting by Cabral Concept,0,0,0,0,2,2
The WTF California Podcast,0,0,0,0,1,1
Here First,0,0,0,0,4,4
A Lifetime in NASCAR,0,0,0,0,1,1
Disney Movie Insiders Presents,0,0,0,1,7,8
The Damsel Dialogues,0,0,0,0,3,3
The Long Shot with Duncan Robinson and Davis Reid,1,0,1,1,69,72
World Reimagined,0,0,0,0,29,29
That Scene with Dan Patrick,2,0,0,0,5,7
The Profitable Audience Podcast,0,0,0,0,50,50
Flight Suit Friday,0,0,0,0,3,3
Dr. Jackie's Point of V,0,0,0,1,12,13
All About Capital Campaigns,0,0,0,0,1,1
Podding the Red Sox,0,0,0,0,3,3
Fantasy Hockey Picks & Bets,1,0,0,0,139,140
Mostly wrestling stories,0,0,0,0,1,1
Entre Hermanas con Alejandra Espinoza y Damaris Jimenez,0,1,0,1,48,50
The Crossover,0,0,0,0,4,4
Indian Startup Stories,0,0,0,0,6,6
Make Your Damn Bed,0,0,0,0,5,5
PenteTalks 2021,0,0,0,0,4,4
Do I Look Like I Know? (DILLIK),0,0,0,0,1,1
Midnight Memories: The Podcast,0,0,0,0,1,1
Win(e)d Down,0,0,0,0,1,1
The Real Canon,2,1,0,2,8,13
The 18th Airborne Corps Podcast,1,2,1,0,7,11
Space F*****s,0,0,0,1,2,3
Trosky Ranch Complete Player Development,0,0,0,0,1,1
A Gutsy Girl,0,0,0,0,22,22
Reparations: The Big Payback,12,2,2,2,32,50
Franny Tings,0,0,0,0,8,8
Pooch Parenting,0,0,0,0,6,6
That's So Sabotage,1,0,0,0,20,21
The Intuitive Eating Podcast,0,0,0,0,5,5
Puppy Talk,0,0,0,0,7,7
Top 9 Podcast,0,0,0,0,6,6
MCU Pod: A Marvel Cinematic Universe Podcast,0,0,0,0,3,3
The Wrestling Matt Podcast,0,0,0,0,10,10
Ben and the Baby,0,0,0,0,1,1
The Salmonville Letter Writer,0,0,0,0,1,1
The Cinecal Moviecast,0,0,0,0,1,1
Side Quest Side Sesh,0,0,0,0,50,50
Open Mic Comedy Show,0,0,0,1,3,4
Be The Right Club Today Podcast,0,0,0,0,2,2
Practically Gita,0,0,0,0,3,3
Teen Summit Podcast,0,0,0,0,1,1
Cannons & Tomahawks Podcast,0,0,0,0,1,1
It Holds Up,0,0,0,0,6,6
Mom Friends,0,0,1,1,48,50
Marty Smith - The Road You Leave Behind,0,0,0,0,15,15
Miami Sports Vibes with Nando Diaz - A Miami Heat & Miami Dolphins Podcast,0,0,0,0,29,29
Pimples and boners,0,0,0,0,1,1
Rolltergeist,1,0,0,1,2,4
Off The Record: David Bowie,1,0,1,1,22,25
Honey Bee Obscura Podcast,0,0,0,0,5,5
The Animal Rescue Podcast: what you always wanted to know but didn’t know who to ask,0,0,0,0,1,1
The Book of Life: Weekly Wisdom with Ruchi Koval,0,0,0,0,1,1
Rise of the Classics Podcast,0,0,0,0,2,2
Borgo Pass Horror Podcast,0,0,0,1,4,5
Abide,1,0,5,1,97,104
BOY TALK,1,0,0,0,27,28
Unofficial Sources,0,1,0,0,2,3
Goodbye Glam Squad - the Erika Jayne Girardi Scandal,1,1,0,0,2,4
We Might Be Drunk,0,1,0,0,43,44
Alberto del Arco,0,0,0,0,1,1
At Home with Benalivi,0,0,0,0,14,14
COURTSIDE with Neal Katyal,0,0,0,0,11,11
Living Electric,0,0,1,0,1,2
OFX Podcast,0,0,0,0,1,1
"Boiler Up, with Rapheal Davis",0,0,0,1,11,12
EOD Drinks,0,0,0,0,1,1
The Striker MLS Podcast,0,0,0,0,1,1
Uncultured Bias with Camara Williams,0,0,0,0,10,10
Afro Saiyan Podcast,0,0,0,0,2,2
Cleared for Takeoff,0,0,0,0,1,1
15 Point Plan,0,0,0,0,19,19
The Link Up Listening Party,0,0,0,0,7,7
"Faith, Philosophy & Politics",0,0,0,0,5,5
The Powerstroke Tech Talk w/ARod Podcast,0,0,0,0,3,3
The NeoJurassic Podcast : The Wild Possibilities of a Jurassic World,0,0,0,0,1,1
Who Knows? We Don't!,0,0,0,0,1,1
"Easier Movement, Happier Horses",0,0,0,0,1,1
Real Reality Fantasy Football,0,0,0,0,17,17
FWF: Figure Wrestling Federation,0,0,0,0,30,30
The Water Tales,0,0,0,0,1,1
The Whimsy + Wellness Podcast,0,0,0,1,49,50
Video Express,0,0,0,0,3,3
Knowable,0,0,0,0,1,1
DFL Running Podcast,0,0,0,0,3,3
Calm Down with Erin and Charissa,1,0,1,1,80,83
Dear Jenna,0,0,0,0,50,50
Clubs & Corks Golf Podcast,0,0,0,0,12,12
Yu Dive Deep,0,0,0,0,10,10
Off-Grid Essential Podcast,0,0,0,0,1,1
Phase Zero,2,0,4,1,45,52
Suave,0,0,2,0,102,104
The Parker Edison Project,1,0,0,0,5,6
Best Beast,0,0,0,0,3,3
NASCAR Weekly Podcast,0,0,0,0,4,4
Bleav in Wake Forest Basketball,0,0,0,0,3,3
Moments That Rock with Tony Michaelides,0,0,0,0,1,1
Object Of Sound,0,0,0,0,13,13
The Ezra Klein Show,10,4,6,12,164,196
Discussing Marvel : A WandaVision Aftershow,1,0,0,0,4,5
Hey! It's a Disc Golf News Podcast,0,0,0,0,1,1
Non Prophets Podcast,0,0,0,0,2,2
The Soil Health Hub Podcast,0,0,0,0,1,1
How Can I Help? – with Dr. Gail Saltz,1,0,0,0,10,11
Facing Forward,0,0,1,1,10,12
Tougie's Take,0,0,0,0,3,3
No Luxe Left Behind,0,0,0,0,4,4
We Talk Back,1,1,0,0,24,26
S2D: The Symptom to Diagnosis Podcast,0,0,0,0,2,2
Beer on the Run Podcast,0,0,0,0,7,7
Just Getting Started with Rich Eisen,0,0,0,0,19,19
Counterjam,0,0,0,0,8,8
Real World Peaceful Parenting,0,0,0,1,49,50
WandaVision 30 Questions,0,0,0,2,5,7
The 3 Amigos,0,0,0,0,2,2
karmamind's podcast,0,0,0,0,36,36
Master Your Mind With Marisa,1,0,0,0,2,3
The Battersea Poltergeist,0,0,0,0,4,4
The Dynasty Movement,0,0,0,0,1,1
On The Screws Golf,0,0,0,0,1,1
Skin and the City,1,0,0,0,36,37
Hear to Slay,0,0,0,0,2,2
Tech News for MBAs,0,0,0,2,14,16
GoZen! Stories,0,0,0,0,10,10
80s Wrestling The Podcast,0,0,0,0,3,3
Side Piece with Melissa Pfeister,0,0,0,0,30,30
Vox Quick Hits,0,1,1,1,4,7
Bee-Attitudes,0,0,0,0,1,1
Daleks Aren't Robots!?,0,0,0,0,2,2
The Kelcey Ayer TV Show on Radio,0,0,0,0,4,4
The Bun and Cardigan Show: A Detroit Pistons Podcast,0,3,0,0,32,35
How It's Made Podcast,0,0,0,0,3,3
The Morgan Harper Nichols Show,0,0,0,0,23,23
The Well Read Poem,0,0,0,0,20,20
Off Da Pine Podcast,0,0,0,0,4,4
More to Life Podcast,0,0,0,0,2,2
A Lititz Podcast,0,0,0,0,1,1
Daily Fantasy Sports Picks & Bets: The Mix,1,0,0,0,103,104
Ultimate Sports Mashup,0,0,0,0,1,1
Chakras + Sex + Relationships with Eliza Boquin,0,0,0,0,11,11
Fantasy Baseball Picks & Bets,0,0,0,0,60,60
Good Times with Mo: The Podcast Year 10,0,0,0,0,1,1
On the Road with Penguin Classics,0,0,0,0,2,2
The Happy Pear Podcast,0,0,0,0,2,2
The History Guy,0,1,0,0,4,5
How It Happened,2,1,3,0,39,45
KYLE and KEVIN: Did we do it?,0,0,0,0,5,5
Lost Hills,3,5,1,2,29,40
Living Centered Podcast,0,0,0,0,9,9
The Chirp with Daren Millard,1,0,0,0,4,5
Armchair Expert Mondays with Dax Shepard,0,1,0,0,3,4
A Word … with Jason Johnson,1,0,1,1,23,26
The Daily Punch,5,3,3,8,34,53
The Wilkow Majority,0,0,0,0,4,4
We Will NOT Play DnD,0,0,0,0,2,2
Stark Wars | Star Wars and Marvel Series Recaps,0,0,0,0,24,24
Flock Journey,0,0,1,0,1,2
The Fit CEO Podcast with Chad Molyneux,0,0,0,0,2,2
Your Next Favorite Movie,0,0,0,0,4,4
FORTitude - Fort Worth Business Leaders,0,0,0,0,1,1
The Battle Catz Podcast,0,0,0,0,7,7
Jorgenson's Soundbox,0,0,0,0,32,32
"First Take, Her Take",1,1,2,1,19,24
Sound the Siren,0,0,0,0,3,3
Check The Marc,0,0,0,0,4,4
ATI Mometrix Teas Review : let’s pass this teas together,0,0,0,0,1,1
Hi Nay,0,0,0,0,2,2
Ian Wright's Everyday People,1,0,0,0,35,36
Comedy Gold Minds with Kevin Hart,6,2,0,3,36,47
Inside Jokes with Kevin Hart,6,2,0,3,36,47
Narcosis: Into The Deep,0,0,0,0,2,2
Cincinnati Zoo Tales,0,0,0,0,2,2
Johnny B Unleashed,0,0,0,0,3,3
Scene at Last,0,0,0,0,1,1
ReviewPods - True Crime Podcast Reviews,0,0,0,0,2,2
The Courtship of Mona Mae,0,0,0,0,3,3
Just Grow It: The Podcast,0,0,0,0,7,7
True Crime Binge,4,0,0,1,95,100
Strange Language,0,0,0,0,1,1
Game MISSconduct,0,0,0,0,3,3
Knee On Belly,0,0,0,0,3,3
The Summercast,0,0,0,0,7,7
One Crazy Ride,0,0,0,0,4,4
Jewel Heart Podcast,0,0,0,0,1,1
Fore The People,1,0,0,0,18,19
Cleanup on Aisle 45 with AG and Andrew Torrez,0,0,1,0,13,14
The Backfield,0,0,0,0,1,1
Hard Tackle - Football Podcast,0,0,0,0,5,5
The College Baseball Nation Podcast,1,0,0,0,1,2
The Am Side Podcast,0,0,0,0,1,1
In The Weeds with Rob Law,0,0,0,0,2,2
They Come to America,0,0,0,0,2,2
Here For Healing,0,0,0,0,6,6
Wokemanistan,0,0,0,0,16,16
Behind the Veil,0,0,0,0,21,21
Rewildology,0,0,0,0,1,1
"Cheers, Brother!",3,2,2,4,39,50
Your Hometown,0,0,0,0,2,2
This Spiritual Fix,0,0,0,0,27,27
Cardboard Fever,0,0,0,0,6,6
Hobby Hunter,0,0,0,0,22,22
Tennis Betting Tidbits,0,0,0,0,1,1
LYF3,0,0,0,0,2,2
Valley of the Suns: A Phoenix Suns Podcast,0,0,0,1,3,4
Slab Talk,0,0,0,0,3,3
How You Create,1,1,0,0,33,35
Into the Shoujo-Verse,0,0,0,0,1,1
This is Tulsi Gabbard,3,0,0,4,164,171
The DAWG POD,0,0,0,0,5,5
Kevin Frandsen’s Pine Tar for Breakfast,0,0,0,0,2,2
3for30,0,0,0,0,1,1
The India Energy Hour,0,0,0,0,1,1
"Girl, I Guess",8,3,4,0,73,88
The Experiment,48,10,20,12,98,188
Buddhist Recovery Podcast,0,0,0,0,1,1
A Little Something Extra,0,0,0,0,1,1
Spinsters,2,1,1,1,182,187
Public Power Underground,0,0,0,0,4,4
Unsubscribe Podcast,0,0,0,0,50,50
Find A Topic,0,0,0,0,6,6
Working Title,3,0,3,1,41,48
1st Edition Podcast,0,0,0,0,1,1
The Mythical Menagerie,0,0,0,0,1,1
Lisa Upside Down,0,0,0,0,1,1
The Human Instrumentality Podcast,0,0,0,0,1,1
Golf Cart Conversations,0,0,0,0,3,3
Balance is Key,0,0,0,1,38,39
Leading Steep,0,0,0,1,44,45
This Week In Videogames,0,0,0,0,10,10
Everyday Woodworking,0,0,1,0,0,1
Tesseract TV: WandaVision,0,0,0,0,11,11
Nurture vs Nurture with Dr. Wendy Mogel,8,8,0,4,142,162
Just The Tip With Danee Bananas,2,1,0,0,6,9
Snakey Talk,0,0,0,0,2,2
Music For Kiddos Podcast,0,0,0,0,10,10
What were you saying ??,0,0,0,0,1,1
Judas and the Black Messiah Podcast,0,0,1,0,7,8
Unsolved Mysteries,24,9,6,12,192,243
Clever Clogs: Riddles for Kids Podcast,1,0,0,0,0,1
Band of Mothers,1,0,0,1,30,32
Sound Culture,0,0,0,0,6,6
Dwellings,0,0,0,0,1,1
Windy City Double Feature Picture Show,0,0,0,0,2,2
SHE / THEY / GAY,0,0,0,0,1,1
The Star Spangled Banter Podcast,0,0,0,0,2,2
And The Best Picture Is...,0,0,0,0,3,3
SpursLandia,0,0,1,0,11,12
Bravo Group Chat,0,0,0,0,13,13
Local Side of Key West,0,0,0,0,7,7
New Species,0,0,0,0,3,3
The Wrestfriends Podcast,0,0,0,0,1,1
The Motherhood & Money Show,1,0,0,0,17,18
Ebony and Irony,2,1,0,0,47,50
Apple Tech Talk-ATT,0,0,0,0,1,1
The Outcast,0,0,0,0,2,2
Roblox!!,2,0,0,0,7,9
NHT awareness.,0,0,0,0,1,1
Skinny Dipping,0,0,0,0,50,50
Good Words with Kirk Franklin,0,0,0,1,81,82
Pop Music For Smart People,0,0,0,0,4,4
Call Of The Wild,0,0,0,1,8,9
Complete Performance Podcast,0,0,0,0,2,2
The Broadway Hat Podcast,0,0,0,0,44,44
Made of Stronger Stuff,0,0,0,0,13,13
The Carnivore Yogi Podcast,0,0,0,0,13,13
Nitty Gritty Training,0,0,0,0,3,3
Alternative Design Podcast,0,0,0,0,2,2
MODASUCKA with Michael Blackson,0,0,2,0,19,21
The Big Sauce Podcast,0,0,0,0,3,3
I Spent A Day With...,0,0,0,0,16,16
That New Mom Life,0,0,0,0,3,3
Keep the Heart,0,0,0,1,66,67
Thirsty for Hallmark,0,0,0,0,3,3
The Tree Thinking Podcast,0,0,0,0,4,4
For The Love of Chaos,0,0,0,0,42,42
Straight Shooters Golf Podcast,0,0,0,0,1,1
The THRU-r Podcast,0,0,0,0,4,4
The Office Deep Dive with Brian Baumgartner,6,4,2,6,118,136
The Owen Jones Podcast,14,1,0,1,55,71
Daily Discipline with Brian Kight,0,0,0,0,23,23
Dodge Movie Podcast,0,0,0,0,3,3
The Stretch Four: NBA Fantasy Experts,0,0,0,0,5,5
The Project Healthy Body Podcast,0,0,0,1,38,39
Gone-Gpn Show,0,0,0,0,1,1
Anxious Like You,0,0,0,2,48,50
Black Autonomy Podcast,0,0,0,0,3,3
MilkMaids,0,0,0,0,2,2
Jason Wilde,0,0,0,0,1,1
Scalzo & Brust,1,0,0,0,21,22
Wilde & Tausch,0,0,0,0,6,6
Dr. Juan Santo Remedio,0,0,1,0,1,2
Marvelvision,0,0,0,0,7,7
The Next American Built Environment,0,0,0,0,3,3
Tremendous Girl,1,1,0,0,16,18
Brain Rot - An 80s Horror Podcast,0,0,0,0,1,1
Granite State Gardening,0,0,0,0,2,2
I Hate This Job,0,0,0,0,2,2
Straight Ahead Animation Podcast,0,0,0,0,1,1
One-Punch Fan,0,0,0,0,2,2
The Undressing Room Podcast Presented by Macy’s,0,0,0,1,8,9
How My Grandmother Won WWII,1,0,0,0,9,10
Neural Networking,0,0,0,0,1,1
The Homeschooling Journey Podcast,0,0,0,0,5,5
The Pop Test – A comedy science quiz,2,0,0,0,6,8
History of the MCU Podcast,0,0,0,0,9,9
Genius Bar,0,0,0,0,11,11
This Month in Sports,0,0,0,0,3,3
The CX Tipping Point,0,0,0,0,2,2
Shegone Nation Podcast,0,0,0,0,3,3
Parenting with Ginger Hubbard,0,0,0,0,21,21
Ministrytwear,1,0,0,0,7,8
The Jordy Culotta Show,0,0,0,1,23,24
The Language Neuroscience Podcast,0,0,0,0,1,1
New York Gritty,0,0,0,0,8,8
Ride or DIY with Liz Morrow,0,0,0,0,2,2
Duluth News Tribune Minute,0,0,0,0,1,1
The Find Your STRONG Podcast,0,0,0,0,7,7
Objections: With Adam Klasfeld,0,0,1,0,11,12
The Writers Room with Sam and Jim,0,0,0,0,7,7
Capital Record,0,0,1,0,14,15
Prompt Us,0,0,0,0,2,2
The Training With Tucker Podcast,0,0,0,0,6,6
Collapse,0,0,0,0,16,16
Dirty Detectives,0,0,0,0,9,9
RHAP Rewind,0,0,0,0,1,1
Radical Musings with Rosanna Arquette,1,1,0,0,10,12
Just Another Excuse,0,0,0,0,3,3
Why Wait Till Sunday,0,0,0,0,2,2
Chrisman Commentary - Daily Mortgage News,0,0,0,0,4,4
Japanese with Shun,0,0,0,0,1,1
It's Nice to Hear You,0,0,0,0,8,8
Nuts & Bolts Rc Podcast,0,0,0,0,2,2
Curious Questions with Ricky Williams Podcast,0,0,0,0,39,39
"Grow, cook, eat, arrange with Sarah Raven & Arthur Parkinson",0,0,0,1,18,19
China Stories,0,0,0,0,4,4
Team Blaney Podcast,0,0,0,0,1,1
To Be Honest,1,0,0,0,7,8
MC! True Long Island Story,1,0,0,0,98,99
Bolling with Favre,1,2,1,1,60,65
Extreme Conversations w/ Brian Myers,0,0,0,0,26,26
Channel Your Enthusiasm,0,0,0,0,4,4
Emergency 9 Golf,0,0,0,0,7,7
The #ANGELS Podcast,0,0,0,0,8,8
STANDBY with JJ and Francisco,0,0,0,0,1,1
BIG FACTS,0,0,0,0,2,2
SYGNYL,0,0,0,0,50,50
CMQ Investing Presents: Compound Money Quietly,0,0,0,0,9,9
Muppeturgy: A Muppet Show Rewatch Podcast,0,0,0,0,3,3
The Fernando Espuelas Show,0,0,0,0,4,4
The HorrorBabble Podcast,0,0,0,0,5,5
Flora Funga Podcast,0,0,0,0,2,2
Trash Pandas Podcast Network,0,0,0,0,4,4
Ask Dr. Julie Hanks,0,0,0,1,49,50
Think About It with Victoria Azarenka,0,0,0,0,6,6
Behind Every Dream,0,0,0,0,2,2
PRETTYSMART,0,0,0,0,50,50
The LoPriore Podcast,1,0,0,0,39,40
Heterodox Out Loud,0,0,0,0,5,5
Investing in Stocks & Crypto for Beginners,0,0,0,0,5,5
Adventure Flying,0,0,0,0,2,2
Trading Table - Dynasty Fantasy Football,0,0,0,0,1,1
StribSports Daily Delivery,0,0,0,0,5,5
Drift Off - Bedtime Stories for Sleep,0,0,0,0,3,3
Above Par,0,0,0,0,13,13
Green Acres Garden Podcast with Farmer Fred,0,0,0,0,3,3
Alan Carr's 'Life's a Beach',1,0,1,2,84,88
The Naruto Virgin,1,0,0,0,3,4
THE DOG HOUSE with Adam & Jimmy,0,0,0,0,6,6
Reality With Vicki,1,0,1,1,13,16
Straight Forward Farming,0,0,0,1,13,14
Whitehot Magazine: Art World with Noah Becker,0,0,0,0,1,1
Harvard Torah,0,0,0,0,1,1
The Dogist: Talking Dogs,0,0,1,0,54,55
Opening Act,0,0,0,0,5,5
Meet Star Gazers,0,0,0,0,1,1
More Than Tracy Turnblad,0,0,0,0,7,7
Passion For Collecting,0,0,0,0,5,5
Organic Sexuality,0,0,0,0,11,11
The Combat Corner,0,0,0,0,1,1
Nat Wonderful,0,0,0,0,1,1
Pillows and Beer,22,11,25,17,182,257
Duchess,0,0,0,0,14,14
The Panic Years,0,0,0,0,9,9
The Opportunist,0,6,0,9,249,264
Rainbow Bridge Connection- Pet loss support,0,0,0,0,3,3
The Truth As I Know It,0,0,0,0,2,2
Spectacle: An Unscripted History of Reality TV,3,1,4,0,30,38
Peering Into The Narrow Room :Expanding the Spirit & Mind,0,0,0,0,9,9
In the Holding Room,0,0,0,0,1,1
Behind The Investigation Podcast,0,0,0,0,2,2
#SistersInLaw,1,0,0,1,48,50
Wedded: The Wedding Planner Podcast,0,0,0,0,28,28
Dwell,0,0,0,0,2,2
Tough on Art,0,0,0,0,1,1
Marv Runs Far,0,0,0,0,2,2
Big & Hungry,3,1,0,0,46,50
Crushing Miles Daily,0,0,0,0,2,2
The Artist and The Athlete with Lindsay Czarniak,0,0,0,0,9,9
Audio Diary Of A Wimpy Kid,0,0,0,0,1,1
The Colin Cowherd Podcast,3,1,1,3,50,58
Pricing Nature,0,0,0,0,9,9
Life in the Rough,0,0,0,0,1,1
Our Birth Wisdom,0,0,0,0,7,7
If/Then,0,0,1,1,30,32
Morning Bru with Jaffe & Razor,0,0,0,0,12,12
Clout101 - The Marketing Strategy Podcast,0,0,0,0,11,11
Comeback Stories,0,0,0,0,47,47
So What!? - A Come Follow Me Resource for LDS Youth,0,0,0,0,2,2
The Love Fix,0,0,0,0,10,10
Popping Corks w/ Winemaker Eric Jensen,0,0,0,0,1,1
WGBD: When God is Black and Disabled,0,0,0,0,1,1
Novafleet 86,0,0,0,0,1,1
The Terminally Unique Podcast,0,0,0,0,2,2
THE DAVID MCKAY-L8-NIGHT SPECIAL,0,0,0,0,2,2
Honey I’m Home,0,0,0,0,11,11
Chuckle Sandwich,1,0,0,1,48,50
Not Your Average Globetrotter,0,0,0,0,4,4
CMP Podcasts,0,0,0,0,2,2
Running Realized,0,0,0,0,22,22
The Pilot Base,0,0,0,0,7,7
Your Dose of Death,0,0,0,0,2,2
Are We Really Brothers,0,0,0,0,24,24
Now and Then,0,0,0,0,1,1
Free The Girls,1,0,0,1,23,25
Joint Resolution with Joe Cunningham,0,0,0,1,27,28
The National Pulse,0,0,0,1,49,50
Is MMT Real? (A Current Affairs Production),0,0,0,0,2,2
That Anime Podcast - For Casual Anime Fanatics,0,0,0,0,1,1
K&G Radio,0,0,0,0,6,6
Sailor Manga,0,0,0,0,1,1
The Immersive Design Podcast,0,0,0,0,1,1
TRUE,0,0,0,0,37,37
a16z Live,0,0,0,0,1,1
Travel Light with Chase Reeves,0,0,0,1,30,31
GetReal!,0,0,0,0,7,7
The Simple Garden Life,0,0,0,0,2,2
On The Wire,0,0,0,0,3,3
Baking A Murder,0,0,1,0,49,50
Wilderness Warrior Podcast,0,0,0,0,5,5
Eight Threads: Unraveled,0,0,0,0,1,1
Tucson Heat,0,0,0,0,3,3
The Lincoln Project,4,0,0,2,44,50
Companions of the Compendium,0,0,0,1,1,2
Blunt Talk with Gabriel Zamora,0,1,1,2,59,63
All About Her | HerFitBod,0,0,0,0,4,4
Pyramid Wrestling,0,0,0,0,5,5
The Influential Nonprofit,0,0,0,0,1,1
FantasyPros Dynasty Football Podcast,1,0,2,1,125,129
The Sand Trap,0,0,0,0,1,1
The Game Chat Sports Podcast,0,0,0,0,2,2
The Food That Built America,2,4,8,2,44,60
The Horse Fix,0,0,0,0,2,2
There's Always a Ladder,0,0,0,0,5,5
Ke Muela :V,0,0,0,0,3,3
Travolting,0,0,0,0,2,2
Macrodosing: Arian Foster and PFT Commenter,6,1,9,1,465,482
Best Picture This,0,0,0,0,6,6
Weighing In with David Mirikitani,0,0,0,0,1,1
Bet the Best,0,0,0,0,4,4
The Anime Virgin,0,0,0,1,4,5
The Real HopeCast,0,0,0,0,4,4
Track and Field Black History,0,0,0,0,2,2
The Midheaven Podcast,0,0,0,0,3,3
Rifles Only Accuracy Podcast,1,0,0,0,1,2
Chris Distefano Presents: Chrissy Chaos,3,1,2,1,43,50
3 Peas In A WOD,0,0,0,0,4,4
The POPCast: A Patterns of Power Podcast,0,0,0,0,1,1
Bridgerton: The Official Podcast,2,0,0,0,8,10
Unified,0,0,1,0,27,28
Eye of the Duck,0,0,0,0,2,2
Third Degree,4,0,1,2,43,50
CoolBusCast,0,0,0,0,7,7
Teaching Meditation,0,0,0,0,1,1
Dirty Air: A NASCAR DFS Podcast,0,0,0,0,1,1
The Austin Approach,0,0,0,0,1,1
Dugout Study Hall,0,0,0,0,1,1
The Pat Tomasulo Podcast,0,0,0,1,25,26
Kingdom Builders,0,0,0,0,4,4
The Aaron Abke Podcast,0,0,0,0,4,4
The Ice Guys,0,0,0,0,1,1
Cup of Joe,0,0,0,0,6,6
Fck Bogeys,0,0,0,0,3,3
“Fishing After Dark” W/ The Beard & The Badge,0,0,0,0,6,6
Choose You Now,0,0,0,0,19,19
Keep or Kut,0,0,0,0,2,2
Blueberries Hill,0,0,0,0,1,1
For the Love of Nature,0,0,0,0,5,5
The Center Collaborative: Creative Solutions in Behavioral Health and Criminal Justice,0,0,0,0,2,2
Three Hillbillies on a Couch,0,0,0,0,1,1
The Jab from Economist Radio,1,0,0,1,9,11
RFK Jr The Defender Podcast,1,0,0,1,28,30
Empowered Business,0,0,1,1,48,50
Reef Beef,0,0,0,0,4,4
"Hecha de Estrellas Podcast, con Alejandra Freile",0,0,0,0,3,3
Teach Me A Lesson with Greg James and Bella Mackie,1,1,1,1,44,48
Stacking Pennies with Corey LaJoie,0,1,2,1,24,28
Level Up with Debbie Neal,0,0,0,0,32,32
Locked On Wildcats - Daily Podcast On Arizona Wildcats Football & Basketball,0,0,0,0,5,5
Sideways,0,0,4,0,4,8
Peace In A Podcast,0,0,0,0,2,2
The DR & the DJ,0,0,0,0,8,8
Inflection Point,0,0,0,0,1,1
Command The Zone,0,0,0,0,1,1
Where Do You RunWell? Podcast,0,0,0,0,1,1
This is Paris,10,5,0,10,410,435
Mapping Out Eth 2.0,0,0,0,0,2,2
The Ayaan Hirsi Ali Podcast,0,0,1,0,33,34
Finding the Joys in the Journey,0,0,0,0,1,1
Expected Points,0,0,0,0,3,3
Deeply Human,0,0,0,0,25,25
Astray,0,0,0,0,32,32
Two Washups One Pro,0,0,0,0,9,9
For All Mankind: The Official Podcast,1,0,0,0,10,11
Runners Shuffled Podcast,0,0,0,0,1,1
The Reroute by Good Humans Only,0,0,0,0,50,50
Owning the Wait,0,0,0,0,37,37
The Cross Connection with Tiffany Cross,0,0,0,0,10,10
Velshi,0,0,0,0,18,18
The Sunday Show with Jonathan Capehart,0,0,0,0,1,1
PDA Parents,0,0,0,0,6,6
Business & Beyond with Gerry Dick,0,0,0,0,6,6
Everything is We,0,0,0,0,26,26
Ball Gag,0,0,0,0,1,1
Things You Don't Need to Know with Ari Cagan,0,0,0,0,30,30
Inside The Vault with Ash Cash,0,0,0,0,16,16
The Rockstar Show by Nicky Jam 🤟,0,0,0,0,3,3
Space to Grow,0,0,0,0,1,1
Rootsland,0,0,0,0,5,5
The Story Nook,0,0,0,1,2,3
Tracking the Storm,0,0,0,0,2,2
The Cait Crowell Podcast,0,0,0,0,1,1
The Gumbo Show,0,0,0,0,2,2
"BloodBath w/ Annie, & Esther, & Khalyla",4,2,4,2,169,181
"Unconditional Love Stories: Pet Parenting Inspiration | Dog Training, Nutrition, Tips & Tricks",0,0,0,0,4,4
Becoming A Stress-Free Nurse Practitioner,0,0,0,1,49,50
A Kids Book About: The Podcast,0,0,0,0,6,6
The Horse People Podcast,0,0,0,0,1,1
The Daily Aus,0,0,0,0,4,4
OB POD,0,0,0,0,6,6
Casually Uncomfortable,0,0,0,0,1,1
Meaning Full Living,4,0,0,0,24,28
OMG Hi! with George Lopez Podcast,2,0,0,0,12,14
The Card Foundation Podcast,0,0,0,0,22,22
Toxic Masculinity,0,0,0,0,2,2
Charlando Tranquilamente,0,0,0,0,1,1
Frost on Flowers,0,0,0,0,3,3
Live Beautifully with Katrina Scott,0,1,0,1,198,200
The River Certified Podcast,0,0,0,0,5,5
Strange by Nature Podcast,0,0,0,0,6,6
Return of the Pod: A Podcast About Star Wars,1,0,1,1,87,90
Baka Banter Anime Podcast,0,0,0,0,18,18
Guilty Pleasures,5,1,6,1,37,50
Field & Garden,0,0,0,0,19,19
Uncircumcised: Raw and Uncut,0,0,0,0,3,3
My Darling Diary,1,0,1,0,31,33
Insurance Agents Think Tank,0,0,0,0,2,2
DFORundown's podcast,0,0,1,0,0,1
Dead Zone Drive-In,0,0,0,0,8,8
Walking Distance: Where Love for Neighbor and Neighborhood Meet Podcast,0,0,0,0,7,7
Mangasplaining,0,0,0,0,3,3
Pitcher's Duel Podcast,0,0,0,0,1,1
The Language of Love,1,0,0,0,12,13
The Social Media Mindset,0,0,0,0,6,6
FAQ PODCAST,0,0,0,0,3,3
The Falcon and the Winter Soldier Podcast by Phantastic Geek,0,0,0,0,9,9
"""DOPE AS USUAL""",0,0,0,2,48,50
The Shuli Show,0,2,0,2,46,50
Keeping Up Appearances: The Luxury Podcast,0,0,0,0,1,1
Sound Thoughts on Art,0,0,0,0,2,2
The Business Journey Podcast,0,0,0,0,38,38
Tomo Podcast,0,0,0,0,2,2
SAUCED,0,0,0,0,1,1
Terroir-Driven: The Waterford Whisky Podcast,0,0,0,0,3,3
The Cast Die Podcast,0,0,0,0,6,6
Not My Type,0,0,0,0,8,8
Nerdabunga,0,0,0,0,7,7
"Gacha Wolfe 3,000",0,0,0,0,1,1
Juice Wrld,0,0,0,0,1,1
talk to Cassius,0,0,0,0,2,2
Almost Unbelievable Paranormal Podcast,0,0,0,0,1,1
Kids Stories - The Boy & The Elf,0,0,0,1,0,1
Key Battles of American History,0,1,0,0,24,25
Coma Girl,0,0,0,0,15,15
Evan's Brooklyn Basketball Podcast,0,0,0,0,2,2
Bring a Trailer Podcast,0,0,0,2,6,8
Not to Cut You Off,0,0,0,0,2,2
AB Wellness Podcast,0,0,0,0,2,2
Off Track,0,0,0,0,1,1
America Recovers,0,0,0,0,8,8
Community Building,0,0,1,0,7,8
The Wrestling RHAP-up,0,0,0,0,2,2
Ladies KAR Care Talk Show,0,0,0,0,4,4
The OjiFanboys,0,0,0,0,2,2
The Customer Engagement Lab,0,0,0,0,5,5
Selling The Mountains,0,0,0,0,2,2
Tips for raising Chicks,0,0,0,0,1,1
The Plugged Lie,0,0,0,0,3,3
Applied Mycology,0,0,0,0,1,1
For Better and Worse | With Jess and Rach,0,0,1,0,20,21
The Steve Sommers Overnight Drive,0,0,0,0,3,3
The Sweet Spot - Golf Podcast,1,0,0,0,27,28
Black Cowboys,1,0,1,0,28,30
The Butterfly Forecast,0,0,0,0,12,12
The Hezi,0,0,0,0,5,5
"Sorry, I'm Sad",0,0,0,0,3,3
Danger Close,0,0,0,0,9,9
Money Confidential,0,0,0,0,26,26
Wolf it Down Weekly - Tyler Florence Podcast,0,0,0,0,3,3
Talk Louder,0,0,0,0,1,1
The Pod Has Been Cast,0,0,0,0,10,10
On The Frontlines,0,0,0,0,7,7
Skincare School,0,0,2,0,30,32
The Nature Dilemma,0,0,0,0,20,20
HairB&B,0,0,0,0,12,12
My Gay Playlist,0,0,0,0,3,3
Pure American Podcast,0,0,0,0,4,4
BOLTED,0,0,0,0,9,9
Sasquatch Odyssey,0,0,0,0,4,4
Open Ice Hits: An NHL Podcast,0,0,0,0,9,9
The Quick Hit,0,0,0,0,1,1
Ghost Party Radio,0,0,0,0,10,10
Sit Down & STFU,0,0,0,0,3,3
White House Press Briefings,0,0,1,0,1,2
The Same! Podcast,0,0,0,0,3,3
The Weird Gig Podcast,0,0,0,0,3,3
Can I go home now? with John Kennedy,0,0,0,0,5,5
Dynasty x Design,0,0,0,0,5,5
Straight People Movies,0,0,0,0,5,5
Raised Right,0,0,0,0,4,4
La Brega,0,0,2,2,34,38
Ceremony Circle,0,0,0,1,36,37
THE ROCKSTAR SHOW,0,0,0,0,1,1
Sin Rodeo con Jomari Goyso,0,0,0,0,7,7
Storybrooke Circus: A Once Upon A Time Podcast,0,0,0,0,2,2
The Working Genius Podcast with Patrick Lencioni,0,0,0,0,3,3
High School Sucked,0,0,0,0,1,1
More Than That with Gia Peppers,0,0,0,0,2,2
Pretty For A Black Girl,0,0,0,0,4,4
Enter The Knight,0,0,0,0,2,2
Unwanted,2,2,3,1,42,50
Riches in the Niches Investor Podcast,0,0,0,0,2,2
The Anthony Sarandrea Show,0,0,0,0,32,32
Raising Kale,0,0,0,0,2,2
The Green Mind,0,0,0,0,1,1
Ask the Vet,0,0,0,0,1,1
Barrier Breakers,0,0,0,0,3,3
"Move better, feel great with Ace Morgan",0,0,0,0,3,3
Flight Following,0,0,0,0,1,1
Two Hot Takes,0,0,1,3,27,31
"Stars, Stripes, and Sanatanis: Young Hindu Voices of America",0,0,0,0,1,1
eaJ x keshi - pillows,0,0,0,0,1,1
Stefanie and Joan's Beauty Bar,0,0,0,0,59,59
Girls Bedroom,1,0,0,0,4,5
THE SANDBAGGERS,0,1,0,0,9,10
SOAR Long Form,0,0,0,0,1,1
Happiness Is with Bruce Aitchison,0,0,0,0,1,1
Quick Single,0,0,0,0,1,1
Therapy 4 Teens,0,0,1,0,33,34
Well Suited,0,0,0,0,5,5
"Royally Us - Harry, Meghan, Kate and William Royal News and Discussion",0,1,0,0,1,2
Making It To The Mic,0,0,0,0,6,6
Ready For It...A Taylor Swift Podcast,0,0,0,0,1,1
A Little Bit Culty,4,0,1,2,83,90
Against The Odds,30,6,6,6,480,528
Fit Over 50 Life,0,1,0,0,6,7
Scandalous Diamonds,0,0,0,0,9,9
Good Sex,1,0,2,4,16,23
Car CULTure,0,0,0,0,5,5
The Al Galdi Podcast,0,0,1,4,170,175
Lipsey's AIM HIGHER Podcast,0,0,0,0,2,2
What You're Craving,0,0,0,0,11,11
Serendipity With Inky Johnson,0,0,0,0,30,30
Real America - La Vera America Senza Filtri,0,0,0,0,5,5
Knead to Know,0,0,0,0,9,9
BECOMING:us with Moriah & Joel Smallbone VIDEO,0,0,0,0,7,7
BECOMING:us with Moriah & Joel Smallbone,0,0,0,0,63,63
RNZ: Fragments,0,0,0,0,3,3
The Homies Podcast,0,0,0,0,2,2
We Go There Podcast,0,0,0,0,6,6
The Ben Ryan Podcast,0,0,0,1,2,3
Scratchquest: Golf Better,0,0,0,0,2,2
The Schwabcast,0,0,0,0,3,3
The Birds & Bees,0,0,0,0,12,12
Left Reckoning,0,0,0,0,5,5
Listen Sis.,0,0,1,1,28,30
RNZ: NZ Wars: Stories of Tainui,0,0,0,0,5,5
Fit For Life with Anjuli,0,0,0,0,3,3
The Doc Talk- Baseball Doctor,0,0,0,0,1,1
Creepscast,0,0,0,0,13,13
The CISO Stories Podcast,0,0,0,0,2,2
Creative Energy,0,0,0,0,3,3
Views from the Edge,0,0,0,1,8,9
Prevail with Greg Olear,0,0,0,1,21,22
The Ryan Pineda Show,0,0,0,0,100,100
Marc & Heidi - The Other D’Amelios,6,0,0,1,28,35
Lincoln: Divided We Stand,0,0,0,0,1,1
Muddy Boots Podcast,0,0,0,0,2,2
Chicks University,0,0,0,0,3,3
The Strands That Bind Us,0,0,0,0,2,2
Fantasy Formula,0,0,0,0,1,1
The Followers: House of Prayer,0,1,1,1,2,5
Mostly Horror Movie Night,0,0,0,0,2,2
The Thatcher Effect,0,0,0,0,1,1
OVERCOME with Michaela,0,0,0,0,1,1
KWEB — Weaving Earth Radio,0,0,0,0,3,3
The Days for Girls Podcast,0,0,0,1,41,42
The Design Diaries,0,0,0,0,8,8
Water Pokemon,0,0,1,0,0,1
Holy City Sinner Radio,0,0,0,0,6,6
The Seed Pod,0,0,0,0,3,3
Ecology & Me,0,0,0,0,3,3
The Larry Kudlow Show,0,0,0,0,7,7
The Bag Ladies Show,0,0,0,1,18,19
Tom Morello’s Maximum Firepower,0,0,1,0,1,2
The Chazz Palminteri Show,0,0,0,0,4,4
Stoke The Fire,0,0,0,0,1,1
Creativamente Libre con Frances Machuca,0,0,0,0,18,18
Woodmother’s Workshop,0,0,0,0,4,4
Interesting Lives of Normal People,0,0,0,0,1,1
Making Marriage Cool Again,0,0,0,0,6,6
Let's Talk About Snacks,0,0,0,0,10,10
Integrative Nurse Coaches in ACTION!,0,0,0,0,3,3
SweeTalks,0,0,0,0,37,37
The Dr. John Berardi Show,0,0,1,2,47,50
The Painfully Honest Podcast with Jason T. Lewis,0,0,0,0,2,2
Shut The Funk Up Podcast,0,0,0,0,5,5
Return to EverQuest,0,0,0,0,11,11
On The Corner Podcast,0,0,0,0,2,2
All Up In Your Business,0,0,0,0,1,1
Fertile Me Radio,0,0,0,0,11,11
The Sean & Sax Show,3,0,0,1,112,116
PBTR - AMPLIFYING ADOPTION ISSUES,1,0,0,0,3,4
That's Enough Already with Urzila Carlson,0,0,0,0,2,2
Kids Trivia with Cayden,0,0,0,0,1,1
Motherhood Meets Medicine,4,0,0,2,24,30
TV GAYD,0,0,0,0,8,8
Pypeline ACC Podcast,0,0,0,0,3,3
Hollywood and Byrne,0,0,0,0,4,4
The Simplified Podcast with Emily Ley,0,0,0,4,170,174
The Butcher Shop,0,0,0,0,6,6
Packaging Podcast,0,0,0,0,1,1
Keep The Weight Off,0,0,0,0,1,1
Pawsitively Dog-Powered,0,0,0,0,3,3
The Homecare Bosses Podcast,0,0,0,0,9,9
Rainbow Rewatch,0,0,0,0,13,13
Shadow Banned Podcast,0,0,0,0,1,1
NONSENSEOLOGY,0,0,0,0,4,4
Fantasy Scouts Podcast,0,0,0,0,7,7
Cinema Stories,0,0,0,0,2,2
Something To Talk About with Samantha Armytage,0,0,0,0,13,13
Garden Talk with Mr. Grow It,0,0,0,0,6,6
No Limits Podcast,0,0,0,0,4,4
The Chris Terrell Podcast,0,0,0,0,5,5
Songs Out Loud,0,0,0,0,1,1
Ruff Around The Edges,0,0,0,0,1,1
The Esthetician’s Lounge,0,0,0,0,1,1
Markets in Focus,0,0,0,0,2,2
TE LO DIJO EL CHOMBO,0,0,0,0,1,1
Counterbalance,0,0,0,0,10,10
Tagline,0,0,0,0,3,3
Don't Tell My Mother! with Nikki Levy,0,0,0,0,10,10
Pops on Hops,0,0,0,0,1,1
American Metamorphosis,0,0,0,0,9,9
The Rockstar Superhero Podcast,0,0,0,0,1,1
Momtini Talks,0,0,0,0,5,5
The Across the Pond Show,0,0,0,0,5,5
Sisters By Chance Podcast,0,0,0,0,39,39
Trend Lightly,0,2,1,0,13,16
Josh and Cassie Yell About Movies!,0,0,0,0,1,1
Little stories by tiny people,1,0,0,0,0,1
Seemingly Unknown Podcast,0,0,0,0,2,2
Nava Cast,0,0,0,0,3,3
The Bitboy Crypto Podcast,0,0,0,0,3,3
No Dumb Answers with Mark & Brad,1,1,0,0,23,25
Allen v. Farrow Podcast,4,0,4,8,36,52
Big Money Energy,2,1,1,0,7,11
Down in the Dugout,0,0,0,0,3,3
Open Deeply Podcast,0,0,0,0,1,1
In Plain Sight: Lady Bird Johnson,4,0,0,0,80,84
Intentional Creative Podcast,0,0,0,0,1,1
Stephen A's World,0,1,0,0,3,4
Psychic Scoop with Spirit Sis,0,0,0,0,7,7
Bond and Banter,0,0,0,0,1,1
Powered By Audio,0,0,0,0,12,12
The Interview with Hugh Hewitt,0,0,0,0,4,4
Finding Mr. Height: The Podcast,0,0,0,1,29,30
Just to Be Nominated: An Award Season Murder Mystery,0,0,0,0,7,7
Ryann The Sagittarius,0,0,0,0,1,1
Solutions with Mason Hargrave,0,0,0,0,1,1
Passion for Dance,0,0,0,0,16,16
The Rhythm Of Life,0,0,0,0,4,4
The Bridgerton Bros,0,0,0,0,4,4
GIRLS TO THE FRONT,0,0,0,0,13,13
One Sweet Dream,0,0,0,0,4,4
On The Farm Podcast,0,0,0,0,1,1
I've Got Wanda Vision: A WandaVision Podcast,0,1,0,0,32,33
Bandscamps,0,0,0,0,1,1
Three Putt Par Podcast,0,0,0,0,1,1
Down Memory Lane w/Mark Rosen,0,0,0,0,2,2
Sew & So...,0,0,0,0,1,1
Skin Tings,0,0,0,0,7,7
The Edge Of Excellence Podcast,0,0,0,0,20,20
Kid Contractor Podcast with Caleb Auman,0,0,0,0,20,20
Fret Not,0,0,0,0,5,5
MOB RADIO,0,0,0,0,51,51
Mojo For Musicians,0,0,0,1,45,46
The Tyson Durfey Show,0,0,0,0,16,16
Brooklyn Art Library - Podcast,0,0,0,0,2,2
For All Mankind (from TeeVee),0,0,0,0,2,2
Daily Report,0,0,0,0,2,2
UpOnly with Cobie & Ledger,0,0,0,0,35,35
The Unholy Three,0,0,0,0,4,4
The Austin Daily Drop,0,0,0,0,3,3
Joyful Microbe,0,0,0,0,6,6
The Scott Mansell Podcast,0,0,0,0,3,3
I Love A Lifetime Movie,0,0,0,0,36,36
The Rosary with Bishop Robert Barron,0,0,0,0,7,7
"The CRUX, True Survival Stories",0,0,0,0,5,5
Odessa,0,3,0,0,9,12
615 Guys,0,0,0,0,1,1
The Reinvention Project with Jim Rome,0,0,0,1,28,29
Second Star to the Left,0,0,0,0,4,4
Supported Sobriety,0,0,0,0,11,11
The Real Question,0,1,0,0,47,48
Domenick’s Den,0,0,0,0,8,8
The Man and the MITH,0,0,0,0,57,57
The Resleevables,0,0,0,0,5,5
Unexplainable,3,2,2,0,23,30
The Gear Patrol Podcast,0,0,0,0,5,5
Hidden Gems: A Board Game Podcast,0,0,0,0,9,9
DoubleTake with Yaqeen Institute,0,0,0,0,1,1
Slumber Party Podcast,1,0,0,0,18,19
FuturElitez Podcast,0,0,0,0,8,8
Wild for Scotland,0,0,0,0,6,6
Curl Up with a Cat Tale with Gwen Cooper,0,0,0,0,25,25
Ode To Black Love,0,0,0,1,3,4
In The Moment Pod,0,0,0,0,3,3
Beyond The Big Bang,0,0,0,0,1,1
The LexG Movie Podcast,0,0,0,1,38,39
Don't Call Us Pretty,0,0,0,0,11,11
The Roses That Be,0,0,0,0,13,13
Master Thy Self - Vibration Meditation,0,0,0,0,1,1
Weird Science Manga Podcast,0,0,0,0,4,4
Eros to the Heart,0,0,0,0,2,2
Kill James Bond!,0,0,0,0,7,7
Fantasy Baseball Today in 5,1,0,0,0,13,14
Life On Course,0,0,0,0,1,1
Golf Fanatics Podcast,0,0,1,0,0,1
Ravens Roost Radio,0,0,0,0,3,3
Again From The Top,0,0,0,0,1,1
Bravo Over Boys,1,0,0,2,19,22
Fast Pace with Josh Phegan and Dean Mackie,0,0,0,0,14,14
The Sunday Scaries with prettyrealcool,0,0,0,0,1,1
Homeroom: A HSMTMTS Podcast,0,0,0,1,0,1
Secrets in Nature,0,0,0,0,4,4
F This Farm - A beginning farmer's saga,0,0,0,0,3,3
Silent Run,0,0,0,0,7,7
That's Nifty,0,0,0,0,2,2
Baby Name Envy - UK's #1 Baby Name Consultancy,0,0,0,0,16,16
The Spot Starter,0,0,0,0,4,4
The Trumpet Summit,0,0,0,0,2,2
chitchatwithauzi's Podcast,0,0,0,0,4,4
Turning Two,0,0,0,0,1,1
Sad Thoughts,1,0,0,0,0,1
"Hello, My Name is Baseball",0,0,0,0,1,1
What's Up Sister?,0,0,0,0,6,6
Forgotten Hollywood,0,0,0,1,5,6
Just the Truth with Jenna Ellis,5,0,0,0,15,20
Authentic Conversion For Online Health and Fitness Coaches,0,0,0,0,2,2
Football Bedtime Stories,0,0,0,0,2,2
Whip's Whatever Happened To...?,0,0,0,0,1,1
The Dirt on Love,0,0,0,1,1,2
Aviation Social Club,0,0,0,0,1,1
"Love, Marriage and Reality TV",0,0,0,0,4,4
Movie Time Capsule,0,0,0,0,1,1
The Sh3nanigans Podcast With Anthony & James,0,0,0,0,1,1
Closet Nerd Podcast,0,0,0,0,1,1
Thinking With... A Rhetorical Theory Podcast,0,0,0,0,1,1
Dirty Genes Podcast,0,0,0,0,9,9
Zee Soccer Podcast,0,0,0,0,2,2
Against the Wind - Podcast,0,0,0,0,3,3
Empire,0,0,0,0,16,16
Chasin' Birdies,0,0,0,0,2,2
Pickaxe and Roll,0,0,0,0,8,8
Watt It Takes,0,0,0,0,3,3
Beers In The Shop,0,0,0,0,1,1
The Breakdown,0,0,0,0,3,3
YulsFM_el podcast,0,0,0,0,1,1
iRewatch iCarly,0,0,0,0,23,23
Why We Marathon,0,0,0,0,1,1
La Zona Segura con Yaminah Cabrera,0,0,0,0,6,6
Show Up or Shut Up with Wendy Solganik,0,0,0,1,8,9
Reality Escape Pod,0,0,0,0,10,10
Zooming With The Homies,0,0,0,0,6,6
Organize Your Closet And Your Life Will Follow,0,0,0,0,2,2
After The Beep with Tyler Elliott,0,0,0,0,2,2
Nats Chat,0,0,0,0,28,28
MuniciPals Golf Podcast,0,0,0,0,1,1
Saved by the Belial: An Atrocious Ultraman Podcast,0,0,0,0,3,3
United Sessions,0,0,0,0,4,4
The Sound: Posture Check,0,0,0,0,2,2
The SociEATy Podcast,0,0,0,0,9,9
WHOA It’s Ryan!,0,0,0,0,48,48
The Hindu/Yoga Dharma.,0,0,1,0,0,1
Simplifying The Magic,0,0,0,0,5,5
Beauty After Betrayal™,0,0,0,0,18,18
The Soup Kitchen of Boynton Beach,0,0,0,0,2,2
The ME Spot,0,0,0,0,19,19
More Right Rudder,0,0,0,0,2,2
Howie Mandel Does Stuff Podcast,5,0,0,1,32,38
Let's Talk Bravo,0,0,0,0,1,1
Sonder Thinking,0,0,0,0,1,1
High Realitea,0,0,0,0,1,1
The Sneider Cut: Collider Movie News,0,0,0,0,1,1
Permission for Pleasure,0,0,0,0,7,7
My Three Things,0,0,0,0,2,2
Mapping Evil with Mike King,0,0,0,0,22,22
Moment of Truth,0,1,0,0,7,8
Trade Secrets Podcast,0,0,0,0,1,1
Bettor Golf,0,0,0,0,7,7
Homeschool Guides,0,0,0,0,1,1
Between 2 Rebuilds,0,0,0,0,1,1
Future Projection — A Baseball America Podcast,0,0,1,2,15,18
NFR Podcast,0,0,0,0,2,2
The Gary DeMar Blogcast,0,0,0,0,1,1
Bums in the basement,0,0,0,0,1,1
The Villainous Podcast,0,0,0,0,1,1
We Are The Runners Show,0,0,0,0,3,3
The Greatness Machine,0,0,0,0,37,37
Millenial Money Podcast,0,0,0,0,3,3
Every Outfit,1,3,1,0,14,19
Moviestruck,0,0,0,0,2,2
Chicago Athlete Podcast,0,0,0,0,20,20
Pretty Intuitive,0,0,0,0,3,3
The Ghostbusters Containment Unit Podcast,0,0,0,0,4,4
Willing To Be Wrong,0,0,0,0,14,14
Dawes Podcast,0,0,0,0,6,6
Global Grooves,0,0,0,0,1,1
Debris Division,0,0,0,0,2,2
Emerging Motherhood,0,0,0,0,6,6
Nochegeek,0,0,0,0,2,2
The Dynasty Duo,0,0,0,0,5,5
Woodland War Machine,0,0,0,0,2,2
The Chris Rose Rotation,0,0,2,0,83,85
The 540,0,0,0,0,2,2
Syria's Lost Generation,0,0,0,0,1,1
Cosmic Conversations with Sarah R. Adams,1,0,0,0,2,3
Plants and Rants Podcast,0,0,0,0,20,20
cookies by christine,0,0,0,0,1,1
Your Woo Woo Best Friend,0,0,0,0,45,45
Takeline,0,0,0,0,29,29
Starting In Strategy,0,0,0,0,1,1
Policy Influencer Playbook,0,0,0,0,1,1
Dynasty Diner Podcast,0,0,0,0,2,2
That Happens,0,0,0,0,45,45
The Juan O’ Savin Podcast,0,0,0,0,1,1
All That To Say,0,0,0,0,2,2
MLG Meditations,3,0,0,0,7,10
Adventure awaits- stories,0,0,0,0,3,3
Happy Brain,0,0,0,0,19,19
Kyle's Valheim Bulletin,0,0,0,0,2,2
Partners N Crime,0,0,0,0,6,6
Straight Chubb - Fantasy Football Podcast,0,0,0,0,6,6
The Ladd Life,0,0,0,0,10,10
Chin Music,0,0,0,0,2,2
Playing Guilty,0,0,0,0,1,1
Procurement Rising,0,0,0,0,3,3
I wanna jump like Dee Dee,0,0,0,0,2,2
According to Need,0,0,0,0,18,18
Tinseltown Thunderdome,0,0,0,0,6,6
High Performance Founder,0,0,0,1,11,12
Energy Impact,0,0,0,0,28,28
POA Podcast,0,0,0,1,0,1
Scared Confident,0,0,0,0,5,5
MAN-slaughter,44,37,20,7,39,147
Doing the Mos,0,0,0,0,4,4
The Atlas Obscura Podcast,2,1,1,4,22,30
The Jeff Dunham Podcast,0,0,0,2,40,42
CRNA School Prep Academy Podcast,0,0,0,0,1,1
Herbalist Kareem Speaks,0,0,0,0,2,2
Confessions of a Server,0,0,0,0,4,4
Greenletes Podcast,0,0,0,0,2,2
The Houseplant Coach,0,0,0,0,1,1
Vivir Casi Casi Cero,0,0,0,0,1,1
Say Less,0,0,0,0,16,16
Cars & Comrades,0,0,0,0,1,1
SINPHONY Radio w/ Timmy Trumpet,0,0,0,0,2,2
Shrink Rap,0,0,0,0,4,4
Pod People’s Podcast (for People Who Make Podcasts),0,0,0,0,3,3
The Final Batch Podcast,0,0,0,0,1,1
Hang and Hunt Podcast,0,0,0,0,7,7
Startup Renegades,0,0,0,0,21,21
Into the Super-Verse,0,0,0,0,4,4
Country First Conversations,0,0,0,0,2,2
Some Anime,0,0,0,1,0,1
Going Against The Flow,0,0,0,0,28,28
Dirty T Podcast,0,1,0,0,0,1
"Watched Once, Never Again",0,0,0,0,5,5
The Gigi Meyer Podcast,0,0,0,0,5,5
What The Parent?,0,0,0,0,1,1
The Net Zero Life,0,0,0,0,10,10
The Lizard Market,0,0,0,0,47,47
ManKind Podcast,0,0,0,0,6,6
Passages: Nicaea,0,0,0,0,3,3
Weekly Skews,0,0,0,0,1,1
1991 Movie Rewind,0,0,0,0,1,1
Racin Rehab,0,0,0,0,3,3
Get Better Today,0,0,0,0,33,33
Young & Curious,0,0,0,0,2,2
Multiply,0,0,0,0,2,2
Finance Explained by Family Finance Mom,0,0,0,0,6,6
Boundless Love,0,0,0,1,11,12
Marvel Talk,0,0,0,0,4,4
"Luther's World of Cryptids, Ghosts and the Unexplained",0,0,0,0,1,1
Birthright,0,0,0,0,2,2
The Jessica Haizman Podcast,0,0,0,1,14,15
Trade Tales,0,0,0,0,2,2
Winnipeg Sports Talk,0,0,0,0,2,2
Cool Story Guys,0,0,0,0,7,7
You Belong in the C-Suite,0,0,0,0,1,1
Limitless with Callie Ray & Kendall,0,0,0,0,10,10
The Way We Parent,0,0,0,0,1,1
Always Be My Sisters,0,0,0,0,1,1
PETPIX ACADEMY with Vasi Siedman,0,0,0,1,29,30
HEALTHCARE HACKS AND CONNECTIONS,0,0,0,0,50,50
Talking Hockey Sense,0,0,0,0,6,6
ONE&ALL Daily Podcast,0,0,0,0,48,48
My Warped Life,0,0,0,0,5,5
Carol & Kay Save the USA,0,0,0,0,2,2
The Super Podcast,0,0,0,0,1,1
Locked On Blue Devils - Daily Podcast On Duke Blue Devils Football & Basketball,0,0,0,0,5,5
"I'm The Promoter, He's The DJ",0,0,0,0,2,2
Applehype,0,0,0,0,1,1
Bold stories. Future focused.,0,0,0,0,3,3
Unleashed with The Dingo and Danny Podcast Fueled by Monster Energy,0,0,0,0,3,3
Out of the Dark with Mandisa & Laura Williams,2,0,0,0,24,26
Worst Movies Ever Played,0,0,0,0,5,5
Unfinished Attic,0,0,0,0,3,3
Novel Dialogue,0,0,0,0,2,2
HER Crowne,0,0,0,0,1,1
Back On Air with Jared Lipscomb,1,0,0,0,16,17
The Katie Armstrong Show,0,0,0,0,6,6
Flycast,0,0,0,0,1,1
Downtown Dish,0,0,0,0,3,3
The Guide Post,0,0,0,0,8,8
Hawkeye Podcast,1,0,0,0,13,14
Inside the War Room: Case Studies in Crisis,0,0,0,0,8,8
Jack Russell Parents,0,0,0,0,4,4
Mat & Board,0,0,0,0,4,4
Dame’s Dropback,0,0,0,0,1,1
Down On The Farm,0,0,0,0,1,1
Small Potatoes,1,0,0,0,10,11
Bad. Dog. Owners.,0,0,0,0,1,1
Speculative Futures,0,0,0,0,1,1
The Father Daughter Dance,0,0,0,0,5,5
Elaine Heney and Listening to the Horse for Equestrians and Horse Owners,0,0,0,0,3,3
Sierra Spills: A College Girl's Guide to Breaking into the Music Industry,0,0,0,0,5,5
She Did That.,0,0,0,0,3,3
Being Known Podcast,0,0,0,0,5,5
All The Best (& Worst) with Mr and Mrs Hinch,0,0,0,0,6,6
Parenting On Purpose,0,0,0,0,7,7
Quarterback Kids Podcast,0,0,0,0,3,3
Things Every 13 Year Old Should Know,0,0,0,0,4,4
The Cast with Rae & Jacquis,0,0,0,0,6,6
The Hallway Nerds Sports Podcast,0,0,0,0,1,1
The Rock Podcast with Denny Somach,0,0,0,1,2,3
Gracious & Strong,0,0,0,1,2,3
Dew Diligence,0,0,0,0,1,1
The MaxLiving Podcast,0,0,0,0,5,5
Baseball Elite,0,0,0,0,2,2
A Remarkable Thought,0,0,0,1,23,24
iMurder,0,0,1,0,20,21
Moms on Break,0,0,0,0,1,1
A Little Bit Crazy,1,0,0,0,32,33
At least you didn't...,0,0,0,0,1,1
Who What Wear with Hillary Kerr,0,0,0,0,3,3
Hype Juice,1,0,0,0,0,1
Milk Crates and Turntables,0,0,0,0,5,5
Nomad or What,0,0,0,0,15,15
Storykeepers Podcast,0,0,0,0,2,2
The Razzle Dazzle Podcast ~ LOST,0,0,0,0,4,4
Life & A Little Basketball,0,0,0,0,7,7
BuckyCast Wisconsin Badgers Football and Basketball Podcast,0,0,0,0,1,1
Flagrant Pod,0,0,0,0,10,10
Playing with Madness,0,0,0,0,3,3
Tap In w/ Harry Jowsey,2,0,0,0,26,28
The Borderline Podcast,0,0,0,0,1,1
RedPath Radio,0,0,0,0,1,1
Behind The Edit,0,0,0,0,2,2
Caps This Morning,0,0,0,0,3,3
Pop Pantheon,0,0,0,0,4,4
Lazy Lab Podcast,0,0,0,0,1,1
The Livin' It Podcast,0,0,0,0,2,2
The No Name Football Podcast,0,0,0,0,6,6
The Ben Domenech Podcast,0,0,0,0,4,4
Rediscover Italy Podcast,0,0,0,1,4,5
Being An Artist,0,0,0,0,1,1
Wake The Fake Up,0,0,0,1,49,50
The Garden Kickback,0,0,0,0,6,6
Stroke Alert,0,0,0,0,1,1
IN Construction with Nate Lelle,0,0,0,0,1,1
ALIVE 2021: A Daft Punk Podcast,0,0,0,0,1,1
A GM's Toolbox,0,0,0,0,1,1
Scoop World Order,0,0,0,0,1,1
BirdSport,0,0,0,0,2,2
Three Way Miss,0,0,0,0,3,3
Gaters Gonna Rate,0,0,0,0,1,1
Tables and Chairs with Kem,0,0,0,0,1,1
Mad Vibeyy,0,0,0,0,3,3
Toadally My Jam Podcast,0,0,0,0,1,1
The X-Block Podcast,0,0,0,0,4,4
The Teacher Talk Show,0,0,0,0,1,1
The Amazing Clarks,0,0,0,0,4,4
Marks of a Mogul,0,0,0,0,27,27
Beauty Boss Millionaire,0,0,0,0,5,5
FIO with Maddy Forberg,0,0,0,0,4,4
Candace,6,0,1,0,42,49
The Publishing Life Podcast,0,0,0,0,5,5
JUVY Podcast,0,0,0,0,2,2
Hobby Farms Presents: Growing Good,0,0,0,0,1,1
The Leap Lifestyle Podcast,0,0,0,0,2,2
Tripping with Tripp,0,0,0,0,1,1
Baking it Down with Sugar Cookie Marketing,0,0,0,0,3,3
Cake Money Confidential,0,0,0,0,2,2
The Era,0,0,0,0,5,5
Game Day Routine,0,0,0,0,6,6
Bowtie Sales Guys,0,0,0,0,4,4
Glitchless Gaming,0,0,0,0,1,1
Legally Balanced,0,0,0,0,3,3
Playlist Wars,0,0,0,0,12,12
Huckleberry Gin,0,0,0,0,8,8
Health Coach Success,0,0,0,0,4,4
Two Dudes and Tunes,0,0,0,0,2,2
Bloom With Bridget,0,0,0,0,5,5
The Original Draft Breakdown Podcast,0,0,0,0,4,4
Anchored In Hope with Father Larry Richards - Catholic Faith,0,0,0,0,2,2
CraftFood Podcast,0,0,0,0,1,1
A French Village Podcast with Sarah Longwell and Ben Wittes,1,0,0,1,41,43
The Halfstep Pod,0,0,0,0,4,4
BLACK GIRLS EATING,0,0,0,0,2,2
Black Millennial Mamas,0,0,0,0,1,1
Kitty Talk,0,0,0,0,1,1
The Morelli Show,0,0,0,0,8,8
Rennervate,0,0,0,0,1,1
Bottom Line Up Front with SEAC,0,0,0,0,1,1
Plan Paradise Podcast,0,0,0,0,1,1
Soft Voice,1,0,1,0,15,17
The Chaotic Duo,0,0,0,0,2,2
Inside Global Girls' Education,0,0,0,0,1,1
"But First, She Failed Podcast",0,0,0,0,21,21
Boots and Bangles Podcast,0,0,0,0,3,3
Beauty Uncovered,0,0,0,0,15,15
The Macaroni Zone,0,0,0,0,1,1
Mama Unscathed,0,0,0,0,1,1
Bizarre Podcast: Dogs Must Die,0,0,0,0,3,3
Your Journey to the Divine,0,0,0,0,2,2
Learning Lots,0,0,0,0,32,32
Press Pause,0,0,0,0,2,2
Baseless Speculation,0,0,0,1,2,3
Cinema Oblivia,0,0,0,0,1,1
The Freaking Ricans,0,0,0,0,4,4
Tell me How,0,0,0,0,1,1
Hammer & Grind,0,0,0,0,11,11
Spa Siobhan,0,0,0,0,1,1
Chasing the Natty: A College Football Fantasy Podcast,0,0,0,0,1,1
WTF Did I Just Watch?,0,0,0,0,7,7
Causeway Kings,0,0,0,0,1,1
Dead North,0,0,0,0,2,2
Heroes of Gaming Podcast,0,0,0,1,4,5
Stories with Brisco and Bradshaw,0,0,0,0,2,2
Armchair Athlete Podcast,0,0,0,0,1,1
Lit Matters,0,0,0,0,1,1
Nourish You,0,0,0,0,1,1
Dr. Garrett Soldano DC Podcast,0,0,0,0,2,2
Chat Em Up w/ DCA,0,0,0,0,1,1
Jets Banter,0,0,0,0,2,2
Movie Luchador,0,0,0,0,3,3
Implotsters,0,0,0,0,2,2
Royals Weekly,0,0,0,0,4,4
Friends to Watch With,0,0,0,0,2,2
A Couple More Things,0,0,0,0,3,3
ALASKA BARCAST,0,0,0,0,2,2
Down In Sugar Land - The Official Podcast of the Sugar Land Skeeters,0,0,0,0,1,1
swish media podcast,0,0,0,0,2,2
Iconoblast Podcast,0,0,0,1,21,22
32 Bar Cut: The Show,0,0,0,0,3,3
The Greatest Music Podcast,0,0,0,0,5,5
Bunker 2 Bunker,0,0,0,0,3,3
22,0,0,0,0,4,4
Jabin Chavez Leadership Podcast,0,0,0,0,3,3
SweetTea,0,0,0,0,5,5
The Balance After Baby,0,0,0,0,3,3
Unprepared Casters,0,0,0,0,26,26
The Chirp Hockey Podcast,0,0,0,0,3,3
Scarlet Sandbox,0,0,0,0,15,15
Swaggy Dot Com,0,0,0,0,2,2
Spoiler Wars Podcast,0,0,0,0,2,2
Chaos! Fantasy Football League Podcast,0,0,0,0,1,1
